I run.	私は走ります。
Let's go!	行くよ。
I do run.	私は走る。
Open up.	開けてくれ。
I mean it!	本気だよ。
Let me see.	えっと。
I love you.	愛してる。
Keep out!	立ち入り禁止。
Let me in.	中に入れて。
Let's go!	行きましょう。
Is this love?	恋かな？
Keep out.	立ち入りを禁ず。
He does run.	彼は走る。
He did run.	彼は走った。
Let me in.	中に入れてよ。
I love you.	大好きだよ！
Let me out!	出してくれ。
Let me go!	私に行かせて。
I love you.	君が好きだ。
Let me say.	一言言いたい。
Mary ran.	メアリーは走った。
Let's go!	まあ行ってみよう。
You do run.	あなたは走る。
Get up early.	早く起きろ。
By all means.	是非どうぞ。
I am human.	私は、人間です。
Do something!	何とかしろ！
I understand.	了解しました。
I understand.	分かってるよ。
He is human.	彼は、人間です。
You are early.	早かったね。
Don't let go.	手を離すなよ。
Good question!	よい質問だ。
By all means.	どうぞどうぞ。
Keep it up!	その調子で続けて。
I love you.	あなたを愛してる。
I love you.	あなたが好きです。
I can't move.	動けないのです。
Large or small?	大か、小か。
I mean it.	本気で言ってるんです。
Let me go!	私に行かせてください。
Let go of me!	私から手を離せ！
I found you.	僕は君をみつけた。
It's your move.	君の番だよ。
I was moved.	とても感動したわ。
Do you love me?	僕のこと好き？
She is human.	彼女は、人間です。
He loves her.	彼は彼女が好きだ。
Is he at home?	彼は家にいるか。
He was at home.	彼は家にいた。
Let me do this.	手伝ってやる。
Do you love me?	私を愛してる？
I love Hitomi.	私は瞳が好きだ。
I love you.	私は、貴方が好きです。
I love you.	君のことが好きなんだ。
How many people?	何人ですか。
I love you.	だって好きなんだもの。
Keep it up.	その調子でがんばって。
By all means.	ぜひお願いします。
That means X.	それがXを意味します
She came last.	彼女は最後にきた。
Let him at it.	彼にやらせておけ。
Let's live it up!	道楽しよう。
All are present.	全員出席です。
I want to live.	私は命がほしい。
I love her.	私は彼女に恋をしている。
I got up early.	私は早く起きた。
I love you.	私はあなたを愛している。
I let him go.	私は、彼を行かせた。
Give me a few.	私に少しください。
We are human.	私たちは、人間です。
You are human.	貴方は、人間です。
I am at home.	わたしは、在宅です。
Let me see that.	それを見せて。
Don't run here.	ここでは走るな。
Is he at home?	彼は家にいますか。
What's its name?	名前は何ですか。
They are human.	彼らは、人間です。
I want some water.	水が欲しい。
I like to run.	私は走るのが好きだ。
You are human.	貴方達は、人間です。
Let us go home.	家へ帰りましょう。
Keep the change!	つりは要らんよ。
People think so.	人には、そう見える
My level is low.	自分のレベルが低い
Is she at home?	彼女は家にいますか。
Is he at home?	彼は在宅していますか。
Let him do it.	彼にそれをさせなさい。
P. S. I love you.	追伸愛してます。
How about running?	走りませんか。
I run every day.	私は毎日走ります。
Can you find it?	見つけられますか。
Never let me go.	決して放さないで。
Keep away from me.	俺に近づくな。
Let me see it.	ちょっと見せて下さい。
Let me see it.	それ、ちょっと見せて。
I do love you.	あなたが好きなのです。
This is Room 839.	８３９号室です。
Let me have a look.	見せてくれ。
Get a move on!	なにちんたら歩いてんだ。
The light is on.	明かりがついている。
She loves Tom.	彼女はトムを愛している。
He came running.	彼は走りながら来た。
He made for home.	彼は家に向かった。
I live in Tokyo.	東京に住んでいます。
He must not live.	生かしてはおかぬ。
There is no water.	水が少しもない。
I have a question.	質問があります。
Come to my house.	私の家へ来なさい。
I have a family.	私には家族がいます。
Let me do it.	私にそれをさせてください。
Let's take a look.	見てみましょう。
Let's get going.	さあ、始めましょう。
May I have your name?	お名前は？
Let me help you.	お手伝いしましょう。
What's your name?	あなたのお名前は？
I am experienced.	私には経験が有ります
Something is needed.　	何かが必要だ
I found many X.	Xが幾つも目に付きました
Let them come in.	彼らを入らせなさい。
He is in the House.	彼は議員である。
The light is out.	電球がきれています。
Come home early.	早く帰ってらっしゃい。
All were present.	全員が出席していた。
I saw her home.	私は彼女を家まで送った。
I live in Kobe.	私は神戸に住んでいます。
May I go home?	私は帰宅してもよいですか。
I want to go home.	私は家へ帰りたい。
I am in the house.	私は家の中にいる。
You keep out of this.	口を出すな。
Well, I loved it.	なかなか良かったよ。
What do you mean?	どういう意味ですか？
That name is Ken.	その名前はケンです。
Let's do the work.	その仕事をやろう。
Let's be off now.	さあ出かけましょう。
Keep the change.	お釣りは取っておいて。
That is her house.	あれは彼女の家だ。
I'm on your side.	あなたを支持します。
Many people like X.	Xを多くの人が好む
He came in person.	彼本人がやってきた。
Her face lit up.	彼女は明るい顔になった。
Give my love to her.	彼女によろしく。
He got home at six.	彼は六時に帰った。
He is running now.	彼は今走っています。
Keep your head down.	頭を上げるなよ。
The lights are out.	灯りが消えている。
He lives in Osaka.	大阪に住んでいます。
I live in Hyogo.	私は兵庫県に住んでいる。
I live in Japan.	私は日本に住んでいます。
I just moved.	私は引っ越してきたばかりです。
I found Tony.	私はトニーを見つけたのである。
I'm on your side.	私はあなたの味方です。
My name is Yamada.	私の名前は山田です。
Let me help you.	私に手伝わせてください。
May I go home now?	今、家に帰っていい？
Live and let live.	己も生き他も生かせ。
I know your name.	君の名前は知っている。
I will take you home.	家まで送ろう。
He is away from home.	家にはいない。
What do you mean?	何を言いたいのですか。
Keep to the right.	右側通行をしなさい。
I can't find Tim.	ティムが見つからない。
At last, he came.	ついに彼はやって来た。
Let's be going now.	そろそろ行こうか。
Keep away from that.	それに近づくな！
The man ran away.	その男は逃げていった。
I'm going home now.	これから帰ります。
Here's some water.	ここに水が少しある。
That's our house.	あれは私たちの家です。
Look at that house.	あの家を見なさい。
When do you run?	あなたはいつ走りますか。
Let's make it three.	３時にしようよ。
What does it mean?	それ、どういう意味？
He knows my name.	彼は私の名前を知っている
Many people say 〜.	〜とみんなが口を揃える
The question is this.	問題はこうです。
I can see the light.	目から鱗が落ちた。
My name is Yatarou.	僕の名は弥太郎です。
I know what you mean.	分かる、分かる。
He moved to Tokyo.	彼は東京に引っ越した。
He has a large family.	彼は大家族だ。
He lives in Kyoto.	彼は京都に住んでいる。
He ran on and on.	彼はどんどん走り続けた。
Long may he live!	彼の命の長からんことを。
May he live long!	彼が長生きしますように。
Only one way to live.	道はただひとつ。
Who runs the show?	誰が会社の経営者かね。
It is a small world!	世間は狭いですね。
Man is 70% water.	人間は７０％水なんだよ。
I ran for my life.	私は命からがら逃げた。
I don't love her.	私は彼女を愛していない。
Come into my room.	私の部屋に入りなさい。
Let it all out.	込み上げる感情をさらけ出せ。
My name is Hopkins.	我が名はホプキンス。
You know something?	意外な話があるんだ。
The house is to let.	その家は貸家です。
Let me do that.	そのことなら私に任せておけ。
Do it by all means.	ぜひそれをしなさい。
Let's get off here.	ここで降りましょう。
Keep to the right.	ここでは右側通行です。
My name is Andrea.	アンドレアと申します。
X has one meaning.	Xには一つ意味が有ります
She isn't running.	彼女は今走っていません。
Her means are small.	彼女の財産は少ない。
He ran up to her.	彼は彼女の所に駆け寄った。
He is close with her.	彼は彼女と親密だ。
He lives in Tokyo.	彼は東京に住んでいます。
He lives in Tokyo.	彼は東京で暮らしている。
He ran away from home.	彼は家出をした。
I take sides with him.	彼の味方になる。
I saw him running.	彼が走っているのを見た。
I'd like some water.	水が欲しいのですが。
Keep your hand still.	手を動かさないで。
Don't let me down.	私を落胆させないでくれ。
I ran for my life.	私は必死になって逃げた。
I live in Yokohama.	私は横浜に住んでいる。
I got home at seven.	私は7時に帰宅した。
My family is small.	私のうちは小人数です。
Do you live here?	君は当地に住んでいるのか。
Where do you live?	君の住まいはどこですか。
How is your family?	家族の皆さんはお元気？
I live in Kakogawa.	加古川に住んでいます。
Don't make light of me.	俺をなめるな。
Let me go with you.	一緒に行かせて下さい。
Come closer to me.	もっと私の側に来なさい。
Tom is in the house.	トムは家の中に居る。
Where do you live?	どちらにお住まいですか。
Do come by all means.	ぜひ来てください。
How is your family?	ご家族はお元気ですか。
This is their house.	これは彼らの家です。
He must love you.	彼はきっと君が好きなんだ。
What is your name?	あなたの氏名は何ですか。
Where is Room 105?	１０５号室はどこですか。
Do you have a family?	ご家族はいますか。
Let them all come.	矢でも鉄砲でも持ってこい。
Do you mean what you say?	本気ですか。
I'll do it by all means.	必ずやります。
She lived a long life.	彼女は長生きした。
She is very human.	彼女は人間性に富んでいる。
Does he live here?	彼は当地に住んでいるのか。
He was ordered home.	彼は帰国を命じられた。
He lives close by.	彼はすぐ近くに住んでいる。
He lives close by.	彼はすぐそばに住んでいる。
He came home at ten.	彼は１０時に帰宅した。
I know him by name.	彼の名前を知っています。
I know him by name.	彼の名前は知っています。
No one was present.	誰も出席していなかった。
Live and let live.	世の中は持ちつ持たれつだ。
It's a small world.	世の中は狭いものですね。
Water finds its level.	水は低きに流れる。
Let me give you a hand.	手伝いましょう。
Live and let live.	自分も生き、他人も生かせ。
Time runs on.	時間というものは早く経過するものだ。
Time is running out.	時間が無くなってきた。
My name is Hashimoto.	私は橋本といいます。
We set out for home.	私たちは家路についた。
I'm going to go home.	今から家に帰ります。
You don't understand.	君、わかってないね。
What time does it open?	何時開店ですか。
Something must be done!	何かしなければ。
Let's study English.	英語を勉強しましょう。
Can I go home now?	もう帰宅してもいいですか。
Where do you live?	どこに住んでいるんですか。
I was at home then.	その時私は家に居ました。
Is that your room?	これはあなたの部屋ですか。
This is the last time.	これが最後だから。
Keep the change.	おつりは取っておいてください。
They are too close.	あの二人はどうも怪しい。
Do you love me?	あなたは私を愛しているのですか。
You may go home.	あなたは家に帰ってもよろしい。
I've always loved you.	ずっとあなたが好きだ
It makes us more human.	それが人間性を育む
I think I understand.	分かるような気がする。
Could I change rooms?	部屋を変えられますか。
Come into the room.	部屋の中に入ってください。
Let it be on your head!	不幸は私の責任だ。
She is loved by him.	彼女は彼に愛されている。
She's always on the go.	彼女は働きづめだ。
They love each other.	彼らは愛し合っている。
They are running now.	彼らは今走っています。
They questioned him.	彼らはまた尋ねて言った。
He ran into the room.	彼は部屋に駆け込んだ。
He has a large family.	彼は扶養家族が多い。
He lives in Nagasaki.	彼は長崎に住んでいる。
Where does he live?	彼はどこに住んでいますか。
He is close to sixty.	彼は６０歳ぐらいです。
Do you live in Tokyo?	東京にお住まいですか。
The light doesn't work.	電気がつきません。
I live in the country.	田舎に住んでいます。
Do you like the country?	田舎が好きかね。
Who is in this room?	誰がこの部屋にいますか。
Could you let it out?	出していただけますか。
Let's have a go at it.	試しにやってみよう。
Don't let me down.	私をがっかりさせないでくれ。
I do not get up early.	私は起きるのが遅い。
I live in Kyoto now.	私は今京都に住んでいる。
I have a large family.	私の家族は大人数だ。
Let me take a look.	私にちょっと見せて下さい。
I love what you are.	今のあなたを愛している。
We are a family of four.	家族は４人です。
What time does it close?	何時閉店ですか。
May I say something?	何か言ってもいいですか。
May I run with you?	一緒に走ってもいいですか。
Have you got a lighter?	ライター持ってる？
At last, we were home!	やっと帰ってきたぞ！
You can go home now.	もう帰宅してもよろしい。
You can go home now.	もう帰ってもいいですよ。
Can I go home now?	もう家へ帰ってもいいですか。
May I go home now?	もう家に帰ってもよいですか。
Tony runs every day.	トニー君は毎日走ります。
Let me know the way.	どうか道を教えておくれ。
At last he came to.	ついに彼は息を吹き返した。
I didn't mean it.	そんなつもりではなかったんだ。
It is of great value.	それは大変価値がある。
Who owns this house?	この家は誰のものですか。
Where do you live?	きみはどこに住んでいますか。
You don't run here.	あなたはここで走りません。
Where is your room?	あなたの部屋はどこですか。
Come home by 6:30.	６時半までには帰ってきてね。
I didn't order this.	これは注文していません。
Come home before six.	６時に帰ってきなさい。
There is an increase in X.	Xが多くなった
I take sides with you.	僕はあなたの見方です。
She's not at home now.	彼女は今家にいません。
She still loved him.	彼女はまだ彼を愛していた。
I know her by name.	彼女の名前だけは知っている。
Did they live here?	彼らは当地に住んでいたのか。
He showed what he meant.	彼は本音を出した。
He came into the room.	彼は部屋に入ってきた。
He lives in Boston.	彼はボストン市に住んでいる。
Does he live here?	彼はここに住んでいるのですか。
He came into the room.	彼が部屋に入ってきた。
I'll take it home with me.	持ち帰ります。
I use it every day.	私は毎日それを使っています。
I meant what I said.	私は本気でそういったのだ。
I have to go home.	私は帰宅しなければいけません。
I always get up early.	私はいつも早く起きる。
My name is Hisashi.	私は「ひさし」という名前だ。
My room is very small.	私の部屋はとても狭い。
How's my order coming?	私の注文はまだですか。
My family is an old one.	私の家は旧家です。
Will you let me at it?	私にやらせてくれない？
I know what you mean.	言いたいことは分かるよ。
Where do you live?	君はどこに住んでいるのですか。
My family are all well.	家族は全員元気です。
Give me something to do.	何か仕事を下さい。
Well, here we are at last!	やっと着いた。
Peter loves Jane.	ペーターはジェーンを愛している。
What a small world!	なんて世界は狭いのでしょう。
May you live long!	どうぞ長生きなさいますように。
We have no such example.	そんな先例はない。
Let me have a look at it.	それを見せてよ。
It's for my family.	それは私の家族へのものです。
Few people think so.	そう思っている人が少ない。
How about your family?	ご家族はいかがですか。
What does this mean?	これはどういう意味ですか。
This room is for VIPs.	この部屋は要人用です。
Who owns this house?	この家はだれの所有ですか。
This house is to let.	このいえは貸し家である。
Ken wasn't running.	ケンは走っていませんでした。
Let me take you home.	お宅にお送りしましょう。
All are well at home.	うちではみんな元気です。
When will you come home?	いつ帰宅しますか。
This is just another day.	ありふれた一日。
I will see you home.	あなたを家まで見送ります。
Do you run every day?	あなたは毎日走りますか。
Where do you live?	あなたはどこにお住まいですか。
Is it open on Sunday?	日曜日でも開いてますか。
It always moves me.	その姿にはいつも心を打たれます
Can you give me a house?	僕に家をくれないか。
Show me another example.	別の例を示しなさい。
You must go out of the room.	部屋を出ろ。
She is a high-liver.	彼女は高望みするタイプです。
She lives in Yokohama.	彼女は横浜に住んでいる。
She is close on sixty.	彼女はもうすぐ６０歳だ。
She got home at seven.	彼女は７時に家に着いた。
He goes there every day.	彼は毎日そこへ行く。
He is in love with her.	彼は彼女に恋している。
He does not get up early.	彼は早く起きない。
He came into my room.	彼は私の部屋へ入ってきた。
He came into my room.	彼は私の部屋に入ってきた。
He is living in Tokyo.	彼は今東京に住んでいる。
Where does he live?	彼は何処に住んでいるのですか。
He used to live here.	彼は以前ここに住んでいた。
He understands French.	彼はフランス語がわかる。
He came home just now.	彼はついさっき帰宅した。
He used to love her.	彼はかつて彼女を愛していた。
He is always studying.	彼はいつも勉強している。
Who is in this room?	誰がこの部屋の中にいますか。
Always do what is right.	常に正しい事をせよ。
Keep up with the times.	時代に遅れないように。
I go to work every day.	私は毎日勤めに出ます。
I'm looking for a house.	私は家を探している。
I have to find it.	私はそれを探さなければならない。
My family are all well.	私の家族は皆元気です。
My family is a large one.	私の家は大家族だ。
I mean what I say.	私が言っていることは本気なのだ。
Be at home this evening.	今夜うちにいてくれ。
Where do you live now?	今何処に住んでいますか。
I'll have to let you know.	考えておきます。
You may go home now.	君はもう家へ帰ってよろしい。
When will you come home?	何時に帰ってくるの。
We want something new.	何か新しいものがほしい。
I saw a light far away.	遠くに明かりが見えた。
Do you have a lighter?	ライターをお持ちですか。
Tony lives in Kobe.	トニー君は神戸に住んでいます。
Much water is needed.	たくさんの水が必要である。
Most people think so.	たいていの人がそう考える。
Let's go at our work.	さあ仕事をはじめましょう。
May I take your order?	ご注文を承りましょうか。
Would you like to order?	ご注文なさいますか。
Can I keep this?	これももらっておいても、良いですか。
Do not run in this room.	この部屋では走るな。
This house is very good.	この家はとても良い。
Is Emily at home now?	エミリーは今家にいますか。
We are a family of five.	うちは５人家族です。
America is very large.	アメリカはとても大きい。
You must go home.	あなたは家へ帰らなければならない。
You came home at 5:00.	あなたは５時に帰宅した。
X had little meaning.	Xがあまり意味を持たなかった
I'm running out of time.	もう、私には時間が無い
My hands moved on their own.	勝手に手が動く
Its name comes from X.	それはXにその名が由来する
My name is Ichiro Tanaka.	名前は田中一郎です。
Who doesn't love her?	彼女を愛さない者がいようか。
She came into the room.	彼女は部屋に入ってきた。
She lived to be ninety.	彼女は９０歳まで生きた。
She came into the room.	彼女が部屋に入ってきた。
He is a man of few wants.	彼は欲の少ない人だ。
He came out of the room.	彼は部屋から出てきた。
Is he loved in Japan?	彼は日本で愛されていますか。
He did not get up early.	彼は早く起きなかった。
He lived to be ninety.	彼は生きて９０歳になった。
He gave me a present.	彼は私にプレゼントをくれた。
He is good for something.	彼は何かの役に立つ。
He used to get up early.	彼は以前早起きだった。
He did come at last.	彼はとうとう本当にやってきた。
When will he go home?	彼はいつ家に帰れるのですか。
He is always on my side.	彼はいつも私の味方だ。
He is always with me.	彼はいつも私といっしょです。
Are they open on Sunday?	日曜は開いていますか。
Japanese houses are small.	日本の家は小さい。
Watanabe is my family name.	渡辺が名字です。
Is Mr Nakamura at home?	中村さんはご在宅ですか。
We moved into a new house.	新居へ引っ越した。
Could you let him out?	出してやってくれませんか。
I saw him running away.	私は彼が逃げるのを見た。
I'd love to come with you.	私は君と行きたい。
I got out of that house.	私はその家を出ました。
I always get up at six.	私はいつも６時に起きる。
My family is a large one.	私の家族は大勢です。
My family are all well.	私のうちはみな元気です。
My family is a large one.	私に家族は大勢です。
We helped one another.	私たちは互いに助け合った。
We had always been close.	私たちは一緒にいた。
Let's go back to our places.	座席へ戻ろう。
Must I come home now?	今帰らなければなりませんか。
I'll let it go this time.	今回は大目に見よう。
Let's help each other.	お互いに助け合いましょう。
I can't keep up with you.	君についていけない。
Let us do the work.	我々にその仕事をやらせて下さい。
Something's got to give.	何かで妥協しなくちゃ。
I have to do something.	何かしなければならない。
I will love you always.	永遠にあなたを愛します。
I saw him run away.	わたしは彼が逃げていくのを観た。
You'd better go home now.	もう家に帰りなさい。
Mary. That's my name.	メアリーですよ、私の名前は。
Where would I find CDs?	どこでＣＤが買えますか。
But they are all people.	でも、みんな人間です。
Let's get it over with.	それを片付けてしまおう。
It is of little value.	それはほとんど価値が無い。
It has my name on it.	それには私の名前があります。
What do you mean by it?	それどういう意味ですか？
I didn't mean that.	そのつもりで言ったのでは・・・。
Let's get down to work.	さあ仕事に取り掛かろう。
How's your family?	ご家族の皆様おかわりありませんか。
Let's keep this level.	このレベルを守りましょう。
The fewer, the better.	ごちそうは小人数ほどよい。
What was your name?	お名前は何とおっしゃいましたか。
When did they go home?	いつ彼らは帰宅しましたか。
He is very mean to me.	あの子は私に意地悪するよ。
That house is very small.	あの家は大変小さい。
You'd better go home.	あなたは家に帰った方がよい。
Well, here we are at last.	ああやっと着いた。
He still loves her.	彼はまだ彼女のことを愛している。
I'm always moved by X.	私はXにいつも感動を覚えます
Study English every day.	毎日英語を勉強しなさい。
I mean what I'm saying.	僕は本気で言っているんだ。
Give me another example.	別の例をあげてください。
Will you get me a room?	部屋を取ってくれませんか。
I will come by all means.	必ずうかがいましょう。
He loves no one but her.	彼女以外の誰も愛さない。
She's off and running.	彼女もう浮かれちゃってるよ。
Her family is very large.	彼女の家族は大人数だ。
He looked around the room.	彼は部屋を見回した。
He is just to a person.	彼は人に対して公平である。
He came up to my room.	彼は私の部屋へ上がってきた。
He looked about the house.	彼は家の周りを見た。
He saw a light far away.	彼は遠くに明かりを見た。
He is always on the go.	彼はいつも忙しくしている。
You had best go home early.	早く帰宅すべきだ。
We've run out of water.	水を使い果たしてしまった。
Do you have any questions?	質問はおありですか。
I meant to have come.	私は来るつもりだったのですが。
I go to Tokyo every day.	私は毎日東京に行きます。
I showed her my room.	私は彼女に自分の部屋を見せた。
I live in a rooming house.	私は下宿しています。
I always get up at six.	私はいつも六時に起きます。
I want to live in Italy.	私はイタリアに住みたい。
Don't look into my room.	私の部屋を覗かないでよ。
I'll show you my room.	私の部屋へご案内しましょう。
I have no home to live in.	私には住む家がない。
Let me go my own way.	私には私の道を行かせて下さい。
We love each other.	私たちはお互いに愛し合っています。
I'm seeing you in a new light.	見直したよ。
Your room is out of order.	君の部屋は乱雑だね。
I know what you mean.	君の言わんとすることはわかる。
It is too early to get up.	起きるには早過ぎる。
All my family is very well.	家族一同元気です。
This is a present for you.	プレゼントをどうぞ。
Let's go early, shall we?	はやく出かけましょう。
Don't keep the TV on!	テレビをつけっぱなしにするな！
It is smaller than Tokyo.	それは東京より小さい。
That's one level down.	それはもう一つ下の階ですよ。
John ran into the room.	ジョンは部屋にかけ込んだ。
Where does John live?	ジョンはどこに住んでいますか。
Come here! I mean you.	ここへ来なさい。君のことだ。
Kim is living with Ken.	キムはケンと同居している。
Our TV is out of order.	うちのテレビは調子が悪い。
May they live long!	あの人たちが長生きされますように。
It's a present for you.	あなたへのプレゼントです。
Do you study every day?	あなたは毎日勉強しますか。
You can understand me.	あなたは私を理解できますね。
All but one was present.	１人の他みんな出席した。
What does it mean?	どういうことを意味しているのですか。
Let's not do the work.	その仕事はやらないでおこう。
They are both in the room.	二人は部屋にいます。
There are too many people.	あまりに人が多すぎます
You can't run my life.	僕の人生に口を出さないでくれ。
Do you know what I mean?	僕の言いたいことがわかる？
She came out of the room.	彼女は部屋から出てきた。
She is at home in English.	彼女は英語が得意です。
She gave me a present.	彼女が僕にプレゼントをくれた。
They are on their way home.	彼らは帰宅の途中だ。
He gave me an example.	彼は私に実例をあたえてくれた。
He isn't at home, is he?	彼は家にいないでしょうね。
He has come home just now.	彼はたった今到着した。
He is something in the FBI.	彼はＦＢＩの大物だ。
Does he come home at six?	彼は６時に帰宅しますか。
I know him only by name.	彼の事は名前しか知らない。
He has no house to live in.	彼には住む家もない。
It is good to get up early.	早起きはよいことだ。
I'd like some more water.	お水をもう一杯ください。
Can you order it for me?	取り寄せていただけますか。
Keep up with the times.	時代に遅れないようにしよう。
Where is the changing room?	試着室はどこですか。
We live in New York.	私達はニューヨークに住んでいます。
I am at home every evening.	私は毎晩家にいます。
I go home early every day.	私は毎日早く家へ帰る。
I know him only by name.	私は彼の名前は知っている。
I study English at home.	私は家で英語を勉強します。
My time is running out.	私の時間は切れかかっている。
Let me say what I think.	私の考えを言わせて下さい。
Do you see what I mean?	私の言う意味が分かりますか。
My family is a large one.	私の家族は大家族である。
My house is like yours.	私の家は、君の家と似ている。
Where do you live now?	現在はどちらにお住まいですか。
I can't live without you.	君無しでは生きられない。
Could you let him out?	外に出してやってくれませんか。
Do you have any questions?	何か質問がありますか。
I'll give you a present.	何かプレゼントをあげるね。
Love will come in time.	やがて愛情が生まれるだろう。
You are to get up earlier.	もっと早起きしなさい。
What I mean is this.	ぼくが言わんとするのはこのことだ。
I saw a light far away.	はるか遠くに明かりが見えた。
All but Tom were present.	トムの他はみな出席した。
Does Tony run every day?	トニー君は毎日走りますか。
I'm just another man.	僕はどこにでもいるような男です。
They live there.	だって２人ともそこに住んでいるんですもの。
It's out of the question.	それは問題外で不可能だ。
That is out of the question.	それは問題外だよ。
Of what value is it?	それはどれほど価値があるのですか。
How is your family?	ご家族の皆さんはご機嫌いかがですか。
I'm more in love with you.	あなたへの愛はつのる。
How large is your family?	あなたは何人家族ですか。
When did you get home?	あなたはいつ家へ帰りましたか。
Were you home at ten?	あなたは１０時に家にいましたか。
We had a little water.	私たちには水が少しありました。
Each one has a name.	それぞれにちゃんと名前がついてました
Most people know about X.	Xをほとんどの方が御存知だ
I only know him by name.	名前だけでしか彼を知らない。
She comes of a good family.	彼女は名門の出である。
She showed me her room.	彼女は僕に部屋を見せてくれた。
She looked around the room.	彼女は部屋を見回した。
She showed me her room.	彼女は私に部屋を見せてくれた。
She is living in London.	彼女はロンドンに住んでいる。
She lives in the country.	彼女はいなかに住んでいる。
She makes a good living.	彼女はいい暮らしをしている。
They have a large house.	彼らは大きな家を持っている。
They don't know my name.	彼らは私の名前を知りません。
He had no house to live in.	彼は住む家がなかった。
He helped me to move.	彼は私の引っ越しを手伝ってくれた。
Where is he running now?	彼は今どこで走っていますか。
He lives in a large house.	彼は広い家に住んでいる。
He lived here for a time.	彼は一時ここに住んでいた。
He no longer lives here.	彼はもうここに住んでいない。
He has just come home.	彼はちょうど今帰宅したところだ。
He came home just now.	彼はたった今帰宅したところです。
Let him do as he likes.	彼の好きなようにやらせなさい。
Let's do it when he comes.	彼が来たらそれをやろう。
Do other people like me?	他人は私が好きなのだろうか。
Will you make room for me?	席を詰めてくれませんか。
That is a good place to live.	住むべきよい場所。
I study English at home.	私は家で英語の勉強をします。
Don't let go of my hand.	私の手を離してはいけません。
You see what I mean?	私の言っている意味が分かりますよね。
How did you find my house?	私の家はいかがでしたか。
Is there any room for me?	私が入る場所がありますか。
You'd better go in person.	君自身が行った方がいい。
I ordered you to get out.	君に出て行けと命じたのだ。
Don't you move from here.	君ここを動くんじゃないぞ。
Can you find your way home?	帰り道は分かりますか。
I'd like something light.	何か軽いものがいいですか。
You should keep to the right.	右側を通るべきだ。
Love me little, love me long.	愛は小出しにせよ。
Let's do it another time.	もう一回それをしましょう。
Tom helped me to move.	トムは引っ越しを手伝ってくれた。
We'd better go home now.	そろそろ家へ帰るほうがよい。
Say it in another way.	それを他の言葉に言い換えなさい。
Let me have a look at it.	それを私に見せてください。
It has my name on it.	それには私の名前が書いてあります。
What do you mean by that?	それ、どういう意味ですか。
I will do it by all means.	ぜひそれをやりましょう。
Steve was loved by all.	スティーブは誰からも愛された。
Steve did not come home.	スティーブは帰宅しなかった。
We saw a light far away.	ずっと遠くに明かりが見えた。
Let me think for a while.	しばらく考えさせて下さい。
Can I take your order now?	ご注文はよろしいですか。
How about your family?	ご家族のみなさんはいかがですか。
This will set a good example.	これは模範となる。
This is smaller than that.	これはあれよりも小さい。
Are you on the level, Ken?	ケンさん、君は本気かい。
They came into the house.	かれらが家にはいって来た。
I didn't get your name.	お名前が聞きとれませんでした。
You can go home now.	あなたはもう家に帰ってもいいですよ。
I don't mean you.	あなたのことをさして言っているのではない。
You came out of the room.	あなたが部屋から出てきた。
You came into my room.	あなたが、私の部屋に入ってきた。
3 to the third power is 27.	３の３乗は２７である。
All but one were present.	一人を除いて全員出席した。
Even so, you are a human.	それでも、おまえは人間だ。
At present, he is in Canada.	目下彼はカナダにいる。
Let's think out another way.	別の方法を考え出そう。
To see her is to love her.	彼女を見れば、好きになる。
You've got to see her home.	彼女を家まで送らなきゃ。
She comes from a good family.	彼女は良家の出身だ。
He loved her very much.	彼女は彼にたいへん愛されていた。
She is living in London.	彼女は今ロンドンに住んでいる。
Where does she live now?	彼女は今どこに住んでいますか。
She came home just now.	彼女はたった今帰ったところです。
She always gets up at six.	彼女はいつも６時に起きる。
He is always on the move.	彼は少しもじっとしていない。
What does he mean to do?	彼は何をしようとしているのか。
He no longer lives here.	彼はもはやここに住んでいない。
He is at home in French.	彼はフランス語に精通している。
He will by no means come.	彼はけっして来ないでしょう。
He's always looking at you.	彼はいつも君を見ている。
He loves you very much.	彼はあなたをとても愛しています。
You had better get up early.	早く起きるほうがよい。
Can you make room for me?	席をつめていただけませんか。
Don't make light of life.	生命を軽んじてはいけません。
Shall I get you some water?	水をお持ちしましょうか。
Do you have any small change?	小銭をお持ちですか。
I study English every day.	私は毎日英語の勉強をする。
I showed him into the room.	私は彼を部屋に案内した。
I had to get up early.	私は早く起きなければならなかった。
I want to have my own room.	私は自身の部屋がほしい。
I don't understand English.	私は英語がわかりません。
Don't come into my room.	私の部屋の中へ入ってこないで。
There is no TV in my room.	私の部屋にはテレビがない。
My home is in the country.	私の家はいなかにあります。
We study English every day.	私たちは毎日英語を学ぶ。
We used to live in Kobe.	私たちは以前神戸に住んでいた。
We have found the Messiah.	私たちは、メシアにあった。
You know what I mean.	私が何を言いたいかおわかりでしょう。
Don't let your feelings show.	喜怒哀楽を見せるな。
Give me a light, would you?	火を貸してくれませんか。
There is no place like home.	家程良いところはない。
There is no place like home.	わが家にまさる所なし。
Lincoln is a great person.	リンカーンは偉大な人です。
Give me a little more water.	もう少し水をください。
Tom came home just now.	トムはたった今帰宅したところだ。
There were so many people.	たいへん多くの人々がいた。
The house is owned by him.	その家は彼が所有している。
Let's go and see him there.	そこへ彼に会いに行こう。
Can you order one for me?	じゃあ注文してもらえますか。
We'd better get a move on.	さっさと行ったほうがいい。
This is a present for you.	これは君へのプレゼントだ。
What time did you come home?	いつ帰宅したのですか。
Take England for example.	イギリスを例にとって見よう。
Do you live in Sasayama?	あなたは篠山に住んでいますか。
Come to my house at eight.	８時に私の家に来て下さい。
I found them all but one.	１つを除いて全部見つかった。
She lives in New York.	彼女はニューヨークで暮らしている。
They are thinking something.	彼らがなにかを考えている
I just can't understand it.	私には全く理解が出来ません
Such person was there too.	あそこにもそんな奴が１人居た
Mr. Yamada always said 〜.	〜といつも山田先生が仰いました
I don't live in Maigo now.	現在は舞子に住んでいません。
I can't find what I want.	欲しいものが見つからないんだ。
Keep the room in good order.	部屋を整頓しときなさい。
Don't run around in the room.	部屋の中で走り回るな。
Can I go out of the room?	部屋からでてきてもいいですか。
Keep as many as you need.	必要なだけおもち帰りください。
They moved to a new house.	彼等は新しい家へ引っ越した。
She has something different.	彼女は他の人と一味違う。
She was at home in English.	彼女は英語に堪能であった。
Does she always go there?	彼女はいつもそこに行きますか。
Her name was Agnes then.	彼女の名前は当時アグネスだった。
I found out where she was.	彼女が何処にいるかが解った。
They moved to a new house.	彼らは新しい家に引っ越した。
They have no house to live in.	彼らは住む家がない。
Do they love each other?	彼らはお互いに愛し合っているの？
He likes to live in Tokyo.	彼は東京に住むのが好きです。
He does not live in Sendai.	彼は仙台に住んではいない。
He came home just now.	彼はちょうど今、帰ってきたところだ。
He came back last August.	彼はこの前の８月に戻ってきた。
It is always the case with him.	彼はいつもそうだ。
Will he come home at six?	彼は６時に帰宅するでしょうか。
Let him say what he will.	彼に言いたい事を言わせておけ。
He has no room to study in.	彼には勉強する部屋がない。
I would like some more water.	水のお代わりを下さい。
We want a house of our own.	自分たちの持ち家が欲しい。
I'd like to order the same.	私も同じものを注文します。
I can't help loving her.	私は彼女を愛さずにはいられない。
I know where he lives.	彼がどこに住んでいるのか知ってるよ。
I'll work as long as I live.	私は生きている限り働く。
I'll never let you down.	私は決してあなた失望させません。
Do you know what I mean?	私の言いたいことが分かりますか。
We lived in Paris before.	私たちは以前パリにすんでいた。
We had little water.	私たちには水が少ししかありませんでした。
Love me little, love me long.	細く愛して長く愛して。
Go and see him in person.	行って直接彼に会ってきなさい。
Light has come into the world.	光が世にやって来た。
The old house was taken down.	古い家が取り壊された。
We work for our living.	我々は生活のかてを得るために働く。
There's no place like home.	我が家ほどいいものはない。
Will you give me a light?	煙草の火を貸してくれませんか。
There is no place like home.	わが家にまさる所はない。
I should have come earlier.	もっと早く来るべきだった。
It's time for us to go home.	もう私たちが帰る時間だ。
You may as well go home now.	もう帰ったらどうですか。
Mary understands Chinese.	メアリーは中国語がわかります。
Tom helped me to move.	トムは私の引っ越しを手伝ってくれた。
Let me have a look at it.	それをちょっと見せてください。
It is out of the question.	それはとてもできない相談だ。
The old man said something.	その老人は何か言いました。
John lives in New York.	ジョンはニューヨークに住んでいる。
Is Mr Schmidt at home now?	シュミット氏はご在宅ですか。
Jane is loved by Peter.	ジェーンはペーターに愛されている。
Now let's get down to work.	さあ、仕事にとりかかろう。
This is as large as that.	これはあれと同じくらい大きい。
This house has six rooms.	この家には部屋が６つあります。
Canada is larger than Japan.	カナダは日本より大きい。
What time do you go home?	あなたは、何時に帰宅しますか。
Let me give you an example.	あなたに例を示しましょう。
Archie made a move on her.	アーチーは彼女に言い寄った。
I can't understand X at all.	Xが私には全く理解できない
Just 13 people? That's all?	１３人？たったそんだけかよ。
Can I get you another one?	別のを買わせてもらえるかなあ。
She changed her name to Ann.	彼女は名前をアンに変えた。
She lives in a large house.	彼女は大きな家に住んでいる。
She gave us a present.	彼女は私たちにプレゼントをくれました。
She lives in a large house.	彼女は広い家に住んでいます。
She came to like the house.	彼女はその家が好きになった。
I would like to know her name.	彼女の名前を知りたい。
He is a man of understanding.	彼は物わかりのよい人だ。
Japan is smaller than Canada.	日本はカナダより小さい。
Is Mr Fujiwara at home now?	藤原氏は今ご在宅でしょうか。
Many hands make light work.	多くの人手は仕事を軽くする。
Could you show me another one?	他のを見せてください。
Getting up early is very good.	早起きはたいへんよい。
I'm used to getting up early.	早起きになれているから。
You should have come earlier.	早くこればよかったのに。
There were fifty persons in all.	全部で５０人いた。
What did you do last Sunday?	先週の日曜日は何をしたの？
Many hands make light work.	人手が多ければ仕事は楽しい。
I'll never let you down.	私は決してあなたを失望させません。
I can't keep up with you.	私はあなたにはついていけません。
I can't live without you.	私はあなたなしでは生きられない。
I have four people in my family.	私は４人家族です。
I'm used to getting up early.	私は早起きになれている。
When he saw me, he ran away.	私の姿を見ると彼は逃げた。
What did you open it with?	君はそれをなにで開けましたか。
I don't get what you mean.	君の言いたいことが分からない。
Something is being looked for.	何かが求められている。
I've got something on you.	俺はお前の尻尾をつかんでいる。
My love has gone far away.	俺の愛は遠くに行ってしまった。
It's you I'll always love.	俺が愛するのは永遠にお前だけ。
Mayuko came out of the room.	マユコが部屋から出てきた。
Get up as early as you can.	できるだけ早く起きなさいよ。
Let's get out of here.	ちょいとここらで河岸をかえましょうや。
Let's not think like that.	そんな風に考えるのはやめよう。
It moved closer and closer.	それはだんだん近づいてきた。
He gave it a new name.	そこで彼は、それに新しい名前を付けた。
But now I live in Tokyo.	しかし、今住んでいるのは東京です。
Give my love to your family.	ご家族の皆さんによろしく。
I have no further questions.	これ以上質問はありません。
Let this be an example to you.	これを戒めとしなさい。
What goes on in this room?	この部屋で何が起こるのですか。
What does this kanji mean?	この漢字はどういう意味ですか。
Twenty families live here.	ここには２０家族が住んでいる。
Did you use to live here?	ここにかつて住んでいたのですか。
Let's go back the way we came.	来た道を戻りましょう。
You get up early, don't you?	あなたは早起きでしょうね。
I didn't get your name.	あなたの名前が聞き取れませんでした。
I want to make love with you.	あなたと愛をかわしたい。
The closest I have is a 38.	３８サイズならあるんですが。
I'd like to change my room.	部屋を代えてほしいのですが。
I've always end up going for X.	Xについつい手が伸びた
Which country are you from?	あなたはどこの国の出身ですか。
I'd like a room in the back.	裏側の部屋に替えてください。
The room was in good order.	部屋はきれいに整頓されていた。
When did you see her last?	彼女を最後に見たのはいつですか。
They work only during the day.	彼らは昼間だけ働きます。
Not all of them are present.	彼らはだれも出席していない。
It is always the case with them.	彼らはいつもそうだ。
Their names are Tom and Ken.	彼らの名前はトムとケンです。
He moved from place to place.	彼は各地を転々と移動した。
He comes here every few days.	彼は数日おきにここに来る。
He has been loved by all.	彼はみんなにずっと愛されています。
Let me go in place of him.	彼の代わりに僕を行かせて下さい。
I'd like to move to the country.	田舎に引っ越したい。
I'm used to getting up early.	早起きには慣れているんだ。
Should we get up earlier?	私達はもっと早く起きるべきだろう。
I live at Akasaka in Tokyo.	私は東京の赤坂に住んでいます。
I did it against my will.	私は自分の意志に反してそれをした。
I see you every now and then.	私はあなたを時々見掛ける。
When did you see him last?	最後に彼にあったのは何時ですか。
Would you make room for me?	座席をつめていただけませんか。
I can't see what you mean.	君の言うことの意味が分からない。
The Kamo runs through Kyoto.	鴨川は京都市を貫流している。
What do you do for a living?	何の仕事をしているのですか。
Can't you do something to help me?	何とかしてよー。
There must be another way.	何か別の方法があるに決まってる。
I didn't mean to do that.	わたしはそうするつもりは無かった。
Mary has just come home.	メアリーはただいま戻ったところです。
Will you let me see you again?	また会ってもらえるかな？
Let's make it some other time.	またの機会にしましょう。