Study!	勉強しなさい。
I run.	私は走ります。
I try.	頑張ってみる。
Action!	演技はじめ！
See more.	続きを見る
Hands off.	触るな！
I do run.	私は走る。
Open up.	開けてくれ。
But why?	しかしなぜ。
Get down!	床に伏せろ！
We try.	私たちは、試す。
Why me?	何でわたしなの？
Why me?	どうして私なの？
I love you.	愛してる。
Hands up!	両手をあげろ！
Keep out!	立ち入り禁止。
Who cares?	知るもんか。
I'll pay.	私が払います。
Of course.	もちろんさ。
Why not?	なぜいけないか。
How big?	どのくらい広い？
My stars!	これは驚いた。
Is this love?	恋かな？
Keep out.	立ち入りを禁ず。
Take care!	用心しなさい。
No problem!	問題ないよ。
She tried.	彼女は試した。
He does run.	彼は走る。
He did run.	彼は走った。
I love you.	大好きだよ！
Go on board.	乗船する。
All right.	承知しました。
I love you.	君が好きだ。
Take care.	気を付けてね。
Why not?	どうしてダメなの？
Take care.	お体を大切に。
Take care.	お気をつけて。
Do you? Why?	本当？なぜ？
Don't study.	勉強するな。
Don't ask.	聞かないでくれ。
I like him.	彼が好きです。
Is it white?	白いですか。
No problem!	大丈夫ですよ。
I saw him.	私は彼に会った。
Mary ran.	メアリーは走った。
Get him!	そいつをつかまえて！
You do run.	あなたは走る。
Get real!	冷静に考えて見ろよ！
You must go.	君が行くのだ。
I'm so full.	もう満腹です。
It's white.	それは白いです。
No problem!	お安い御用です。
He is old.	彼は年を取っている。
I said so.	私はそう言いました。
I can't say.	何とも言えない。
You don't say.	意外だねー。
Keep it up!	その調子で続けて。
You said it!	そう！その通り。
Now tell me.	さあ話したまえ。
I want money.	お金が欲しい。
I love you.	あなたを愛してる。
I love you.	あなたが好きです。
There are many X.	Xが多い
He tries to X.	彼がXを試みる
He must be X.	彼がXに違い無い
It's a problem.	問題だなあ。
Make it real.	本物を追求しろ。
Is he right?	彼は正しいですか。
Large or small?	大か、小か。
I will join it!	出席します。
Time presses.	時間が押してる。
I help him.	私は彼を手伝います。
Check it out!	君も見てごらん！
Who cares?	だれが気にするもんか。
The same to you.	ご同様に。
He will try X.	彼がXに挑戦する
Check, please.	勘定書を頼むよ。
Might is right.	力は正義なり。
Do you love me?	僕のこと好き？
He loves her.	彼は彼女が好きだ。
How old is he?	彼はいくつなの？
Have him come.	彼に来てもらえ。
Act your age.	年相応にふるまえ。
This is life!	生きててよかった！
Do you love me?	私を愛してる？
I love Hitomi.	私は瞳が好きだ。
I love you.	私は、貴方が好きです。
How's your job?	仕事どうなの？
You look down.	元気がないわね。
I love you.	君のことが好きなんだ。
How many people?	何人ですか。
How old are you?	何歳ですか。
What did you say?	何だって。
You all right?	よろしいですか。
I love you.	だって好きなんだもの。
Keep it up.	その調子でがんばって。
Just right here?	この場所に？
Come right in.	お入りください。
It saved me.	おかげで助かったよ。
I sold a book.	私は本を売った。
Why do you ask?	なんで聞くの？
I go every year.	毎年行きます。
He did right.	彼は正しく行動した。
He is driven.	彼はやる気満々です。
I called him up.	彼に電話した。
All are present.	全員出席です。
I love her.	私は彼女に恋をしている。
I like both.	私はどちらも好きです。
I love you.	私はあなたを愛している。
I am off today.	今日は休みです。
I did see him.	確かに会いました。
All sold out!	みんな売り切れです。
See you next week!	また来週！
Is Bob right?	ボブは正しいですか。
Who cared?	だれが気にかけたでしょう。
Don't be long.	すぐ戻ってこいよ。
Don't run here.	ここでは走るな。
Check, please.	お勘定して下さい。
Ask Alex.	アレックスに聞いてみなさい。
I'll ask Tom.	トムに聞いてみます。
You're right.	おっしゃる通りです。
I don’t drive.	私が車の運転をしない
He told me X.	彼がXを私に告げました
Close your book.	本を閉じなさい。
I have much to do.	僕は忙しい。
Show him in.	彼を中に御案内しなさい。
I don't see him.	彼を見ていない。
How old is he?	彼は何才なんですか？
Do you know him?	彼の知人ですか。
He is well paid.	彼の給料はいい。
Do you want him?	彼にご用ですか。
Why not try it on?	着てみない？
Don't be long.	早く帰ってきなさい。
Check, please.	清算をお願いします。
I want some water.	水が欲しい。
Get your hands off!	手を離せ！
May I try it on?	試着できますか。
I need some paper.	紙がほしい。
I like history.	私は歴史が好きだ。
I am studying.	私は勉強しています。
I like to run.	私は走るのが好きだ。
My house is big.	私の家は大きい。
Isn't it black?	黒くないのですか。
Go to the park.	公園に行きなさい。
I told you before!	言っただろ！
Give me your money.	金出せよ。
Look up more.	もっと上を向きなさい。
I'll say no more.	もう言うまい。
Love to party!	パーティーが大好き。
On what account?	どう言うわけで？
Keep the change!	つりは要らんよ。
I don't care.	ちっとも構いませんよ。
This book is old.	この本は古い。
When does it end?	いつ終わるの？
I know him.	あたしは彼を知っています。
I am 19 years old.	１９歳です。
Say 'ahhh'.	「アー」といってください。
"Age?" "16."	「何歳？」「１６歳です」
Today is Sunday.	今日は日曜日だ。
There are more X.	Xのほうが、多い
People think so.	人には、そう見える
My level is low.	自分のレベルが低い
All is still.	万物が静まり返っている。
May I join you?	僕も一緒にしていい？
She gave money.	彼女はお金を与えた。
Do I know him?	彼を知っているかって？
He has big hands.	彼は手が大きい。
He is my friend.	彼は私の友達です。
He did say so.	彼は確かにそう言った。
P. S. I love you.	追伸愛してます。
No one can tell.	誰にも分からない。
Are you all right?	大丈夫ですか？
How about running?	走りませんか。
Don't be long.	早く帰ってきなさいよ。
I run every day.	私は毎日走ります。
I'm free today.	私は今日はひまです。
I go to the park.	私は公園に行く。
I am, of course.	もちろん、私です。
Get to the point!	はっきり言えよ。
What did you say?	なんて言ったの？
Just the same!	どっちでも同じことだ。
Is this my life?	これが人生なのか。
Here's my card.	これが私の名刺です。
I do love you.	あなたが好きなのです。
This is Room 839.	８３９号室です。
How did you reply?	何て答えたの？
I'll ask Tom.	トムに頼むことにします。
I'll ask Tom.	トムにお願いしようかな。
I'll ask Tom.	トムに訊いてみようっと。
They are both good.	両方ともよい。
The light is on.	明かりがついている。
They are in class.	彼等は授業中だ。
She loves Tom.	彼女はトムを愛している。
Did you know him?	彼をご存知だった？
He came running.	彼は走りながら来た。
He has a good hand.	彼は手がよい。
He works under me.	彼は私の部下だ。
He is off today.	彼は今日は休みです。
He had no money.	彼はお金がなかった。
May I try it on?	着てみていいですか。
He must not live.	生かしてはおかぬ。
The stars came out.	星が出てきた。
I'm out of control.	制御できない。
Some water, please.	水をください。
There is no water.	水が少しもない。
A man must work.	人は働かねばならぬ。
We ran out of food.	食糧が尽きた。
I pointed at him.	私は彼を指さした。
I work with him.	私は彼と仕事をする。
I play with him.	私は彼と一緒に遊ぶ。
I want to drive.	私は車を運転したい。
Come to my house.	私の家へ来なさい。
I have a family.	私には家族がいます。
I'm game for it.	私にはその気がある。
We made him go.	私たちは彼を行かせた。
I have a problem.	困ってるんだよね。
Your loving friend.	君の親友より。
Check, please.	勘定書を持ってきてくれ。
Please try one.	一度食べてみて下さい。
Don't ask me why.	わけは聞かないで。
See you around.	またお会いしましょう。
They asked him.	彼らは彼に聞きました。
That is well said.	まさにその通り。
What's your job?	どんなお仕事ですか。
They are very big.	とても大きいね。
Don't say that.	そんなこと言わないで。
Set it down there.	それを下に置け。
I'll tell him that.	そう伝えます。
Go in the field.	この道を行きなさい。
I'll pay for it.	ここは私が払います。
Today is Sunday.	きょうは日曜日です。
That is a table.	あれはテーブルです。
You make a box.	あなたは箱を作ります。
I'll go ask Tom.	トムに訊いてくるよ。
I am experienced.	私には経験が有ります
The time is right.	時間がちょうど良い
I'm aging well.	相応にいい歳をとってきた
I found many X.	Xが幾つも目に付きました
I need more time.	もっと時間が必要だ。
You look contented.	満足そうですね。
Don't open your book.	本を開くな。
Don't tell on me.	僕の告げ口をするな。
I think I'm right.	僕が正しいと思う。
How is your life?	暮らしはどうですか。
She told Tony.	彼女はトニーに言いました。
He is her friend.	彼は彼女の友達です。
He is in the money.	彼は大金持ちだ。
He looked around.	彼は周りを見渡した。
He looked around.	彼は左右を見回した。
He is full of go.	彼は元気いっぱいだ。
He is in the House.	彼は議員である。
What did he say?	彼は何と言いましたか。
He is still here.	彼はまだここにいる。
How big he is!	彼はなんて大きいのだろう。
Act your age.	年に似合った行動をしなさい。
The light is out.	電球がきれています。
May I try it on?	着てみてもいいかしら？
Who doesn't know?	知らぬ者がいようか。
All were present.	全員が出席していた。
Take my word for it.	信じてくれよ。
Show your cards.	手の内を明かしなさい。
Who plays the lead?	主演は誰ですか。
Next person, please.	次の方どうぞ。
I have no friends.	私は友達がいない。
I made him go.	私は彼を無理にも行かせた。
I am the same age.	私は同じ年齢です。
I am in the house.	私は家の中にいる。
I study English.	私は英語を勉強します。
I like it black.	私はブラックが好きだ。
About three weeks.	三週間ぐらいです。
I'll come right now.	今すぐ行くよ。
Do as I told you.	言ったとおりにしろ。
You keep out of this.	口を出すな。
Don't tell me.	言わなくてもわかりますよ。
What're you saying?	何を言ってるの！
May I join you?	一緒に行っていいですか。
I need more time.	もっと時間が欲しい。
Bob is my friend.	ボブは私の友達です。
Well, I loved it.	なかなか良かったよ。
Study on and on!	どんどん勉強しなさい。
How old is Tony?	トニー君は何歳ですか。
Please have a try.	どうぞやってみて。
Try and do it.	それをやってごらんなさい。
That is all right.	それは申し分ない。
That's the point.	それが重要な点です。
Tell me about it.	そのことを話してよ。
All was still.	すべてのものが静かだった。
How old is he then?	じゃあ何歳なの？
Here's the address.	これが住所です。
This book is small.	この本は小さい。
Kumi made a box.	クミは箱を作りました。
Keep the change.	お釣りは取っておいて。
In about two weeks.	およそ２週間で。
Those are my CDs.	あれは私のCDです。
That is her house.	あれは彼女の家だ。
What is the problem?	何が問題なの？
I'll go ask Tom.	トムに訊いてきますね。
X has started acting.	Xが行動に出る
I was offered a job.	仕事の話を頂いた
Many people like X.	Xを多くの人が好む
It's about one month.	約１ヶ月です。
It'll be a big day.	明日は大切な日だ。
He came in person.	彼本人がやってきた。
She didn't reply.	彼女は返答しなかった。
She took my hand.	彼女は私の手を取った。
She ran second.	彼女は競走で２着になった。
Give my love to her.	彼女によろしく。
What did she say?	彼女は何て言ったんだ？
Give him time.	彼を長い目で見てやりなさい。
Does he know me?	彼は私を知っていますか。
He is my Mr Right.	彼は私の理想の人よ。
He is running now.	彼は今走っています。
How old he is!	彼はなんと年をとったことか。
He was very old.	彼はとても年老いていた。
He asked for money.	彼はお金を求めた。
Tell me about him.	彼のことを話してよ。
Look into the box.	箱の中をみてごらん。
Get out of my life!	二度と顔を出すな。
Hand in your papers.	答案を提出せよ。
The lights are out.	灯りが消えている。
I long for company.	私は相手が欲しい。
Do what is right.	正しいことをしなさい。
This is the life.	人生、こうでなくちゃ！
Can I try this on?	試着していいですか。
We know him.	私達はその人のことを知っている。
I gave him a call.	私は彼に電話をした。
I study at school.	私は学校で勉強する。
I must go out.	私は外出しなければならない。
I have no money.	私はお金をもっていない。
What's the material?	材質は何ですか。
It is Monday today.	今日は月曜日です。
Set off right now.	今すぐ出かけなさい。
You study English.	君は英語を勉強する。
Since you say so.	君がそう言うんだから。
It's all right.	気にしなくていいんですよ。
Why do you think so?	何故そう思うの？
Keep to the right.	右側通行をしなさい。
That's a class act.	一流の腕前ですね。
Of course, you may.	もちろんいいとも。
Of course, you may.	もちろん、いいよ。
I'll tell you what.	まあ、聞きなさい。
Tom drove the car.	トムは車を運転した。
I like it very much.	とても好きです。
Where can I park?	どこに駐車できますか。
How was your test?	テストはどうだった？
I thought as much.	そんな事だと思った。
Ask him about it.	それは彼に尋ねなさい。
Is it not black?	それは黒くありませんか。
What is the story?	それは何の話ですか。
How long it is!	それはなんて長いんだろう。
Get down from there.	そこから降りろ！
Size 9, I think.	サイズは９だと思います。
Here's some water.	ここに水が少しある。
Those are my books.	あれは私の本です。
That's our house.	あれは私たちの家です。
Look at that house.	あの家を見なさい。
That house is big.	あの家は大きいです。
Can you drive?	あなたは車を運転できますか。
When do you run?	あなたはいつ走りますか。
I see your point.	あなたの主旨はわかる。
I tell you this.	あなたに言っておきます。
I must buy one.	１台買わなければならない。
We're out of stock.	在庫がありません。
Please study here.	ここで勉強しなさい。
I have back problems.	腰痛持ちです。
Did you ask the price?	値段聞いた?
Many people say 〜.	〜とみんなが口を揃える
I can see the light.	目から鱗が落ちた。
I looked around me.	僕は周りを見回した。
The law was changed.	法律が改正された。
I get her point.	彼女の話しの確信をつかむ。
They made him work.	彼らは彼を働かせた。
They are my friends.	彼らは私の友人だ。
He shares a room.	彼は部屋を共有している。
He has a large family.	彼は大家族だ。
He doesn't know me.	彼は私を知りません。
He is at home today.	彼は今日家にいる。
He is a man of action.	彼は行動家だ。
What does he do?	彼は何をしている人ですか。
Is he still here?	彼はまだここにいますか。
He is about my age.	彼はほぼ私の年です。
He ran on and on.	彼はどんどん走り続けた。
He has no money.	彼はお金を持っていません。
He travels around.	彼はあちこち旅行する。
Long may he live!	彼の命の長からんことを。
How big is he?	彼の大きさはどのくらいですか。
I will have him come.	彼に来てもらう。
Please call him up.	彼に電話して下さい。
I got to know him.	彼と知り合いになった。
May he live long!	彼が長生きしますように。
Tokyo is a big city.	東京は大都市です。
I've changed my job.	転職をしたんです。
Join us, won't you?	仲間に入りませんか。
Who runs the show?	誰が会社の経営者かね。
You may be right.	多分君が正しいのだろう。
It is a small world!	世間は狭いですね。
Man is 70% water.	人間は７０％水なんだよ。
We all like him.	私達はみんな彼がすきです。
I ran for my life.	私は命からがら逃げた。
I don't love her.	私は彼女を愛していない。
I call him Mike.	私は彼をマイクと呼びます。
I made him do so.	私は彼にそうさせました。
I returned to Japan.	私は日本に戻った。
I am studying now.	私は今勉強をしている。
I thought as much.	私はそのように考えた。
Come into my room.	私の部屋に入りなさい。
Will you tell me?	私に話してくれませんか。
I am free from care.	私には心配がない。
We're old friends.	私たちは幼なじみです。
We study music.	私たちは、音楽を勉強します。
Do as I tell you.	私が言うようにしなさい。
It's Saturday today.	今日は土曜日です。
I'll come right now.	今すぐに参ります。
You are allowed to go.	行ってもよい。
Do as you are told.	言われたようにせよ。
Will you join us?	君も仲間に入りませんか。
Do you love music?	君は音楽が好きですか。
Don't ask for money.	金をくれというな。
I have a little money.	金は少しある。
I have little money.	金は少ししかない。
I did write to him.	確かに書きましたよ。
Why didn't you come?	何故来なかったの？
No music, no life.	音楽がない人生は無い。
I took a week off.	一週間休んでいました。
Rome is an old city.	ローマは古い街だ。
Come and join us.	ふるってご参加ください。
The party is over.	パーティーは終わった。
What a friend you are!	なんて友人だ。
No, it's second hand.	なに、中古だよ。
Why is he here?	なぜ彼はここにいるのですか。
Why do I even care?	なぜ頭から離れない。
Any paper will do.	どんな紙でも結構です。
Please don't bother.	どうぞお構いなく。
Please, tell me.	どうぞ、私に話して下さい。
It's under the table.	テーブルの下よ。
It is just an act.	それは芝居にすぎない。
Tell me the story.	その話を聞かせなさい。
Tell me about it.	そのことを話して下さい。
I'll be right back.	じきに戻って来ます。
These cars are big.	これらの車は大きい。
This is an old book.	これは古い本です。
You can park here.	ここに駐車できますよ。
Just sign here.	ここにサインをお願いします。
Keep to the right.	ここでは右側通行です。
Our money ran out.	お金がなくなってきた。
Am I not right?	おれの言うとおりではないか。
You will study.	あなたは勉強するつもりです。
How old are you?	あなたの年齢は何歳ですか。
I have two friends.	私には友達が２人います
Users can check X.	Xをユーザーが確認できる
He will save the world.	彼が地球を救う
We are allowed X.	Xが私たちに許されています
I'm much better at it.	俺の方が全然上だ
She isn't running.	彼女は今走っていません。
She is five years old.	彼女は五歳です。
What does she do?	彼女はなにをしていますか。
I must help him.	彼をてつだってあげなければ。
They are the same age.	彼らは同い年だ。
They had no food.	彼らには食べ物が無かった。
He is my close friend.	彼は僕の親友だ。
He ran up to her.	彼は彼女の所に駆け寄った。
He is close with her.	彼は彼女と親密だ。
He asked for food.	彼は食物をくれと頼んだ。
He can drive a car.	彼は車の運転ができる。
He drove to school.	彼は車で学校へ行った。
He's good at cards.	彼はトランプがうまい。
He is on the team.	彼はそのチームの所属だ。
He did not say so.	彼はそうは言わなかった。
He got a new job.	彼に新しい勤め口があった。
I found him a job.	彼に職を見つけてやった。
I gave him the book.	彼にその本をあげた。
May I go with him?	彼といってもよろしいか。
I saw him running.	彼が走っているのを見た。
Why don't you come in?	入っておいでよ。
Hand in your papers.	答案を出して下さい。
There's a big sign.	大きな看板があります。
Down with the Government!	政府打倒。
I'd like some water.	水が欲しいのですが。
Act your place.	新米のくせに大きな顔をするな。
Keep your hand still.	手を動かさないで。
What's the story?	事の次第はどうなんですか。
We studied English.	私達は英語を勉強した。
I have to study.	私は勉強する必要があります。
I ran for my life.	私は必死になって逃げた。
I gave him a book.	私は彼に本を一冊やった。
I saw him go out.	私は彼が出て行くのを見た。
I came to like him.	私は彼が好きになった。
I saw him last week.	先週彼に会いました。
I am an office worker.	私は会社員です。
I'm checking out.	私はチェックアウトします。
I'm right, aren't I?	私の言う通りだろう？
My family is small.	私のうちは小人数です。
We're the same age.	私たちは同じ年齢です。
I'll take care of it.	私がご馳走します。
I'm not free today.	今日は都合が悪いんだ。
What's the day today?	今日は何日ですか。
Who's the DJ today?	今日のＤＪは誰ですか。
You can study here.	君はここで勉強できる。
How is your family?	家族の皆さんはお元気？
Don't make light of me.	俺をなめるな。
He took a week off.	一週間の休みをとった。
Come closer to me.	もっと私の側に来なさい。
No more parties.	もうパーティーはなしですよ。
I want some money.	ぼくはお金がほしいのだ。
I'm in need of money.	ぼくはお金がいる。
Tom is in the house.	トムは家の中に居る。
Please don't bother.	どうぞおかまいなく。
The TV doesn't work.	テレビがつかないよ。
I tried to tell you.	だから言っただろう。
What's the point?	そんなことして何になるの？
May I try it on?	それを着てみてもいいですか。
That's very big of you.	それは有難い。
Judy likes him.	ジュディーさんが彼を好きです。
How is your family?	ご家族はお元気ですか。
No more can be said.	これ以上は言えない。
This is their house.	これは彼らの家です。
This car sells well.	この車はよく売れる。
He must love you.	彼はきっと君が好きなんだ。
I see your point.	お話の要点は分かりました。
Who is that old man?	あの老人は誰ですか。
Are you studying?	あなたは勉強していますか。
Do you know him?	あなたは彼を知っていますか。
Where is Room 105?	１０５号室はどこですか。
Do you have a family?	ご家族はいますか。
There is still no reply.	まだ返事が無い
I try to make time.	私が何とか時間を作ります
The price is still high.	まだ価格が高い
The food is so good!	とにかくご飯が美味しい
It's well cared for.	充分に手入れが行き届く
Why don't we go home?	家に帰りましょうか。
To change the subject.	話はかわりますが。
It is a long story.	話せば長いことなのです。
I want to buy another.	別なのを買いたい。
She gave it to him.	彼女は彼にそれを与えた。
She lived a long life.	彼女は長生きした。
She made me a star.	彼女は私をスターにした。
Does she know you?	彼女は君を知っていますか。
What does she do?	彼女は何をしているんですか。
She is aged seventeen.	彼女は１７歳です。
She knew the teen.	彼女は、ティーンを知った。
She's got a point.	彼女のいうことは一理ある。
Don't tell her about it.	彼女に言うな。
She acted as a guide.	彼女が案内役をした。
Does he live here?	彼は当地に住んでいるのか。
He is my close friend.	彼は親しい友人だ。
He signed the check.	彼は小切手に署名した。
He is my old friend.	彼は私の古い友達です。
He may come today.	彼は今日来るかもしれない。
He is a man of action.	彼は行動力がある。
He is an office worker.	彼は会社員です。
He is good at driving.	彼は運転が上手だ。
He took a week off.	彼は一週間休みをとった。
He lives close by.	彼はすぐ近くに住んでいる。
He lives close by.	彼はすぐそばに住んでいる。
I know him by name.	彼の名前を知っています。
I know him by name.	彼の名前は知っています。
Where does he work?	彼の勤め先はどこですか。
He is free from care.	彼には心配事がない。
Can he do this job?	彼にこの仕事ができるか。
May I open the box?	箱を開けてもいいですか。
What is in the box?	箱の中に何がありますか。
Give your papers in.	答案を提出して下さい。
No one was present.	誰も出席していなかった。
Who made this box?	誰がこの箱を作りましたか。
The more, the better.	多ければ多い程よい。
I have some gifts.	贈り物を多少持っています。
It's a small world.	世の中は狭いものですね。
Water finds its level.	水は低きに流れる。
Where is the library?	図書館はどこですか。
Is this your first visit?	初診ですか。
Take your hands off me.	手を離してくれ。
What's the room rate?	室料はいくらですか。
Time runs on.	時間というものは早く経過するものだ。
Time is running out.	時間が無くなってきた。
We need the money.	私達はお金が必要なのです。
I am not up on history.	私は歴史に弱い。
I have to study.	私は勉強しなければなりません。
I don't like studying.	私は勉強が嫌いだ。
I am as old as he.	私は彼と同じくらいの年だ。
I do not care for him.	私は彼が嫌いです。
I don't have a box.	私は箱を持っていません。
I love reading books.	私は読書が好きです。
It's all right with me.	私は大丈夫です。
I saw her last week.	私は先週彼女に会った。
I am sixteen years old.	私は16歳です。
I am in Tokyo today.	私は今日東京にいます。
I am 30 years old now.	私は今30歳です。
Can you tell my age?	私の年がわかりますか。
We are good friends.	私たちは良い友達です。
We look up to him.	私たちは彼を尊敬している。
Call me this evening.	今晩電話をください。
I got off at the park.	公園で降りました。
Why don't you say it?	言ってみたらどうだ。
Money comes and goes.	金は天下の回りもの。
You study English.	貴方は、英語を勉強します。
What time does it open?	何時開店ですか。
Say it in English.	それを英語で言ってごらん。
Is there a problem?	悪いところがありますか。
Of course I will go.	もちろん私も行きます。
You should make notes.	メモを取りなさい。
They are all the same.	みんな同じなのよ。
Why do you say that?	なぜそんな事を言うの。
Tom is older than I.	トムは私より年上です。
Tom and I are friends.	トムと僕は友達だ。
I like it very much.	とても気に入ってます。
Where can I park?	どこへ駐車すればいいですか。
Check in, please.	チェックインをお願いします。
Can I check in now?	チェックインできますか。
It only costs $10.00!	たった１０ドルだぜ。
I thought as much.	そんなことだと思ってたよ。
You have a point there.	それは一理ある。
It is Pochi's food.	それはポチの食べ物です。
It may be all right.	それでいいと思います。
What's in the box?	その箱に何が入っているの。
What is your address?	ご住所はどこですか。
Can I try this on?	これを試着したいのですが？
This is a small book.	これは小さい本です。
Is that your room?	これはあなたの部屋ですか。
This is much the best.	これが最高なんだ。
This book sells well.	この本はよく売れる。
This book is smaller.	この本の方が小さい。
How long is this?	この長さはどれくらいですか。
Can I study here?	ここで勉強してもいいですか。
Just water, please.	お水だけでけっこうです。
He wants the money.	お金を欲しがっています。
Keep the change.	おつりは取っておいてください。
He's in the money.	うなるほど金を持っている。
Say the word any time.	いつでも合図して。
Is she all right?	あの人は変わりはないですか。
You must not play.	あなたは遊んではいけない。
Do you love me?	あなたは私を愛しているのですか。
When do you study?	あなたはいつ勉強しますか。
What should I say?	何と言ったらいいか・・・。
Why do you love me?	なんで私のこと好きなの？
Why do you love me?	どうして愛してくれるの？
I have back problems.	腰に持病があります。
The server was down.	サーバーが落ちていた。
I've run out of material.	もうネタが無い
I don't have the words.	もう言葉にならない
He takes X into account.	彼がXを踏まえる
Check back next week.	来週またご来店下さい。
Might makes right.	無理が通れば道理が引っ込む。
I'll cover for you.	僕が証人になってあげるよ。
Could I change rooms?	部屋を変えられますか。
Come into the room.	部屋の中に入ってください。
She is loved by him.	彼女は彼に愛されている。
She did well by him.	彼女は彼によく尽くした。
She looked around.	彼女は自身の辺りを見回した。
She is about my age.	彼女は私くらいの年齢だ。
She can drive a car.	彼女は車の運転ができる。
What does she have?	彼女は何を持っていますか。
She studies English.	彼女は英語を勉強します。
She's older than Tom.	彼女はトムより年上だ。
I know her address.	彼女の住所を知っています。
She is free from care.	彼女には心配がない。
They love each other.	彼らは愛し合っている。
They are the same age.	彼らは同じ年齢です。
They are running now.	彼らは今走っています。
He made up the story.	彼は話をでっち上げた。
He ran into the room.	彼は部屋に駆け込んだ。
He has a large family.	彼は扶養家族が多い。
He started a new life.	彼は新生活を始めた。
He is about my size.	彼は私くらいの大きさだ。
Is he studying now?	彼は今、勉強していますか。
Where does he live?	彼はどこに住んでいますか。
He is just my age.	彼はちょうど私と同じ年です。
He was very old.	彼はたいへん年をとっていました。
He ran out of money.	彼はお金を使い果たした。
He asked for money.	彼はお金が欲しいと言った。
He is close to sixty.	彼は６０歳ぐらいです。
He studies Chinese.	彼は、中国語を勉強します。
Do as he tells you.	彼の言うとおりにしなさい。
Don't call him names.	彼の悪口を言わないで。
I handed a map to him.	彼に地図を手渡した。
You didn't see him.	彼に会わなかったのだろう。
He is free from care.	彼には何の心配もない。
When did you see him?	彼にいつ会いましたか。
I'd better see him.	彼とあったほうがいいかな。
I looked into the box.	箱の中を覗き込んだ。
The light doesn't work.	電気がつきません。
I live in the country.	田舎に住んでいます。
Do you like the country?	田舎が好きかね。
Did you ask the price?	値段は聞きましたか。
Who is in this room?	誰がこの部屋にいますか。
Here's your party.	相手の方がお出になりました。
Do that which is right.	正しいことをせよ。
How's your new job?	新しい職場はいかがですか。
We call him Mike.	私達は彼をマイクと呼んでいる。
I am going to study.	私は勉強するつもりです。
I am friends with her.	私は彼女と友達です。
I came to know him.	私は彼を知るようになった。
I will make him go.	私は彼をいかせるつもりだ。
I told him to come.	私は彼に来るように言った。
I have done with him.	私は彼とは手を切った。
I asked who he was.	私は彼が誰であるか尋ねた。
I don't care for him.	私は彼が好きはでない。
I don't care for him.	私は彼が気にくわない。
I like him very much.	私は彼がとても好きだ。
I like Japanese food.	私は日本食が好きです。
I'm paid by the day.	私は日給でもらっている。
I have some money.	私は少しお金を持っています。
I'm a government worker.	私は公務員です。
I bought an old car.	私は古い車を買いました。
I will visit Kyoto.	私は京都を訪れるつもりだ。
I was at the party.	私はパーティーに出席した。
I play video games.	私はテレビゲームをします。
I have many books.	私はたくさん本を持っている。
I must go there.	私はそこへ行かなければならない。
I want some money.	私はいくらかのお金がほしい。
I am paid by the week.	私の給料は週給です。
I have a large family.	私の家族は大人数だ。
We're close friends.	私たちは親しい友人です。
We need some money.	私たちはお金が少し必要だ。
All I want is money.	私が欲しいのは金だけだ。
I'm looking for a job.	仕事を探してるんだ。
I found no job today.	今日は仕事にあぶれた。
Where is today's paper?	今日の新聞はどこ。
This is the last game.	今回が最後の試合だ。
Sales are down now.	今は売り上げが落ちている。
I love what you are.	今のあなたを愛している。
I'm just looking around.	見ているだけだ。
You must not come in.	君は入ってはいけない。
I have little money.	金はいくらも持ってない。
Send me the account.	鑑定書を送ってください。
We are a family of four.	家族は４人です。
I'll drive you home.	家まで車で送りましょう。
What time does it close?	何時閉店ですか。
What time does it start?	何時に始まるの？
I'm studying English.	英語を勉強しています。
May I run with you?	一緒に走ってもいいですか。
Have you got a lighter?	ライター持ってる？
I've had it with him.	もう彼にはうんざりだ。
We have a long way to go.	まだ先は長い。
Mike calls him Ned.	マイクは彼をネッドと呼ぶ。
"Look," she said.	ほら見て。と彼女は言いました。
How did the party go?	パーティの進み具合は。
Why did you do that?	なぜそんなことをしたの。
Why do you study?	なぜあなたは勉強するのですか。
How long does it take?	どれ位かかりますか。
Tony runs every day.	トニー君は毎日走ります。
Who does Tony like?	トニー君は誰を好きですか。
What does Tony do?	トニー君の職業はなんですか。
Please give me a hand.	ちょっと手を貸して。
We are full just now.	ただ今すべて満席です。
We're out of stock now.	ただいま品切れだ。
You're about right.	だいたい君の言うとおりだ。
It is of great value.	それは大変価値がある。
It's not a little money.	そりゃ大金だよ。
You have him there.	その点では君は彼より上だ。
John is as old as I.	ジョンは私と同い年です。
Good. Now go down with it.	じゃ下ろす。
So you give up, right?	じゃ、諦めるんだね。
May I try this on?	これを試着してもいいですか。
What is in this box?	この箱の中に何があるか。
Who owns this house?	この家は誰のものですか。
You may park here.	ここに駐車してもいいですよ。
Can I pay on credit?	クレジットで払えますか。
You can't say no.	おまえは何も否定できないまま。
When did you return?	いつ帰ってきたのですか。
When can I visit you?	いつお訪ねできますか。
Those are our books.	あれらは私たちの本です。
"Five!" says Alex.	アレックスは「５こ」と言う。
I don't have much time.	あまり時間がない。
Are you ten years old?	あなたは十才ですか。
You don't run here.	あなたはここで走りません。
Where is your room?	あなたの部屋はどこですか。
See you a little before 7.	７時前にね。
That'll be around 7:00.	７時頃になります。
Come home before six.	６時に帰ってきなさい。
That's how he said it.	彼が言葉をそう口にした
There are problems with X.	Xに問題が有る
I'm another year older.	自分がまた年をとった
I'm another year older.	私がまた年を取ります
See you in the evening.	また夜に会いましょう
The file size is big.	ファイルのサイズが大きい
There is an increase in X.	Xが多くなった
X has been pointed out.	Xが指摘されています
X takes so much work.	Xになかなか骨が折れます
That's right, isn't it?	ねえ、そうでしょう。
This will cost Euro30.	３０ユーロになります。
Don't change the subject.	話をそらすなよ。
It's five in the evening.	夕方の五時です。
Please show me another.	別のを見せて下さい。
Please change my room?	部屋を替えてください。
She made her point.	彼女は自分の主張をとおした。
She ran out of paper.	彼女は紙を使い果たした。
She is still under age.	彼女はまだ未成年だ。
She still loved him.	彼女はまだ彼を愛していた。
She may well say so.	彼女がそう言うのも当然だ。
They call him Jim.	彼らは彼をジムと呼んでいます。
They study industry.	彼らは、産業を勉強します。
He comes of good stock.	彼は良い家柄の出だ。
He says he will come.	彼は来たいと言っている。
He kept reading a book.	彼は本を読み続けた。
He came into the room.	彼は部屋に入ってきた。
Who does he look like?	彼は誰に似ていますか。
I think he is right.	彼は正しいと私は思います。
He took me by the hand.	彼は私の手をとった。
He is my best friend.	彼は私の一番の友人です。
He took me by the hand.	彼は私の手を掴んだ。
He's the Bach of today.	彼は現代のバッハだ。
It's all up with him.	彼は回復の見込みが無い。
He didn't say a word.	彼は一言も言わなかった。
It is all over with him.	彼はもうだめです。
He is no longer here.	彼はもうここにはいない。
He is made of money.	彼はべらぼうな大金持ちだ。
He asked $5 for it.	彼はそれに五ドルを請求した。
Does he live here?	彼はここに住んでいるのですか。
He will come all right.	彼はきっときますよ。
He is in want of money.	彼はお金が入用です。
He and I share a room.	彼と私は同じ部屋です。
He came into the room.	彼が部屋に入ってきた。
I am eighteen years old.	年齢は１８歳です。
No one can say that.	誰もそんなこといえないよ。
Life is all in all.	生命はかけがえのないものだ。
What is the right time?	正確には何時ですか。
People call him Dave.	人々は彼をデイブと呼ぶ。
I'll give you a check-up.	診察しましょう。
May I set the table?	食事の用意をしましょうか。
I'd like to check in.	手続きをしたいのですが。
What is the next class?	次の時間は何だっけ？
May I use some paper?	紙を借りてもいいですか。
Tell him I'm not in.	私は留守だと伝えて下さい。
I use it every day.	私は毎日それを使っています。
I don't care for him.	私は彼をあまり好まない。
I am older than him.	私は彼より年をとっている。
I gave him my address.	私は彼に住所を教えた。
I found him a job.	私は彼に仕事を見つけてやった。
I paid him the money.	私は彼にその金を払った。
I think he is right.	私は彼が正しいと思います。
I live in a big city.	私は大都会に住んでいる。
I want a little money.	私は少しお金がほしい。
I see much of Takaoka.	私は高生加によく会う。
I've run out of money.	私は一文無しになった。
I like it very much.	私はとても気に入りました。
I study very little.	私はたまにしか勉強しない。
I will give it a try.	私はそれをやってみよう。
My room is very small.	私の部屋はとても狭い。
I take back my words.	私の発言を取り消します。
My car is not running.	私の車は故障している。
My family is an old one.	私の家は旧家です。
We are at home today.	私たちは今日家にいます。
I have no money today.	今日はお金がないんだ。
How was today's game?	今日の試合はどうだった。
The total is one hundred.	合計は１００だ。
You should try to see it.	見ておくべきだ。
Can you drive a car?	君は車の運転が出来ますか。
Do you study English?	君は英語を勉強しますか。
Why can't you come?	君はなぜ来られないのですか。
What you say is right.	君の言うことは正しい。
I have no money on me.	金の持ち合わせがない。
You are my best friend.	貴方は、大親友です。
Could I have the check?	会計をお願いします。
My family are all well.	家族は全員元気です。
I parted with my old car.	愛車を手放した。
He's still fibrillating.	まだ痙攣している。
Are you still around?	まだその辺にいるのかな？
Peter loves Jane.	ペーターはジェーンを愛している。
Who acts Hamlet?	ハムレットの役は誰がやるのですか。
What should I say?	なんと言ったらいいのか・・・。
What a small world!	なんて世界は狭いのでしょう。
Why did I do that?	なぜ私はあんなことをしたのか。
Where will you visit?	どこを訪れる予定ですか。
May you live long!	どうぞ長生きなさいますように。
Why were you there?	どうして君はそこにいたのか。
Don't buy on credit.	つけで買ってはいけません。
It isn't much of a car.	たいした車ではない。
Is it Japanese food?	それは日本の食べ物ですか。
It's for my family.	それは私の家族へのものです。
The house is on sale.	その家は売りに出ている。
Sign your name there.	そこに署名してください。
It's been a long time.	ずいぶんになりますね。
But he needed a job.	しかし、仕事が必要でした。
How about your family?	ご家族はいかがですか。
This room is for VIPs.	この部屋は要人用です。
Please open this box.	この箱を開けてください。
This car must go.	この車を処分しなければならない。
This work doesn't pay.	この仕事は儲からない。
This job doesn't pay.	この仕事は割に合わない。
Who owns this house?	この家はだれの所有ですか。
Could you sign here?	ここにサインしてください。
Ken wasn't running.	ケンは走っていませんでした。
I have got some money.	お金を少し持っている。
Give me a little money.	お金を少しください。
I do not want any money.	お金はいりません。
Those are their books.	あれらは彼らの本です。
This is just another day.	ありふれた一日。
Do you run every day?	あなたは毎日走りますか。
Check your order.	あなたのオーダーをチェックしろ。
The Irishman replies.	アイルランド人は答える。
They are out of hand.	あいつらは手に負えない。
Because it is there.	なぜならそこにあるからさ。
Is it open on Sunday?	日曜日でも開いてますか。
I don't have any more money.	金がもう無い
I’m still in Tokyo now.	私は今まだ東京にいます
The story starts from X.	Xから、物語が始まる
He asks the state for X.	彼がXを国に求めます
Many people take action.	多くの人が行動を取る
I want game information.	ゲームの情報が欲しい
Tests start next week.	来週からテストが始まる。
Please visit there today.	本日ご覧ください。
A book is made of paper.	本は紙で出来ている。
Can you give me a house?	僕に家をくれないか。
Study will do you good.	勉強は君のためになる。
I need some writing paper.	便箋をください。
Please show me another.	別の物を見せて下さい。
He is on another phone.	別の電話に出ています。
You must go out of the room.	部屋を出ろ。
She changed the subject.	彼女は話題を変えた。
She and I are of an age.	彼女は僕と同い年だ。
She gave him the car.	彼女は彼にその車をやった。
She took her own life.	彼女は自らの命を絶った。
She is close on sixty.	彼女はもうすぐ６０歳だ。
She is visiting Paris.	彼女はパリを訪れている。
She is about my age.	彼女はだいたい私と同じ年だ。
She acted in the play.	彼女はその劇に出ていた。
She likes word games.	彼女はことば遊びが好きだ。
She must be well off.	彼女はお金持ちに違いない。
She tried a third time.	彼女は３度目を試みた。
Her job is to type.	彼女の仕事はタイプを打つ事だ。
She's got the point.	彼女のいうことはもっともだ。
She is free from care.	彼女には心配ごとがない。
What do you make of him?	彼をどう思いますか。
They are paid by the day.	彼らは日給制です。
They are all of an age.	彼らはみな同い年です。
They are free from care.	彼らには心配がない。
He came down in the world.	彼は落ちぶれた。
He says he won't come.	彼は来ないと言っている。
He goes there every day.	彼は毎日そこへ行く。
He is in love with her.	彼は彼女に恋している。
I think that he is right.	彼は正しいと思う。
He is looking for a job.	彼は職を探している。
He traveled on business.	彼は商用で旅をした。
He was run over by a car.	彼は車に轢かれた。
He is out of the office.	彼は事務所にいない。
He came into my room.	彼は私の部屋へ入ってきた。
He came into my room.	彼は私の部屋に入ってきた。
He called at my house.	彼は私の家に立ち寄った。
He acted as my guide.	彼は私の案内をしてくれた。
He asked me for help.	彼は私に助けを求めてきた。
He is a man of action.	彼は行動力のある人です。
Where does he live?	彼は何処に住んでいるのですか。
He can drive a car.	彼は運転をすることが出来ます。
He is no longer here.	彼はもはやここにはいない。
Why did he do that?	彼はなぜそんなことをしたのか。
He must have seen it.	彼はそれを見たに違いない。
He may have said so.	彼はそう言ったかもしれない。
He used to love her.	彼はかつて彼女を愛していた。
He is in need of money.	彼はお金に困っている。
He returned to America.	彼はアメリカに戻った。
He must be about forty.	彼は４０才近いはずだ。
He is no longer here.	彼は、もうここにはこない。
I can't make him out.	彼のいう事は理解できない。
He made up the story.	彼がその話をでっちあげた。
The shop closes at seven.	店は７時に閉まる。
Who is in this room?	誰がこの部屋の中にいますか。
How long will it be?	待つ時間はどのくらいですか。
What's the right time?	正しい時刻は何時ですか。
Don't point at others.	人を指差してはいけない。
Don't point at others.	人を指さしてはいけない。
Have you been here before?	初診の方ですか。
Keep up with the times.	時代に遅れないように。
The game was called off.	試合は中止になった。
We made him our guide.	私達は彼を案内人にした。
I go to work every day.	私は毎日勤めに出ます。
I had him write it.	私は彼にそれを書いてもらった。
I said he might go.	私は彼がいってもよいといった。
I want to go to college.	私は大学へ行きたい。
I want to go to college.	私は大学に行きたい。
I didn't study at all.	私は全く勉強しなかった。
I paid $200 in taxes.	私は税金に二百ドル払った。
I am paid by the week.	私は週単位で支払われる。
I am not studying now.	私は今勉強していません。
I saw him in the park.	公園で彼に会いましたよ。
I'm looking for a house.	私は家を探している。
I am friends with Mike.	私はマイクと友達です。
I have many books.	私はたくさんの本を持っています。
I want to play cards.	私はカードゲームがしたい。
I do not have any money.	私はお金が全くない。
I am a 22 year-old man.	私は２２歳の男性です。
My family are all well.	私の家族は皆元気です。
Please see my people.	私の家族に会ってください。
My family is a large one.	私の家は大家族だ。
Please come to my house.	私の家に来て下さい。
I can do the job right!	仕事にぬかりはないぜ！
Be at home this evening.	今夜うちにいてくれ。
Today is not your day.	今日は君ついてないねえ。
There is no school today.	今日は学校がない。
I have no money on me.	今金の持ち合わせがない。
Must I do it now?	今、それをしなければいけませんか。
You must help her.	君は彼女を助けなければならない。
I think you're right.	君の言うとおりだと思うよ。
You may be right.	君の言うことは正しいかもしれない。
I'll come to your place.	君のところに行くよ。
Didn't I tell you so?	君にそう言わなかったかい？
Well may you ask why!	君が理由を聞くのも当然だ。
I ran into an old friend.	旧友に出くわした。
Old friends called on me.	旧友が訪ねてきた。
He did not get any game.	獲物がとれなかった。
We made him go there.	我々はそこに彼を行かせた。
How long will it take?	何日ぐらいかかりますか。
What time does it start?	何時に出発しますか。
Tell me what to do.	何をしたらいいか言って下さい。
Is Okayama a big city?	岡山は大きな都市ですか。
They are a party of six.	彼ら一行は６名です。
Write on every other line.	一行おきに書け。
He didn't say a word.	一言も彼は口にしなかった。
Do you have a lighter?	ライターをお持ちですか。
Try on another one.	もうひとつ別のを試してごらん。
I don't want any more.	もうこれ以上いりません。
Are you all right now?	もうお体はいいんですか。
May I add a point?	もう１点付け加えてもいいですか。
Why do you say that?	なぜそうおっしゃるのですか。
Why do you work here?	なぜここで働いているのか。
Why do you need it?	どんなことでそれが必要ですか。
Who does Toshio like?	としお君は誰が好きですか。
What place did you see?	どこを観光しましたか。
How do you make a box?	どうやって箱を作るのか。
Much water is needed.	たくさんの水が必要である。
Most people think so.	たいていの人がそう考える。
The subject is closed.	その問題はこれで終わり。
Shall I have that box?	その箱を持ちましょうか。
John is my best friend.	ジョンは私の親友です。
Jim will not come today.	ジムは今日は来ない。
Do you know your size?	サイズはお分かりですか。
Can I keep this?	これももらっておいても、良いですか。
This is what he said.	これが彼が言ったことです。
How old this book is!	この本は何と古いのだろう。
Where does this book go?	この本どこに置くの。
Do not run in this room.	この部屋では走るな。
This house is very good.	この家はとても良い。
May I ask your name?	お名前を聞いてもいいですか。
I have no money on me.	お金の持ち合わせがない。
Do you need much money?	お金が沢山必要ですか。
We are a family of five.	うちは５人家族です。
Ann can't find a job.	アンは仕事がみつからない。
Those photos are hers.	あの写真は彼女のものだ。
America is very large.	アメリカはとても大きい。
Are those two going out?	あの二人できてるの？
You must do work.	あなたは仕事をしなければならない。
You must go home.	あなたは家へ帰らなければならない。
You did not say so.	あなたはそう言いませんでした。
I'm up to here with him!	あいつには頭にきた！
"Next time," he said.	「次回だよ」と彼は言った。
Call me at the office.	会社へ電話してください。
I'm running out of time.	もう、私には時間が無い
The store is out of stock.	店にもう在庫が無い
I don't like X very much.	Xがあまり好きでない
The class size is small.	１クラスの人数が少ない
He took on this job.	彼が今回の仕事を引き受けました
Take that back, right now!	訂正しろ、今すぐ。
Do you like Japanese food?	和食は好きですか。
Do you like to travel?	旅行することが好きですか。
I'll see you next month.	来月お会いしましょう。
Where is the post office?	郵便局はどこですか。
Yumi has many books.	由美は本をたくさん持っている。
My friends call me Beth.	友達は私をベスと呼ぶ。
My friends call me Ken.	友達はぼくをケンと呼ぶ。
What if I say "no"?	僕が「嫌だ」と言ったらどうする。
I've found another job.	別の仕事を見つけました。
Who doesn't love her?	彼女を愛さない者がいようか。
She says she will come.	彼女は来ると言っている。
She came into the room.	彼女は部屋に入ってきた。
She bobbed at him.	彼女は彼にぴょこんとおじぎをした。
She can't drive a car.	彼女は車の運転ができない。
She is at work right now.	彼女は今、仕事中だ。
She is about my age.	彼女はだいたい私と同じ年頃だ。
She must go there.	彼女はそこへ行かなければならない。
She got me by the hand.	彼女が僕の手をつかんだ。
She came into the room.	彼女が部屋に入ってきた。
She may well say so.	彼女がそういうのももっともだ。
They work in the fields.	彼らは畑で働いている。
He came out of the room.	彼は部屋から出てきた。
He took her by the hand.	彼は彼女の手を取った。
Is he loved in Japan?	彼は日本で愛されていますか。
He is on another line.	彼は他の電話に出ています。
He didn't study at all.	彼は全然勉強しなかった。
He gave me a record.	彼は私にレコードをくれました。
He gave me a present.	彼は私にプレゼントをくれた。
He is as old as I.	彼は私と同じくらい年をとっている。
He is looking for a job.	彼は仕事を探している。
He will not come today.	彼は今日来ないでしょう。
He said, I am not.	彼は言った。「そうではありません」
He asked for some money.	彼は金をくれと頼んだ。
He asked for the money.	彼は金がほしいといった。
He is a man of education.	彼は教育のある人だ。
He still wants to come.	彼はまだ来たがっている。
Where does he come from?	彼はどこの出身ですか。
He made up that story.	彼はその話をでっち上げた。
How many does he want?	彼はいくつ欲しいのですか。
Is he a friend of yours?	彼はあなたの友達なの？
I got even with him.	彼にうまく仕返しをしてやった。
I get on well with him.	彼とはうまくやっている。
Are they open on Sunday?	日曜は開いていますか。
What is Japan noted for?	日本は何で有名ですか。
Japanese houses are small.	日本の家は小さい。
Can I check in here?	搭乗手続きはここでできますか。
Watanabe is my family name.	渡辺が名字です。
Will it be much longer?	長くかかるんでしょうか。
Who doesn't think so?	誰がそう思わないであろうか。
Don't look down on others.	他人を軽蔑するな。
Your party is on line.	相手方がお出になりました。
Please give me some water.	水を少しください。
I will pay for it by check.	小切手で支払う。
Don't show them your hand.	手の内を見せるな。
Keep to your own line.	自己の方針をあくまで守れ。
Keep next Sunday free.	次の日曜は空けておいてね。
I'd like to try this on.	試着してもいいですか。
I don't know him at all.	私は彼を全然知らない。
I made friends with him.	私は彼と友達になった。
I made friends with him.	私は彼と親しくなった。
I will do it right now.	私は今すぐそれをします。
I do not need money now.	私は今お金はいらない。
I'd love to come with you.	私は君と行きたい。
I have no money on me.	私は金の持ちあわせがない。
I like music very much.	私は音楽がとても好きだ。
I want to study English.	私は英語を勉強したい。
I like love stories.	私はラブストーリーが好きです。
I asked for Bob's help.	私はボブの助けを求めた。
I got out of that house.	私はその家を出ました。
I am through with him.	私はあの男とは手を切った。
My family is a large one.	私の家族は大勢です。
My family are all well.	私のうちはみな元気です。
My family is a large one.	私に家族は大勢です。
We are in the same class.	私たちは同級生です。
We helped one another.	私たちは互いに助け合った。
Please save my place.	座席をとっておいてください。
Now, there is a problem.	困ったことになったな。
Are you free this evening?	今晩お空きですか。
You can take today off.	今日は仕事を休んでよい。
What shall we do today?	今日は何をしましょうか。
Show me today's paper.	今日の新聞を見せて下さい。
I worked all this week.	今週はずっと働いていた。
Must I come home now?	今帰らなければなりませんか。
You must not do it now.	今それをしてはいけない。
Need I go right now?	今すぐに行く必要がありますか。
Black becomes you.	黒のものはあなたによく似合います。
I will go if I must.	行かねばならないなら行きます。
You have many books.	君はたくさんの本を持っている。
You may as well say so.	君はそう言うほうがよい。
You haven't any money.	君はお金を持っていません。
You are right in a way.	君はある意味では正しい。
I can't keep up with you.	君についていけない。
You should visit Kyoto.	京都を訪問するべきだよ。
You have to pay the price.	回ってきたんだよ。
We learn by experience.	我々は経験によって学ぶ。
I do not like science.	科学は好きではありません。
How long will you be gone?	何日ぐらい行くの。
Tell me what you want.	何が欲しいか言ってごらん。
I'll tell you a story.	一つ話をしてあげましょう。
I can't take it any more.	もう我慢できないわ。
Why did you open the box?	なぜはこをあけたの。
When does Tony study?	トニー君はいつ勉強しますか。
Where can I try this on?	どこで試着できますか。
What are you driving at?	どうするつもりなのか。
Why don't you come in?	どうして入って来ないのか。
But they are all people.	でも、みんな人間です。
How about Thai food?	タイ料理なんか、いかがですか。
It is of little value.	それはほとんど価値が無い。
They were all sold out.	それはすべて売り切れた。
Add more water to it.	それにもっと水をたしなさい。
Is this Canadian money?	それがカナダのお金なの？
Did the car look old?	その車は古びて見えましたか。
That's not the problem.	そういう問題じゃないよ。
You should visit Kyoto.	ぜひ京都へ行くべきだよ。
If you must, you must.	ぜひにとあれば仕方がない。
Do come and visit us.	ぜひ、遊びにおいでください。
Come and see me right now.	すぐに会いに来て。
Call 110 right now.	すぐ１１０番に電話してください。
Take as much as you like.	好きなだけ取ってね。
The server was down.	サーバーがダウンしていました。
How's your family?	ご家族の皆様おかわりありませんか。
Please write this down.	これを書き留めて下さい。
This is a very old book.	これは大変古い本です。
This is my account book.	これは私の出納帳です。
Can you do this problem?	この問題が解けますか。
This book is very small.	この本はとても小さい。
I think it's around here.	この辺だと思います。
Don't read in this room.	この部屋で本を読むな。
This money goes for food.	この金は食費になる。
They allow parking here.	ここは駐車してもよい。
Don't be long about it!	ぐずぐずせずに早くしろ！
How was today's game?	きょうの試合はどうでしたか。
May I ask your name?	お名前をお聞きしたいのですが。
May I ask your name?	お名前は何とおっしゃいますか。
I say it all the time.	いつも言ってるじゃないか。
What does that sign say?	あれは何の標識ですか。
I don't see much of him.	あまり彼に会いません。
That house is very small.	あの家は大変小さい。
I'll drive you home.	お宅まで車でお送りしましょう。
Do you like to study?	あなたは、勉強が好きですか。
He must be over fifty.	５０歳は超えているはずだ。
Come, Jesus replied.	「来なさい」イエスは言われた。
Education starts at home.	教育は家庭に始まる。
He still loves her.	彼はまだ彼女のことを愛している。
Hanako and I replied.	花子ちゃんとあたしが返事をする
Many people do research.	いろんな人が研究をします
There is no problem at all.	まったく問題が無い
He made a team with them.	彼が一緒にチームを作る
He will use it for real.	彼がそれを実際に使用する
He starts playing the game.	彼がゲームを始める
It's north of the park.	それは公園の北側に位置する
He checks the contents.	彼がその内容をチェックする
There are no signs of X. 	Xが全く感じられません
He studies English more.	彼がもっと英語を勉強する
They care for each other.	お互いが相手を思い遣る
Our website opened.	当社のホームページが開設されました
Now this is more like it.	この方がしっくりする。
Daniel got a good job.	ダニエルさんが良い職を得た。
Do as I told you to do.	命じたとおりにやりなさい。
Please tell me your name.	名前を教えてください。
Study English every day.	毎日英語を勉強しなさい。
Read between the lines.	本当の所を読みとらなきゃ。
It's all the same to me.	僕はどっちでも結構です。
Tell me what you want.	望みのものを言ってください。
Please change my room?	部屋を変えていただけますか。
Will you get me a room?	部屋を取ってくれませんか。
They looked down on him.	彼等はわたしを軽蔑した。
He loves no one but her.	彼女以外の誰も愛さない。
She's off and running.	彼女もう浮かれちゃってるよ。
She called him by name.	彼女は彼を名指しで呼んだ。
She made a man of him.	彼女は彼を一人前の男にした。
She got what he said.	彼女は彼の言うことを理解した。
She gave him the money.	彼女は彼にその金をやった。
She gave him the money.	彼女は彼にその金をあげた。
Did she come with him?	彼女は彼と一緒に来ましたか。
She is about my age.	彼女は私と同じくらいの年齢です。
She gave us some food.	彼女は私たちに食物をくれた。
She said no more work.	彼女は仕事はしないと言った。
She has a love of music.	彼女は音楽が大好きです。
She supports her family.	彼女は一家を支えている。
What will become of her?	彼女はどうなるのだろう。
She may have said so.	彼女はそう言ったかもしれない。
She is eighteen at most.	彼女はせいぜい１８歳だ。
She says she will come.	彼女はくるといっているよ。
Her family is very large.	彼女の家族は大人数だ。
I have seen her before.	彼女に以前お会いしました。
They liked large cars.	彼らは大型の車が好きだった。
He looked around the room.	彼は部屋を見回した。
He looked up at the stars.	彼は星空を見上げた。
He is just to a person.	彼は人に対して公平である。
He is paid by the week.	彼は週給で仕事をしている。
He came up to my room.	彼は私の部屋へ上がってきた。
He asked me to help him.	彼は私に助けてと頼んだ。
He handed a note to me.	彼は私に書き物を手渡した。
He will not come today.	彼は今日は来ないでしょう。
He did what he was told.	彼は言われた通りにした。
He looked about the house.	彼は家の周りを見た。
What does he want to do?	彼は何をしたいのですか。
What has become of him?	彼はどうなったのだろうか。
He said he could do it.	彼はそれができるといった。
He looked into the box.	彼はその箱の中をのぞいた。
He has a little money.	彼はお金を少し持っています。
He likes Italian food.	彼は、イタリア料理が好きだ。
Do it like he tells you.	彼の言うようにしなさい。
I have business with him.	彼に用事があるのです。
I provided him with food.	彼に食物をあてがった。
I'm longing to see him.	彼に会いたいと思っている。
He has a gift for music.	彼には音楽の才能がある。
I asked him to do that.	彼にそうしてくれと頼んだ。
It took a long, long time.	長い長い時が過ぎた。
Who told you the story?	誰が君にこの話をしたのか。
Many a man comes and goes.	多くの人が往来する。
You look much better.	前よりもずっと良さそうですね。
Not a star was to be seen.	星一つ見えなかった。
Do come to the party.	是非パーティーへおこし下さい。
We've run out of water.	水を使い果たしてしまった。
May I pay by check?	小切手でお支払いしてもよいですか。
You make your own life.	自分の人生は自分で決める。
Our team did very well.	私達のチームはよくやった。
I call her up every day.	私は毎日彼女に電話する。
I go to Tokyo every day.	私は毎日東京に行きます。
I asked her for a date.	私は彼女をデートに誘った。
I showed her my room.	私は彼女に自分の部屋を見せた。
I told her not to go.	彼女に行かないようにと言った。
I made friends with her.	私は彼女と友達になった。
I don't know him at all.	私は彼を少しも知らない。
I know him very well.	私は彼をとても良く知っている。
I know both of them.	私は彼らを二人とも知っています。
I have life insurance.	私は生命保険に入っています。
I led him by the hand.	私は手を取って彼を案内した。
I like you very much.	私は君のことがとても好きです。
I live in a rooming house.	私は下宿しています。
I must be going now.	私はもう行かなくてはなりません。
I will go there no more.	私はもうそこへ行かない。
I have little money.	私はほとんどお金を持っていない。
It's all the same to me.	私はどちらでも構わない。
It's all right with him.	私はそれでかまいません。
I'll tell him so then.	私はその時彼にそう言います。
I don't care for Alice.	私はアリスが好きではない。
Don't look into my room.	私の部屋を覗かないでよ。
I'll show you my room.	私の部屋へご案内しましょう。
I'll tell you my story.	私の身の上話をしましょう。
He must be the one for me.	私には彼が一番なの。
Why don't you come with me?	私と一緒に来ない？
We live in a big city.	私たちは大都市に住んでいる。
We love each other.	私たちはお互いに愛し合っています。
I'll come to your place.	私が君のところへ行くよ。
How is it in the market?	市場の景気はどうですか。
Sales are down this month.	今月は売上が落ちた。
I don't have classes today.	今日は授業が無い。
What's the program for today?	今日の予定は？
So much for today's work.	今日の仕事はこれまで。
Now is the time for action.	今が行動する時だ。
I will go if I must.	行かねばならないのなら行きます。
Take as much as you like.	好きなだけ取りなさい。
Do as you're told to do.	言われた通りにしなさい。
I'm seeing you in a new light.	見直したよ。
Take care of your health.	健康に気をつけなさい。
Your room is out of order.	君の部屋は乱雑だね。
You and I are good friends.	君と僕は仲よしだ。
I didn't know you cared!	気を使ってくれてどうも。
That was a close call.	間一髪！危ないところでした。
All my family is very well.	家族一同元気です。
I've seen one many times.	何度もそれを見ました。
What are you driving at?	何をなさるつもりですか。
I'm playing a TV game.	俺はテレビゲームをしている。
Please take another one.	もう一枚とってください。
I saw him no more.	もうそれ以来彼に会うこともなかった。
Mayuko came up with him.	マユコは彼に追いついた。
It's a long way to Boston.	ボストンまでは遠い。
This is a present for you.	プレゼントをどうぞ。
What are you driving at?	なにが言いたいのですか。
Don't keep the TV on!	テレビをつけっぱなしにするな！
May I do it right now?	それをすぐしてもいいですか。
I thought I must do it.	それをしなければと思った。
They are all of a size.	それらはみな同じ大きさだ。
It is smaller than Tokyo.	それは東京より小さい。
It's for my personal use.	それは私が使う物です。
That goes without saying.	それは言うまでもない。
Can I take your word for it?	それは確かかい。
That's one level down.	それはもう一つ下の階ですよ。
It's just another story.	それはごく平凡な物語だ。
Well, I must be going.	それではそろそろ失礼します。
That man has one box.	その男は１つの箱を持っている。
Who will try the case?	その事件の裁判官は誰ですか。
The game was called off.	その試合は中止になった。
John ran into the room.	ジョンは部屋にかけ込んだ。
Where does John live?	ジョンはどこに住んでいますか。
This is a book about stars.	これは星の本です。
This is what he says.	これが彼の言っていることです。
These are sold in one's.	これらは一個売りします。
Don't read in this room.	この部屋では本を読むな。
Is this information right?	この情報は正しいか。
We request this address.	この住所へお願いします。
This play has three acts.	この劇は三幕からなる。
Keep this money for me.	この金を預かってください。
You shall have this money.	このお金をあげよう。
Would you sign here?	ここにサインをお願いできますか。
You mustn't park here.	ここで駐車してはいけません。
Can I pay by credit card?	カードで支払えますか。
How long have they been here?	いつ来たんだ？
Ann was long coming.	アンはなかなかやって来なかった。
I do not have much time.	あまり時間がないのです。
May they live long!	あの人たちが長生きされますように。
It's a present for you.	あなたへのプレゼントです。
Do you study every day?	あなたは毎日勉強しますか。
Do you go to college?	あなたは大学に行っていますか。
Can you drive a car?	あなたは自動車を運転できますか。
Why do you think so?	あなたは何故そう考えるのですか。
When did you see him?	あなたはいつ彼に会いましたか。
All but one was present.	１人の他みんな出席した。
Do I have to study?	私は勉強しなければならないですか。
They are both in the room.	二人は部屋にいます。
X will change your life.	Xで貴方の人生が変わります
My friends call me Ken.	友達は僕のことをケンと呼ぶ。
Do you have many friends?	友達はたくさんいますか。
Write your name in full.	名前を略さずに書きなさい。
I shared a room with him.	僕は彼と部屋を共有した。
You can't run my life.	僕の人生に口を出さないでくれ。
I'll take over your job.	僕が君の仕事を引き継ごう。
The prices will come down.	物価が安くなるだろう。
She looked all around.	彼女は辺りをぐるりと見回した。
She came out of the room.	彼女は部屋から出てきた。
She had a little money.	彼女は少しお金を持っていた。
She must have gone out.	彼女は出かけたにちがいない。
She does know it.	彼女は確かにそのことを知っているんです。
She gave me a present.	彼女が僕にプレゼントをくれた。
She can't have said so.	彼女がそう言ったはずはない。
She may well say so.	彼女がそう言ったのももっともです。
They asked for my help.	彼らは私に助けを求めてきた。
They will buy a record.	彼らは、レコードを買います。
He must be an American.	彼はアメリカ人にちがいない。
He is about your age.	彼は大体あなたぐらいの年齢です。
He did as I told him.	彼は私に言われたとおりにやった。
He is giving an address.	彼は演説しているところだ。
I know why he did it.	彼はなぜそれをしたか知っている。
He asked for more money.	彼はさらにお金を要求した。
Does he come home at six?	彼は６時に帰宅しますか。
I know him only by name.	彼の事は名前しか知らない。
I think that he is right.	彼の言うとおりだと思う。
You can ask him for help.	彼に助けを頼んでごらん。
He has no house to live in.	彼には住む家もない。
He did not get any game.	彼には獲物が何もなかった。
I am through with him.	彼との関係はもう終わっている。
Try to act your age.	年齢相応に振る舞うようにしなさい。
Do you like Japanese food?	日本食はお好きですか。
What will become of Japan?	日本はどうなるだろう？
The store opens at 9 a.m.	店は午前９時にあきます。
You must act like a man.	男らしく行動すべきである。
I'd like some more water.	お水をもう一杯ください。
Prices are lower in Kobe.	神戸は比較的物価が安い。
It took all evening.	寝るまでずっと時間がかかりました。
Food works on our health.	食べ物は健康を左右する。
There is no paper to write on.	書く紙がない。
I have no money with me.	手持ちのお金はありません。
I'd like to return a car.	車を返却したいのですが。
How many cars do you have?	車を何台お持ちですか。
Keep up with the times.	時代に遅れないようにしよう。
Can you tell me the time?	時間を教えてくれないか。
How long does it take?	時間はどのくらいかかりますか。
Where is the changing room?	試着室はどこですか。
I am at home every evening.	私は毎晩家にいます。
I know him only by name.	私は彼の名前は知っている。
I have a book in my hand.	私は手に本を持っている。
I am free from work today.	私は今日は仕事がない。
I gave an opening address.	私は開会の辞を言った。
I study English at home.	私は家で英語を勉強します。
I like English very much.	私は英語が大変好きです。
I want to study French.	私はフランス語を勉強したい。
I asked where to go.	私はどこへ行ったらよいのか尋ねた。
I saw him just now.	私はついさっき彼に会ったばかりです。
I'll tell him so then.	私はその時に彼にそういいます。
I've run out of money.	私はお金が無くなってしまった。
I know how old you are.	あなたが何歳か知っています。
My time is running out.	私の時間は切れかかっている。
My family is a large one.	私の家族は大家族である。
My house is like yours.	私の家は、君の家と似ている。
This is my email address.	私のメールアドレスです。
Please give me some water.	私に水をくれませんか。
Don't ask me for money.	私にお金をせびらないでくれ。
We kept our books closed.	私たちは本を閉じていた。
We visited our old school.	私たちは母校を訪れた。
We ran around the park.	私たちは公園の回りを走った。
We have no school today.	私たちはきょう授業がない。
We work to get money.	私たちはお金を得するために働く。
I'll be free this evening.	今晩は何も予定がない。
It is another story now.	今では事情が変わってきた。
I will be there right now.	今すぐそこに行きます。
Now is the time for action.	今こそ行動する時だ。
I can't live without you.	君無しでは生きられない。
You must study more.	君はもっと勉強しなければならない。
You may keep the book.	君はその本を持っていていいよ。
I'll give you this money.	君にこのお金を上げよう。
You and I are the same age.	君と僕とは同じ年だ。
You and I are the same age.	君と僕とは同い年だ。
I have some money with me.	金はいくらかあります。
I'm not pressed for money.	金には困っていないよ。
How long do you want it for?	期間はどのくらい？
I'm willing to help him.	喜んで彼の助けになります。
We have come a long way.	我々はずっと努力してきた。
How many people in your party?	何人様ですか。
What's taking you so long?	何をぐずぐずしてるの？
I'll give you a present.	何かプレゼントをあげるね。
Be my right-hand man.	俺の片腕となって手助けしてくれ。
Please pay at the register.	レジでお願いします。
Get 'em before they get you!	やられる前にやれ。
Love will come in time.	やがて愛情が生まれるだろう。
Mike and Ken are friends.	マイクとケンは友達です。
Bob and I are great friends.	ボブと僕は親友だ。
New York is a big city.	ニューヨークは大きな都市だ。
Why do you need change?	どんな事で小銭が必要ですか。
All but Tom were present.	トムの他はみな出席した。
Does Tony run every day?	トニー君は毎日走りますか。
I'm just another man.	僕はどこにでもいるような男です。
I'm just looking around.	ちょっと見ているだけです。
I'd like to check out.	チェックアウトしたいのですが。
I have no money to buy it.	それを買うお金がない。
May I do it right now?	それをすぐにしてもいいですか。
Of what value is it?	それはどれほど価値があるのですか。
The house has been sold.	その家は売られてしまった。
The house has been bought.	その家は買い取られた。
The hotel is down there.	そのホテルならそこですよ。
It doesn't take very long.	そう長くはかからない。
We'll check on it right now.	すぐに点検します。
See you at the party.	じゃあパーティーで会いましょう。
Jane is as old as I am.	ジェーンは私と同じ年齢です。
Will you sign it for me?	サインしてもらえるかしら。
I haven't seen you for ages.	ご無沙汰しました。
How is your family?	ご家族の皆さんはご機嫌いかがですか。
Would you care to join me?	ご一緒にいかがですか。
These are very old books.	これらは大変古い本です。
This is as long as that.	これとあれは同じ長さです。
All is completed with this.	これで全てが完成だ。
How small this book is!	この本は何と小さいのだろう。
This box is full of books.	この箱は本で一杯です。
Give me all this money.	このお金を私に全部ください。
Write it down here, please.	ここに書いて下さい。
Ken is older than Seiko.	ケンは、聖子より年上です。
Tell me when to start.	いつ出発するのか教えて下さい。
I'm not about to ask him.	あの人に頼む気はないよ。
Can you do as much?	あなたも同じようなことが出来ますか。
I'm more in love with you.	あなたへの愛はつのる。
You must help her.	あなたは彼女を手伝わなければならない。
Can you drive a car?	あなたは自動車の運転ができますか。
How large is your family?	あなたは何人家族ですか。
Do you need any food?	あなたは何か食べ物が必要ですか。
How about your place?	あなたの家でいいですか、場所は？
I'll do what you ask.	あなたのおっしゃる通りにします。
What does Akina have on?	アキナは何を着ていますか。
Ann likes music very much.	アンは音楽が大好きだ。
We had a little water.	私たちには水が少しありました。
That's where the problem is.	そこに問題がある。
It doesn't bother me at all.	Xが全く苦にならない
He won't tell us about X.	彼がXを私たちに語りません
He pointed out the problems.	彼が問題点を指摘した
It records all information.	すべての情報を記録する
Most people know about X.	Xをほとんどの方が御存知だ
540 courses are offered.	５４０の講座を開講しています
"For how many?" "Three."	「何名様ですか」「３名です」
Please go on with your story.	話を続けて下さい。
All the money was gone.	有り金全部無くなってしまった。
I only know him by name.	名前だけでしか彼を知らない。
My way is action not words.	不言実行が俺のやり方。
She comes of a good family.	彼女は名門の出である。
She showed me her room.	彼女は僕に部屋を見せてくれた。
She looked around the room.	彼女は部屋を見回した。
She needs to help him.	彼女は彼を助けてやる必要がある。
She is all in all to him.	彼女は彼にとっては全てだ。
She was run over by the car.	彼女は車にひかれた。
She showed me her room.	彼女は私に部屋を見せてくれた。
She lives in the country.	彼女はいなかに住んでいる。
When will she return home?	彼女はいつ家に帰るのか。
They are in the same class.	彼らは同じクラスです。
They have a large house.	彼らは大きな家を持っている。
They didn't tell me so.	彼らは私にそうはいわなかった。
They must be Americans.	彼らはアメリカ人にちがいない。
He must be from the South.	彼は南部出身に違いない。
He is great in many ways.	彼は多くの点で偉大である。
He working all right.	彼は申し分なくよくはたらいている。
He had no house to live in.	彼は住む家がなかった。
He has changed my life.	彼は私の人生を変えてしまった。
He offered to help me.	彼は私に手伝ってくれるといった。
He sent me a present.	彼は私にプレゼントを送ってくれた。
He told me to do it.	彼は私にそれをするように言いつけた。
He gave me some money.	彼は私にいくらかのお金をくれた。
Will he come this evening?	彼は今夜来るでしょうか。
Where is he running now?	彼は今どこで走っていますか。
He hasn't been here long.	彼は今ここへ来たところだ。
He lives in a large house.	彼は広い家に住んでいる。
He likes music very much.	彼は音楽がとても好きです。
He studied English history.	彼は英国史を勉強した。
He's different from before.	彼は以前の彼とは違う。
He no longer lives here.	彼はもうここに住んでいない。
He sent a card to Mary.	彼はメアリーにカードを送った。
What has become of him?	彼はその後どうなったのですか。
He came back before eight.	彼は８時前に帰ってきた。
He can't be under thirty.	彼は３０以下のはずはない。
We look to him for help.	彼の助力を当てにしています。
I didn't need to tell him.	彼に話す必要はなかった。
You can ask him for help.	彼に助けを頼んでごらんよ。
I want him to read this.	彼にこれを読んでもらいたい。
Tell me when he will come.	彼がいつ来るのか教えて。
How long will it take?	日にちはどのくらいかかりますか。
Could you tell me the way?	道を教えてくれませんか。
Tokyo is a very big city.	東京はとても大きな街です。
What's the boarding time?	搭乗開始は何時からですか。
You say you changed schools.	転校したそうですね。
Do your work with more care.	注意して仕事をしろ。
Do other people like me?	他人は私が好きなのだろうか。
I took a day off last week.	先週一日休みを取った。
Please reply by return.	折り返しお返事をお願いします。
Will you make room for me?	席を詰めてくれませんか。
People learn from experience.	人は経験から学ぶ。
How many people are on board?	乗客は何人ですか。
You have done a very good job.	上出来でしたね。
Will you take a check?	小切手で受け取ってもらえますか。
Name and address, please.	住所氏名を言ってください。
That is a good place to live.	住むべきよい場所。
Do a better job next time.	次回はもっとうまくやれ。
I am pressed for time.	時間がなくてたいへん困っている。
How did the game come out?	試合はどうなりましたか。
We must be going now.	私達はもう帰らなければなりません。
Please show me around.	私をあちこちに案内してください。
I will do it the same.	私も同じようにそれをしましょう。
I don't have any friends.	私は友達がほとんどいない。
I don't know him at all.	私は彼をまったく知りません。
I know him like a book.	私は彼のことはよく知っている。
I gave some books to him.	私は彼に数冊の本を与えた。
I handed the mike to him.	私は彼にマイクを手渡した。
I think him in good health.	私は彼が健康だと思う。
I study Japanese history.	私は日本史を勉強している。
I have a little money.	私は少しだけお金を持っています。
I have no money with me.	私は金を持ち合わせていない。
I study English at home.	私は家で英語の勉強をします。
How old do you think I am?	私は何歳だと思いますか。
I want a personal computer.	私はパソコンが欲しい。
Cards are not in my line.	私はトランプは得意でない。
I don't have any money.	私はお金を全く持っていません。
I have no money with me.	私はお金のもちあわせがない。
I added a room to my house.	私は１部屋建て直した。
I found him the book.	私は、彼にその本を見つけてあげた。
This is all I have to say.	私の言い分はこれだけだ。
How did you find my house?	私の家はいかがでしたか。
I, for my part, don't care.	私のほうはかまわない。
My house looks to the south.	私の家は南向きです。
Give me some water, please.	私に水を少しください。
Give me the same, please.	私にも同じものをください。
I have no money with me.	私には金の持ち合わせがない。
I read it to my family.	私それを家族に読んで聞かせた。
Is there any room for me?	私が入る場所がありますか。
Can I pay a credit card?	支払にカードはつかえますか。
You can use my car today.	今日私の車を使っていいよ。
Which day of the week is it?	今日は何曜日ですか。
When will you next visit?	今度はいつ訪ねてくるのか。
I'm not available right now.	今は手が放せません。
I take back what I said.	今言ったことは取り消します。
Do you have an address?	行き先の住所はおわかりですか。
Do it as you are told.	言われたようにそれをやりなさい。
All right. I'll take it.	結構です。それにしましょう。
You'd better go in person.	君自身が行った方がいい。
Did you pay for the book?	君は本の代金を払ったのか。
Tell me about your plan.	君の計画について話しなさい。
You have a gift for music.	君には音楽の才能がある。
You are making history.	皆さんは歴史をつくっています。
Shall I drive you home?	家まで車でお送りしましょうか。
Why didn't you tell her?	何故彼女にいわなかったんだ？
Why do you think so?	何があなたにそう考えさせるのですか。
You should keep to the right.	右側を通るべきだ。
I look very different.	以前とは別人のようになりました。
Love me little, love me long.	愛は小出しにせよ。
How about a second helping?	もう１杯いかがですか。
It's all over between us.	僕たちの仲はもう終わりだ。
Paul offered a new plan.	ポールは新しい案を提案した。
I ran into an old friend.	ばったり昔の友達に会った。
I don't know what to say.	なんて謝ったらいいかなあ。
Why did you come to Japan?	なぜ日本に来たのですか。
You have a point there.	なかなか味のあることを言うね。
How long will you be here?	どのくらい滞在しますか。
How much will it cost?	どのくらいの料金がかかりますか。
Tell me which you want.	どちらがほしいのか言いなさい。
What papers do you take?	どこの新聞をとっていますか。
I just got by on the test.	テストはなんとかなった。
I'm going out for a while.	ちょっと出かけてきます。
Say it in another way.	それを他の言葉に言い換えなさい。
I'm not going to sell it.	それは売らないつもりです。
That is a new story to me.	それは初めて聞く話です。
It was a very big room.	それはとても大きな部屋だった。
Hand me that book, please.	その本を渡してください。
Don't look into the box.	その箱をのぞいてはいけない。
Can you take on the job?	その仕事引き受けてくれるか。
Steve was loved by all.	スティーブは誰からも愛された。
What are those cards, Jan?	ジャン、そのカードは何？
But now to our next topic.	さて、次の話題に移ろう。
May I take a message for him?	ご伝言を承ります。
Please sign your name here.	ご署名をお願いします。
Write your address, please.	ご住所をお書き下さい。
How about your family?	ご家族のみなさんはいかがですか。
I can do without this.	こんなものなしでも十分やれるよ。
This time I'll try it.	こんどは私がそれをやってみよう。
This is smaller than that.	これはあれよりも小さい。
This is what you must do.	これが君のなすべきものだ。
This book is sold here.	この本はここで売られています。
This box is made of paper.	この箱は紙で出来ている。
How big is this park?	この公園はどのくらい広いのですか。
May I show you around?	このあたりを案内いたしましょう。
Write your address here.	ここに住所を書いてください。
Can I park my car here?	ここに車を止めてもいいですか。
Are you on the level, Ken?	ケンさん、君は本気かい。
Kumi did not make a box.	クミは箱を作りませんでした。
Kim and I are the same age.	キムと私は同じ年齢だ。
They came into the house.	かれらが家にはいって来た。
I know you don't care.	お前にとってはどうでもいいこと。
Can I have some water, please?	お水をください。
Take as much as you like.	お好きなだけお取りなさい。
I'm trying to save money.	お金を貯めようとしている。
Emi will study English.	エミは英語を勉強するでしょう。
You don't have to study.	あなたは勉強する必要はない。
Can you drive a car?	あなたは車を運転する事ができますか。
I will do as you say.	おっしゃるとおりにいたしましょう。
Can you do as much?	あなたにも同じようなことができますか。
You came out of the room.	あなたが部屋から出てきた。
You came into my room.	あなたが、私の部屋に入ってきた。
I will show you around.	あちらこちらご案内いたします。
A year has twelve months.	１年には１２か月あります。
I can do it in a week.	１週間でそれをすることはできる。
Tony said, "I like it."	「好きです」とトニーは言った。
All but one were present.	一人を除いて全員出席した。
What is he going to tell who?	彼が誰に何を話すのか
He will create two images.	彼が２枚の画像を作成します
He will go down in history.	彼が歴史に不朽の名を残す
He asked ～ and me for help.	彼が〜と私に救済を頼んだ
He finds X in the story.	彼がXを、物語のなかに見出だす
We have been asked about X.	Xが私たちに問われている
He compares product prices.	彼が商品の価格を比較する
Can we say "No" to America?	米国にノウと言えるのか？
No, no! That's not right.	どっこい。そうはいかないよ。
That goes without saying.	そんなことは言わずもがなだ。
Take as much as you want to.	欲しいだけ取りなさい。
At present, he is in Canada.	目下彼はカナダにいる。
Name and address, please.	名前と住所を言ってください。
I will do it at all costs.	万難を排してやり遂げよう。
Please go on with your study.	勉強を続けて下さい。
To see her is to love her.	彼女を見れば、好きになる。
She doesn't have any friends.	彼女は友達がいない。
She comes from a good family.	彼女は良家の出身だ。
He loved her very much.	彼女は彼にたいへん愛されていた。
She gave him the money.	彼女は彼にそのお金をあげました。
Is she any better today?	彼女は今日いくらかいいですか。
Where does she live now?	彼女は今どこに住んでいますか。
They are paid by the week.	彼らは週給をもらっている。
Their team's name is NWO.	彼らのチーム名はＮＷＯです。
He provided them with food.	彼は彼らに食料を与えた。
He keeps a store in Tokyo.	彼は東京に店を持っている。
He could not go to college.	彼は大学に行けなかった。
He traveled around the world.	彼は世界一周をした。
He is taking a day off today.	彼は今日お休みです。
Need he go right now?	彼は今すぐ行かなければなりませんか。
He goes to the office by car.	彼は会社に車で行く。
He likes English very much.	彼は英語がとても好きだ。
He is no longer in business.	彼はもはや仕事がない。
He no longer lives here.	彼はもはやここに住んでいない。
He no longer works here.	彼はもうここには勤めていない。
He will study French.	彼はフランス語を勉強するつもりです。
He gave me this in return.	彼はお返しにこれをくれた。
When did he come of age?	彼はいつ成年に達したのですか。
He doesn't read many books.	彼はあまり本を読まない。
He loves you very much.	彼はあなたをとても愛しています。
He must be over sixty.	彼は６０をすぎているにちがいない。
He acted well in Hamlet.	彼は「ハムレット」で好演した。
He has a good school record.	彼の学校の成績はいい。
Why don't you call him up?	彼に電話したらどうですか。
Try to keep up with him.	彼に遅れずについていきなさい。
You'd better not tell him.	彼には話さない方がいいよ。
Did you see him go out?	彼が外へ出て行くのを見ましたか。
I don't care what he does.	彼が何をしようと構わない。
He acted as our guide.	彼がわたしたちの案内役をつとめた。
Would you tell me the way?	道を教えていただけますか。
Tokyo is a very big city.	東京はとても大きな都市です。
Why didn't you call me up?	電話くれればよかったのに。
Keep the change, please.	釣り銭は取っておいてください。
Who told you the news?	誰が君にそのニュースを知らせたの？
Come on, it'll be all right.	大丈夫、心配しないで。
Many businesses closed down.	多くの会社が休業した。
Don't look down on others.	他人を軽蔑してはいけない。
Can you make room for me?	席をつめていただけませんか。
Don't make light of life.	生命を軽んじてはいけません。
Shall I get you some water?	水をお持ちしましょうか。
People call him Dave.	人々は彼をいつもデーブと呼んでいる。
Give me some credit.	信用してもらってもいいと思いますがね。
All the food was gone.	食べ物はすべてなくなってしまった。
When does the show start?	上映はいつから始まりますか。
Do you have any small change?	小銭をお持ちですか。
I'd like to pay by check.	小切手で支払いたいのですが。
Will you drive me home?	車で家まで送ってもらえませんか？
I will do well on the test.	試験でうまくいくだろう。
I study English every day.	私は毎日英語の勉強をする。
I don't know her address.	私は彼女の住所を知りません。
I will make a friend of him.	私は彼を味方にしよう。
I showed him into the room.	私は彼を部屋に案内した。
I look to him for help.	私は彼の助けをあてにしています。
I want him to go there.	私は彼にそこへ行ってもらいたい。
I go to school with him.	私は彼と一緒に学校にいきます。
I saw that he was right.	私は彼が正しいことが分かった。
I don't have any money.	私は少しもお金を持っていません。
I want to have my own room.	私は自身の部屋がほしい。
I've got time on my hands.	私は時間を持て余している。
I am studying English now.	私は今英語を勉強している。
I took your word for it.	私は君の言葉をそのまま信じた。
I'm going to sell my house.	私は家を売るつもりです。
I have seen her before.	私は以前彼女に会ったことがある。
I will not see him any more.	私はもう彼に会わない。
I don't have any money.	私ははまったくお金がありません。
I don't have much money.	私はたいして金を持っていない。
I keep the book at hand.	私はその本を座右に置いている。
I have no money with me.	私はお金を持ち合わせていない。
I have been here for a week.	私は１週間ここにいる。
I read it to my family.	私はそれを家族に読んで聞かせた。
Don't come into my room.	私の部屋の中へ入ってこないで。
There is no TV in my room.	私の部屋にはテレビがない。
She called while I was out.	私の外出中に彼女は来た。
My home is in the country.	私の家はいなかにあります。
Please note my words.	私のことばを注意して聞いてください。
You might have told me.	私に言ってくれてもよかったのに。
I would see Mr White.	私だったらホワイト氏にあってみるね。
We study English every day.	私たちは毎日英語を学ぶ。
We made him our guide.	私たちは彼を私たちの案内人にした。
Note how I do it.	私がどんな風にそれをやるかよく見ていなさい。
Don't play on the job.	仕事を遊び半分にしてはいけないよ。
Business took him there.	仕事が彼をそこに連れていった。
I am going to see him today.	今日彼に会うつもりだ。
You'd better not go today.	今日は行かないほうがよい。
How much should I pay today?	今日はおいくらですか。
I want to close my account.	口座を閉じたいのですが。
You must do your best.	君は最善をつくさなければならない。
You must read this book.	君はこの本を読まねばならない。
Write your address here.	君の住所をここにお書きなさい。
How can you say that?	君にそんなことを言う資格があるのか。
Open your book to page nine.	九ページを開きなさい。
The printer needs paper.	給紙トレーに紙が入ってないよ。
May I have the check, please?	勘定をお願いします。
All the members were present.	会員は全員出席した。
I'm the witchfinder general.	我こそ魔女がりの大将。
Give me a light, would you?	火を貸してくれませんか。
There is no place like home.	家程良いところはない。
There is no place like home.	わが家にまさる所なし。
Lincoln is a great person.	リンカーンは偉大な人です。
Give me a little more water.	もう少し水をください。
Would you like some more?	もう少し召し上がりませんか。
Please show me another one.	ほかのを見せてください。
Helen is seventeen years old.	ヘレンは１７歳です。
Mr Ford is all right now.	フォード氏はもう大丈夫です。
I'd like some more butter.	バターをもう少しください。
Are you coming to the party?	パーティーに来ますか。
He was present at the party.	パーティーに出席した。
Naoki is as old as Kaori.	ナオキはカオリと同じ年です。
Tom and I are good friends.	トムと私はよい友達です。
By the way, how old are you?	ところで、何歳ですか。
He may well be right.	たぶん彼の言うことはただしいだろう。
There were so many people.	たいへん多くの人々がいた。
It's for my personal use.	それは私の個人用のものです。
It would be better to try.	それはやってみた方がいい。
The shop is closed today.	その店は今日はしまっている。
The store closes at seven.	その店は７時に閉店します。
The store closes at eleven.	その店は１１時に閉まる。
In that case, you are right.	その場合は君が正しい。
Is the play still running?	その劇はまだ上演中ですか。
The house is owned by him.	その家は彼が所有している。
How did the game come out?	そのゲームはどうなったか。
And Tony was the oldest.	そしてトニーは一番年上でした。
You should go back right now.	すぐに戻るべきだよ。
Check these papers over.	これらの書類に目を通してくれ。
This is a present for you.	これは君へのプレゼントだ。
What an old book this is!	これは何と古い本なのだろう。
This is a very small book.	これはとても小さい本です。
This is a little gift for you.	これはお土産です。
Take this book back to him.	この本を彼に返しなさい。
Don't play in this room.	この部屋で遊んではいけないよ。
Who will try this case?	この事件は誰が審理するのですか。
This work is made for him.	この仕事は彼に向いている。
This material has no give.	この材質は弾力性に欠ける。
This word is still in use.	この語はまだ使われている。
How long have you been here?	ここに来てどのくらい？
Ken calls me every day.	ケンは毎日私に電話をかけてくる。
Can I use a credit card?	クレジットカードは使えますか。
You should go to see him.	きみは彼に会いに行くべきだ。
Can I pay with a credit card?	カードは使えますか。
Might I ask your age?	お年をお聞きしてよろしいでしょうか。
Do you know him at all?	いったい君は彼を知っているのか。
Have you tried that store?	あの店は行ってみましたか。
Were you here last week?	あなたは先週ここにいましたか。
Do you have any money?	あなたは少しお金を持っていますか。
A is 5 times as long as B.	ＡはＢの５倍の長さがある。
Come to my house at eight.	８時に私の家に来て下さい。
Twenty years is a long time.	２０年とは長い年月だ。
Come back within a month.	１ヶ月以内に帰ってきなさい。
Ten years is a long time.	１０年といえば相当な時間だ。
Select action for Chris.	クリスの行動を選択して下さい。
There is no such sign at all.	その気配がまったく無い
He didn't ask their name.	彼はその人の名前を聞かなかった
Return to the top of the page.	ページのＴＯＰに戻る
Return to the top of the page.	ページのトップへ戻る
He registers the information.	彼がこの情報を登録する
It takes more time to do X.	Xにはまだまだ時間が掛かる
The research group found X.	Xを研究グループが発見した
That's what I want to say.	それはこっちのセリフですよ。
I don't like both of them.	両方とも好きなわけではない。
I'd like to change some money.	両替したいんですが。
My friend has a large family.	友人の家は大家族です。
I'll take back what I said.	僕が言ったことを取り消す。
Keep the room in good order.	部屋を整頓しときなさい。
Don't run around in the room.	部屋の中で走り回るな。
Can I go out of the room?	部屋からでてきてもいいですか。
Keep as many as you need.	必要なだけおもち帰りください。
She writes me every week.	彼女は毎週私に手紙を書きます。
She did the book up in paper.	彼女は本を紙で包んだ。
She must be from the South.	彼女は南部出身に違いない。
She writes a very good hand.	彼女は字がすごくうまい。
She worked on my account.	彼女は私のために働いてくれた。
She's getting on all right.	彼女は元気にやっています。
She likes music very much.	彼女は音楽がとても好きです。
She played cards with Roy.	彼女はロイとトランプをした。
She called off the party.	彼女はパーティーを取りやめた。
She is a credit to her class.	彼女はクラスの名誉だ。
She came back before eight.	彼女は８時前に帰ってきた。
Her friends call him Ned.	彼女の友達は彼をネッドと呼ぶ。
She has no money about her.	彼女には手持ちの金がない。
They have no house to live in.	彼らは住む家がない。
They are about the same age.	彼らは同じくらいの年だ。
Do they love each other?	彼らはお互いに愛し合っているの？
He got paid under the table.	彼は裏金をもらいました。
He runs in the park every day.	彼は毎日公園を走る。
Does he have many books?	彼は本をたくさん持っていますか。
He does not live in Sendai.	彼は仙台に住んではいない。
He drives a car, doesn't he?	彼は車を運転しますよね？
He is six years older than I.	彼は私より６才年上だ。
He told me a long story.	彼は私に長い物語を話してくれた。
He asked me for some money.	彼は私に金をくれと言った。
He found me a good job.	彼は私によい仕事を見つけてくれた。
He will be back in a second.	彼は今すぐ帰ってきます。
He traveled around the country.	彼は国中を旅した。
He gave not a word in reply.	彼は一言も答えなかった。
He is not more than eighteen.	彼はせいぜい１８歳だ。
He is much older than Ken.	彼はケンよりずっと年上です。
He is the older of the two.	彼は２人の中で年上の方だ。
He has a family to support.	彼には養うべき家族がいる。
He has no room to study in.	彼には勉強する部屋がない。
Do you have access to him?	彼とはつきあいがありますか。
I saw him come this way.	彼がこっちへ来るのが見えました。
I saw him come this way.	彼がこっちに来るのが見えました。
He can't be under thirty.	彼が３０才より若いはずがない。
Keep out of the way, please.	道を開けておいて下さい。
I haven't seen you for ages.	長いこと会わなかったね。
Parked cars are in the way.	駐車は通り道の邪魔になる。
I want to see him at all costs.	是非彼に会いたい。
It is the longest in the world.	世界最長なのです。
I would like some more water.	水のお代わりを下さい。
Many a mickle makes a muckle.	塵も積もれば山となる。
Are you done with the paper?	新聞はもうお済みですか。
Please tell me your location.	場所を教えてください。
Is this your first visit here?	初めての診察ですか。
I've been learning to drive.	車の運転を習っています。
We want a house of our own.	自分たちの持ち家が欲しい。
How did the game come out?	試合はどんな結果になったか。
We traveled in South America.	私達は南米を旅行した。
I'd like to order the same.	私も同じものを注文します。
I want to study history.	私は歴史を研究したいと思います。
I looked into the next room.	私は隣の部屋の中を見た。
I was calling my friend.	私は友達に電話をかけていました。
I can't help loving her.	私は彼女を愛さずにはいられない。
I told her what to do.	私は彼女になにをすべきか言いました。
I asked him to help me.	私は彼に助けてくれるように頼んだ。
I must go and see him.	私は彼に会いに行かなければならない。
I'll work as long as I live.	私は生きている限り働く。
I am content with my job.	私は自分の仕事に満足している。
I work in the field of art.	私は芸術畑で働いています。
I like to study English.	私は英語を勉強するのが好きです。
I took part in the party.	私はそのパーティーに参加した。
I called at Judy's house.	私はジュディさんの家を訪れた。
I want a guide to Chicago.	私はシカゴの案内書が欲しい。
I have visited America.	私はアメリカを訪れた事があります。
It was her that told me.	私に言ってくれたのは彼女だった。
Please tell me your name.	私に君の名前を教えてください。
I've got no more to do.	私にはもうこれ以上することがない。
We go to the same school.	私たちは同じ学校に通っている。
We have to act now.	私たちは今、行動を起こさなければいけない。
We must go to school.	私たちは学校へ行かなければなりません。
All of us know him well.	私たちは皆彼をよく知っています。
We must study English.	私たちは英語を学ばなければならない。
We lived in Paris before.	私たちは以前パリにすんでいた。
We bought the man's house.	私たちはその男の家を買った。
We had little water.	私たちには水が少ししかありませんでした。
Love me little, love me long.	細く愛して長く愛して。
I'm seeing her this evening.	今晩私は彼女に会います。
I am going to see him today.	今日は彼に会うつもりだ。
May I call on you today?	今日お訪ねしてもよろしいですか。
May I use your car today?	今日、車を借りてもいいですか。
We are in the black this month.	今月は黒字である。
So you are acting high-handedly.	高飛車に出たね。
You can read between the lines.	行間を読みなさい。
Go and see him in person.	行って直接彼に会ってきなさい。
I'd like to open an account.	口座を開きたいのですが。
Light has come into the world.	光が世にやって来た。
Do you have a table for five?	五人の席はありますか。
The old house was taken down.	古い家が取り壊された。
You must not go out today.	君は今日外に出てはならない。
Will you take on the job?	君はその仕事を引き受けますか。
Please go on with your story.	君の話を続けて下さい。
You are off the point.	君の言うことはピントがはずれている。
I'll study your report.	君のレポートを読んでおきましょう。
I should have taken the money.	金を選ぶべきだった。
What's your home address?	貴方のお宅の住所はどこですか。
School will open on Monday.	学校は月曜日に始まります。
There's no place like home.	我が家ほどいいものはない。
I'd like to call my family.	家族に連絡したいのですが。
I don't know what to say.	何を言ったら良いかわからない。
I don't know what to say.	何を言えばよいのか分からない。
Hmmm, how shall I say this?	何て言ったらいいのかなあ。
Will you give me a light?	煙草の火を貸してくれませんか。
There are seven days in a week.	一週間は七日です。
There is no place like home.	わが家にまさる所はない。
Meg didn't even look at me.	メグは私を見もしなかった。
Mike said that he would come.	マイクは来ると言った。
How did the party go?	パーティーのすすみ具合はどうでしたか。
Come to the party, will you?	パーティーに来なさいね。
Why do you think that way?	なぜそのように思うのですか。
How about going for a drive?	ドライブはいかがですか。
What subject are you good at?	どの教科が得意ですか。
I will help as much as I can.	できる限り手伝います。
It shows white from here.	それはここからでは白く見える。
It's the same to me.	それは、私にとって、どっちでも同じ事だ。
A friend told me that story.	その話は友達から聞いた。
How long is that story?	その物語はそのくらいの長さですか。
Take my word for it.	そのことなら私のことばを信じてください。
Two can play at that game.	そのゲームなら相手になろう。
Shall I have him call you?	そちらへ電話させましょうか。
John and Beth are of an age.	ジョンとベスは同い年だ。
What's going on down there?	したで何が起こっているの？
Jane is loved by Peter.	ジェーンはペーターに愛されている。
Now, go about your study.	さあ、勉強に取りかかりなさい。
What old books these are!	これらは何と古い本なのだろう。
These are all much the same.	これらはみな大同小異だ。
This is a book about stars.	これは星についての本です。
This is as large as that.	これはあれと同じくらい大きい。
That is all that he said.	これが彼が言ったことの全てだ。
I know my way around here.	この辺は、よく知っています。
This article is high quality.	この品物は品質がよい。
This house is not for sale.	この家は売りもんではない。
This house has six rooms.	この家には部屋が６つあります。
This place used to be a field.	ここは昔、畑だった。
Ken likes music very much.	ケンは音楽がとても好きです。
Canada is larger than Japan.	カナダは日本より大きい。
Might I ask your name?	お名前をお伺いしてもよろしいですか。
You did it all right.	お前は、やるべき事はちゃんとやったよ。
May I have the check, please?	お勘定をお願いします。
I'd like to try aerobics.	エアロビクスをやってみたいな。
Won't you come over to my place?	うちに来ないか。
I'll be with you right now.	いますぐそちらに参ります。
When are you going to say, I do?	いつ結婚するの？
I have not seen him since.	あの時以来彼に会っていない。
What must you do now?	あなたは今何をしなければなりませんか。
Take as many as you want.	あなたが欲しいだけ取りなさい。
How many CDs do you have?	ＣＤをどれくらい持っているの。
You must be here by five.	５時までに来なければならない。
Write in less than 50 words.	５０語以内で書きなさい。
I'll call you within a week.	１週間以内に電話します。
Ten years is a long time.	１０年というのは、長い年月だ。
I will go there no more.	私はもうそこには行かないだろう。
They are about the same age.	彼らはほぼ同じ年齢です。
Mr. Yamada asks Mr. Sato.	山田先生が、佐藤先生に質問をする
This would make a great gift.	これはプレゼントに最適だ
Just 13 people? That's all?	１３人？たったそんだけかよ。
Yumi is one of my friends.	由美は、私の友達のひとりです。
Get your friend to help you.	友達に助けてもらいなさい。
Get your friend to help you.	友人に助けてもらいなさい。
I have many model cars.	僕は模型自動車をたくさん持っている。
Can I get you another one?	別のを買わせてもらえるかなあ。
The cost of living has gone down.	物価が下がった。
She provided for her old age.	彼女は老後の備えをした。
She lives in a large house.	彼女は大きな家に住んでいる。
She set a new world record.	彼女は世界記録を出しました。
She gave us a present.	彼女は私たちにプレゼントをくれました。
She lives in a large house.	彼女は広い家に住んでいます。
How old do you think she is?	彼女は何歳だと思いますか。
She was present at the party.	彼女はその会に出席した。
She came to like the house.	彼女はその家が好きになった。
She must be forty or so.	彼女は４０歳かそこらにちがいない。
Ask her what she bought.	彼女が何を買ったかきいてみなさい。
Ask her what she has done.	彼女が何をしたかを尋ねなさい。
They started at the same time.	彼らは同時に出発した。
They closed the shop at five.	彼らは５時に店を閉めた。
He showed me around the city.	彼は町を案内してくれた。
He's running for Congress.	彼は代議士に立候補しています。
He did a check on the quality.	彼は主要点を点検した。
He is one of my best friends.	彼は私の親友の一人です。
He visited Kyoto last year.	彼は昨年京都を訪問しました。
He did what he had been told.	彼は言われたことをした。
He works with me at the office.	彼は会社の仲間です。
He had been there before.	彼は以前そこに行った事があった。
He is no longer in business.	彼はもう商売をしていない。
He will be back before long.	彼はまもなく帰るでしょう。
He wrote a story just now.	彼はちょっと前に物語を書いた。
He must have made it up.	彼はそれをでっち上げたに違いない。
He works best at this job.	彼はこの仕事では一番よく働く。
Why don't you call him up?	彼に電話してみたらどうですか。
He doesn't have any friends.	彼には友達が一人もいない。
I saw him looking at me.	彼が私を見つめているのが分かった。
Do you know what he said?	彼が何を言ったか知っていますか。
I had a phone call from him.	彼から電話がかかってきた。
He will go in your place.	彼があなたの代わりに行くだろう。
I work every day save Sundays.	日曜日以外は毎日働く。
Japan is smaller than Canada.	日本はカナダより小さい。
We have quoted special prices.	特別価格の見積りです。
Tokyo is bigger than Yokohama.	東京は横浜より大きい。
The price will not come down.	値は下がらないでしょう。
Who told you the news?	誰が君にそのニュースを教えたのですか。
Many hands make light work.	多くの人手は仕事を軽くする。
Could you show me another one?	他のを見せてください。
That will not make even carfare.	足代にもならない。
There were fifty persons in all.	全部で５０人いた。
Your party is on the line.	先方が電話にお出になりました。
Many hands make light work.	人手が多ければ仕事は楽しい。
One must do one's best.	人はベストを尽くさなくてはならない。
I don't care what people say.	人が何を言おうと平気だ。
Will you take a personal check?	小切手は使えますか。
Might I ask your address?	住所をお聞きしてよろしいですか。
Tell us what to do next.	次になにをしたらいいか教えてくれ。
I gave him what books I had.	持っていた本を彼に与えた。
I study English at school.	私達は学校で英語を勉強します。
I like studying history.	私は歴史を勉強することが好きです。
I have done with her job.	私は彼女の仕事とはもう関係ない。
I am not older than he is.	私は彼ほど歳はとっていません。
I wrote him to ask why.	私は彼になぜかと尋ねる手紙をかいた。
I wanted him to go there.	私は彼にそこへ行ってほしかった。
I have known him a long time.	私は彼と知り合って長い。
I was in London last month.	私は先月ロンドンにいました。
I work for a stock company.	私は証券会社で働いています。
I must go about my work.	私は仕事に取りかからねばならない。
I like studying English.	私は英語を勉強することが好きです。
I saw her at the party.	私はパーティーで彼女を見かけました。
I want to see her very much.	私はとても彼女に会いたい。
I want to see him very much.	私はとてもかれにあいたい。
I don't have much money.	私はたいしてお金を持っていません。
I can't work out the problem.	私はその問題が解けない。
I was not studying then.	私はその時勉強していませんでした。
I've been in Sapporo before.	私はこの一年間札幌にいる。
I have some money with me.	私はいくらかお金を持っている。
I have a friend in England.	私はイギリスに友達がいます。
I'm looking for an old man.	私はある老人を探しています。
I don't have much money.	私はあまりお金を持ってないんです。
I would like to visit you.	私はあなたを訪ねたいものです。
I can't keep up with you.	私はあなたにはついていけません。
I must say no to you.	私はあなたにノーと言わなければならない。
I can't live without you.	私はあなたなしでは生きられない。
I have four people in my family.	私は４人家族です。
You are to do as I tell you.	私の言った通りにしなさい。
We must keep the law.	私たちは法の定めに従わなければならない。
We're friends from way back.	私たちは昔からの友人です。
We need to study more.	私たちはもっと勉強する必要があります。
Will you tell us a story?	私たちにお話をしてくれませんか。
I have a full program today.	今日は予定が詰まっている。
I wasn't at my best today.	今日は最高の調子が出なかった。
Today is our school field day.	今日は学校の運動会だ。
I don't care to do it today.	今日はそれをやりたくない。
You look different today.	今日はいつもとちがって見えるね。
Have you read today's paper?	今日の新聞は読みましたか。
I'm going to Paris next month.	今月パリへ行く予定だ。
He looks much better now.	今、彼はずっと調子がよいようだ。
I don't have much time now.	今はあまり時間がないのです。
You will play into their hands.	向こうの思う壷だぞ。
The park was full of people.	公園は人でいっぱいだった。
What time does the play start?	劇はいつ始まりますか。
I have a job for you.	君達にやってもらいたい仕事があるのだよ。
Would you care to come with us?	君も一緒に来たいか。
I should think you are right.	君は正しいと思いますが。
How many books do you have?	君は何冊の本をお持ちですか。
What are you driving at?	君は一体何を言おうとしているのか。
What did you open it with?	君はそれをなにで開けましたか。
You have no right to say so.	君にはそういう権利が無い。
Kyoto has many universities.	京都には多くの大学がある。
I will get even with you some day.	覚えていろよ。
I haven't seen him for years.	何年も彼に会ってません。
I got control of the works.	わたしがその工場を管理した。
Where do I return cars?	レンタカーの返却場所は、どこですか。
Louie, your friends are coming.	ルイ、友達がくるよ。
I traveled about Europe.	ヨーロッパをあちらこちら旅行した。
You can do it if you try.	やってみれば君にはそれが出来る。
My age is going to tell on me.	もう歳には勝てません。
Mayuko came out of the room.	マユコが部屋から出てきた。
Why don't you ask Mr White?	ホワイトさんに聞いてみたら？
How did you like the party?	パーティーはいかがでしたか。
The party was over at nine.	パーティーは９時に終わった。
Why did you go to Tokyo?	なぜあなたは東京に行ったのですか。
Dorothy isn't in the office.	ドローシーは職場にいない。
Please make way for him.	どうぞ彼のために道をあけて下さい。
How is it she does not come?	どうして彼女は来ないのか。
I will help as much as I can.	できるだけお助けします。
Many a little makes a mickle.	ちりも積もれば山となる。
Give me a hand, will you?	ちょっと手を貸してくれませんか。
I should say he won't come.	たぶん、彼は来ないでしょう。
The old man got in her way.	その老人が彼女の邪魔をした。
The room is full of people.	その部屋は人々でいっぱいだ。
The book is of great value.	その書物は非常に価値がある。
I would very much like to go.	ぜひ、行きたいのですが。
I'll be with you in a second.	すぐそちらへまいります。
Jack is one of my friends.	ジャックは私の友人の一人です。
Give my love to your family.	ご家族の皆さんによろしく。
What more could I want?	これ以上何を欲しがることがあろうか。
I've read both these books.	これらの本を２冊とも読んだ。
This is a story about stars.	これは星についての話です。
What a big book this is!	これはなんて大きな本なんでしょう。
This is the end of my story.	これで私の話は終わりです。
I need a box of this size.	これくらいの大きさの箱がいる。
This is my business address.	これが私の会社の宛名です。
How much do you ask for this?	これ、いくらで売りたい？
What goes on in this room?	この部屋で何が起こるのですか。
What is all this bother about?	この騒ぎはどうしたの。
Did you go to the last class?	この前の授業に出たかい？
What do you say to this plan?	この計画はどうでしょう。
Come over here and join us.	ここへきて仲間に入りなさい。
Could I park my car here?	ここに駐車してもよろしいですか。
Twenty families live here.	ここには２０家族が住んでいる。
This is just between you and me.	ここだけの話だよ。
Where are your credit cards?	クレジットカードはどこだ。
The class are all here.	クラスの人たちぜんいんがここにいる。
I think we can be friends.	きっと友達になれると思います。
Tell me when to start.	いつ出発したらいいか私に教えて下さい。
Are you studying English?	あなたは英語を勉強していますか。
Tell me what your name is.	あなたの名前を教えてください。
You and I are old friends.	あなたと私は昔からの友達です。
I want to make love with you.	あなたと愛をかわしたい。
Take as much as you like.	あなたが好きなだけお取り下さい。
Where is the XXX department?	ＸＸＸ売り場はどこですか。
The closest I have is a 38.	３８サイズならあるんですが。
Why don't we share a room?	１つの部屋に一緒に住まないか。
I'd like to change my room.	部屋を代えてほしいのですが。
I make 100 euros per day.	私は一日に100ユーロ稼ぎます。
I wanted it more than others.	憧れる気持が人一倍強かった
It can be used for a long time.	利用期間が長期間に渡る
It's around the city center.	それがほぼ街の中心に位置する
We will support your life.	私たちがあなたの生活を応援します
X will be selected by the person.	Xを本人が選択する
They ask the government for X.	彼らがXを政府に要求する
Which country are you from?	あなたはどこの国の出身ですか。
I got what she was saying.	僕には彼女の言うことが分かった。
That's not what you said before.	話が違うじゃないか。
We must provide for old age.	老後に備えなければならない。
I'd like a room in the back.	裏側の部屋に替えてください。
How old will you be next year?	来年で何歳になりますか。
I'm going by the post office.	郵便局のそばを通ってるよ。
Could I see the room please?	部屋を見せていただけますか。
The room was in good order.	部屋はきれいに整頓されていた。
She's loved by her friends.	彼女は友達から愛されています。
She wrote down what he said.	彼女は彼の言葉を書き留めた。
She asked about my school.	彼女は私の学校についてたずねた。
What do you think she said?	彼女は何と言ったと思いますか。
She was asked to the party.	彼女はパーティーに招待された。
She is at home in the subject.	彼女はその問題に詳しい。
Does she work in this city?	彼女はこの町で働いていますか。
She must be over eighty.	彼女は８０歳を超えているに違いない。
She's not as old as Mary.	彼女は、メアリーほどの年ではない。
Her life is free from care.	彼女の人生は、何の心配もない。
Her actions are to the point.	彼女の行動は的を得ている。
Her actions are to the point.	彼女の行動は的を射ている。
They work only during the day.	彼らは昼間だけ働きます。
Not all of them are present.	彼らはだれも出席していない。
They work for so much a week.	彼らは１週間いくらで働く。
Some of them are my friends.	彼らの何人かは私の友人です。
He checked out of the hotel.	彼は精算をしてホテルを出た。
He traveled all over the world.	彼は世界中を旅行した。
He was experienced in business.	彼は商売の経験がある。
He knows how to drive a car.	彼は車の乗り方を知っている。
He got out from under the car.	彼は車の下から出てきた。
He asked me for some money.	彼は私に金をいくらか要求した。
He said that I must go.	彼は私が行かなければならないといった。
He was made much of at school.	彼は学校で重んじられた。
He is a big man in the company.	彼は会社の重要人物だ。
He visited Italy before.	彼は以前イタリアを訪れたことがある。
He traveled all over Europe.	彼はヨーロッパ中を旅行した。
He was looking for a good job.	彼はよい職を探していた。
He has been loved by all.	彼はみんなにずっと愛されています。
He drove down to the hotel.	彼はホテルのほうへ車で行った。
He tried to learn French.	彼はフランス語を勉強しようとした。
He told me where to go.	彼はどこへ行けば良いのか教えてくれた。
He doesn't know any better.	彼はそれぐらいの知恵しかない。
He is just right for the job.	彼はその仕事にぴったりだ。
He has come down in the world.	彼はおちぶれてしまった。
He's been working all day long.	彼は１日中働いている。
I have seen him many times.	彼には何度も会ったことがある。
I will tell you about him.	彼についてあなたに話しましょう。
I couldn't get him to do it.	彼にそれをさせられなかった。
I will make him pay the money.	彼にお金を支払わせよう。
Don't keep company with him.	彼と付き合うのはやめなさい。
I saw him looking at me.	彼が私を見つめているのが目に映った。
He is into the Internet.	彼、インターネットにはまってるよね。
Our main office is in Osaka.	当社の本社は大阪にあります。
Saturday comes before Sunday.	土曜日は日曜日の前に来る。
Running is good for the health.	走ることは健康に良い。
How many papers do you take?	新聞はいくつとっていますか。
How do you like your new job?	新しい仕事はいかがですか。
The shop did not want him.	商店も彼を欲しがりませんでした。
What do you have in your hand?	手に何をもっていますか。
I'm saving money for a car.	車を買うために貯金をしている。
We had a party in the open.	私達は野外でパーティーをした。
I would not have known him.	私もこの方を知りませんでした。
I like to read story books.	私は物語の本を読むのが好きだ。
I called him up on the phone.	私は彼を電話に呼び出した。
I told him what to do.	私は彼に何をしたらよいのか教えてやった。
I can't get by without him.	私は彼なしではやっていけない。
I have as many books as he.	私は彼と同数の本をもっている。
I don't like what he said.	私は彼が言った事が気に食わない。
I want many books to read.	私は読むための沢山の本がほしい。
I don't like long drives.	私は長距離ドライブは好きではない。
I don't care what you were.	私は昔のあなたなど気にしない。
I did not take many photos.	私は写真をあまりとらなかった。
I will try to do my best.	私は最善を尽くすよう努力をします。
I am to go there today.	私は今日そこへ行くことになっています。
I only did as I was told.	私は言われたとおりにしただけです。
I asked Ken to help me.	私は健に手伝ってくれるようにたのんだ。
I have traveled many times.	私は何度も旅行したことがある。
I have seen a UFO before.	私は以前ユーフォーを見た事がある。
I don't want to go any place.	私はどこにも行きたくない。
I wrote my name on the paper.	私はその紙に名前を書いた。
I have not been around much.	私はあまり世間を知りません。
I see you every now and then.	私はあなたを時々見掛ける。
What I want to say is this.	私の言いたいことはこのことだ。
We call him Goro-san.	私のうちでは、「五郎さん」って呼ぶんです。
I don't see what he says.	私には、彼のいうことがわからない。
We go to school to study.	私たちは勉強するために学校へ行く。
We made friends with them.	私たちは彼らと親しくなりました。
We made friends with Jane.	私たちはジェーンと友達になった。
Why don't you join our party?	私たちの仲間に入りなさい。
I'll get there before you will.	私が先にそこへ着くよ。
When did you see him last?	最後に彼にあったのは何時ですか。
It'll come right in the end.	最後にはうまく収まるだろう。
They are studying these days.	最近彼らは勉強しています。
Would you make room for me?	座席をつめていただけませんか。
I had a very good time today.	今日はとても楽しかったわ。
I didn't do much work today.	今日はあまり仕事がなかった。
Do I have to go right now?	今すぐいかなければなりませんか。
The park was full of people.	公園は人々でいっぱいでした。
You must take care driving.	交通に注意しなければいけない。
Do as you were told to do.	言いつけられたとおりにしなさい。
That was just another party.	月並みのパーティーだったよ。
Must you work on Sunday?	君は日曜日に働く必要があるのですか。
You're Tom's friend, aren't you?	君はトムの友人だね。
The Kamo runs through Kyoto.	鴨川は京都市を貫流している。
I didn't know what to say.	何と言っていいかわからなかった。
There must be another way.	何か別の方法があるに決まってる。
You had to study English.	英語を勉強しなければならなかった。
"I don't know", said Tony.	わからないよ。とトニーは言った。
Do you have a larger size?	もっと大きいサイズはありますか。
Please show me another one.	もう一つ別の物を見せて下さい。
I have three more pages to go.	もう３ページ残っている。
Mr White is about my age.	ホワイトさんは私とほぼ同じ年です。
At first, I didn't like him.	はじめは彼が好きでなかった。
I'm looking for a part-time job.	バイト探してるんだ。
Why do I have to do that?	なんで僕がやらなくちゃいけないの。
Well, you may be right.	なるほど、君の言うとおりかもしれない。
What do you study English for?	なぜ英語を学ぶのですか。
How about going for a drive?	ドライブするのはどうですか。
Which house did you live in?	どの家に住んでいたのですか。
Does Toshio like Sachiko?	としお君は佐知子さんが好きですか。
Please show me the TV Guide.	テレビガイドを見せて下さい。
That is to say, on May 10th.	つまり、５月１０日のことだ。
At last, I completed my work.	ついに私は仕事を完成した。
Just take my word for it.	だまされたと思ってやってみなさい。
No more than 50 people came.	たった５０人しかこなかった。
You have given me so many.	そんなにたくさんくださいました。
It has a value all its own.	それにはそれなりの価値がある。
We won't take up the problem.	その問題は取り上げません。
I got the book back from him.	その本を彼から取り返した。
The store is not open today.	その店は今日は開いていない。
The store is closed Mondays.	その店は月曜日には休業です。
Didn't you visit the park?	その公園に行かなかったのですか。
Did you learn it from him?	そのことは彼から聞いたのですか。
"That's right", said John.	そうだね。とジョンが言いました。
That is why I came here.	そういうわけで私はここへきたのです。
A great party that was.	すばらしいパーティーでしたよ、それは。
John has no friends here.	ジョンはこのへんには友達がいない。
Sharon must be a go-getter.	シャロンはやり手にちがいない。
How long may I keep this?	これ、いつまで借りていられますか。
This book sold well in Japan.	この本は日本でよく売れた。
This room is not very large.	この部屋はそう大きくはない。
What does this sign say?	この掲示はなんと書いてあるのですか。
This house is not very large.	この家はそう大きくはない。
These days people visit here.	このごろ人がここを訪れる。
You should keep it close.	このことは伏せておいたほうがいい。
Come over here and join us.	こっちに来て仲間に入りなさい。
Could I park my car here?	ここに車をとめてもよろしいですか。
Write down your name here.	ここにあなたの名前を書きなさい。
Do you have a credit card?	クレジットカードはお持ちですか。
A good many people were there.	かなりの人がそこにいた。
Might I ask your name?	お名前をお伺いしてもよろしいでしょうか。
Could I get some water, please?	お水をいただけますか。
When did you open your new store?	いつ開店したのか。
Do you know him at all?	いったい君は彼のことを知っているのか。
Ann gave me this present.	アンは私にこのプレゼントをくれた。
That room is not very large.	あの部屋はそう大きくはない。
You must go to Harajuku.	あなたは原宿に行かなければならない。
Do you have any money?	あなたはお金をいくらか持っていませんか。
You must get up at six.	あなたは６時に起きなければなりません。
Please go on with your story.	あなたの話を続けて下さい。
Please write down your name.	あなたの名前を書いて下さい。
You are right in a way.	あなたの言うことはある意味では正しい。
You can visit NHK any time.	ＮＨＫはいつでも見学できます。
Our rates increased in April.	４月に給料があがりました。
I go shopping every other day.	１日おきに買い物に行く。
How many books does he have?	彼は何冊本を持っていますか。
There are two types of people.	人には二つタイプが有ります
I have seen it around two times.	私がそれを２回ほど見た
Video games aren't good for you.	ゲームは身体に良くない
X is included with every product.	Xが各商品につきます
Make best use of the internet.	ネットを最大限に利用しよう
Yamada ran without giving up.	山田選手が粘りの走りを見せた
We need an experienced person.	経験が豊富な方を募集します
The user selects all items.	ユーザーが全ての項目を選択します
Take care of Mr. Tanaka for me!	田中さんのことを頼むよ。
I do not like both of them.	両方とも好きというわけではない。
How old will you be next year?	来年君は何歳になりますか。
I'll see you a week from today.	来週の今日お会いします。
Can I have a friend paged?	友達を呼び出してもらいたいんです。
I'm not about to ask him.	僕はあの人に頼む気持ちはありません。
The way I see it, he is right.	僕の見るところ彼は正しい。
Prices are going up every day.	物価は毎日アップしている。
The light was on in the room.	部屋には明かりがついていた。
She thinks the world of him.	彼女は彼をとても愛しています。
She is all in all to him.	彼女は彼にとって最もたいせつな人だ。
She is all in all to him.	彼女は彼にとってかけがえのない人だ。
She is very free with her money.	彼女は大変気前がいい。
She is at most 18 years old.	彼女は多く見ても１８歳だろう。
She is the only friend I have.	彼女は私の唯一の友達です。
She has a love of learning.	彼女は学問を愛する気持ちがある。
She called me many a time.	彼女は何度も私に電話をかけてきた。
She will be here before long.	彼女はまもなく戻ってきます。
She was pleased with the gift.	彼女はその贈り物を喜んだ。
She is not without money.	彼女はお金がないというわけではない。
Her car is two years old.	彼女の車は買ってから二年たっている。
Do you know what she said?	彼女が何と言ったか知っていますか。
It is up to you to support him.	彼を養うのは君の責任だ。
They had no house to live in.	彼らは住むべき家がなかった。
They came to love each other.	彼らは愛し合うようになった。
They bought a box of cookies.	彼らはクッキーを１箱買った。
They are wanting in industry.	彼らには勤勉さが欠けている。
They have the right to do so.	彼らにはそうする権利がある。
He is looked up to by friends.	彼は友達に尊敬されている。
He runs a company in Meguro.	彼は目黒で会社を経営している。
He goes to Karuizawa every year.	彼は毎年軽井沢へ行く。
He works every day but Sunday.	彼は日曜を除いて毎日働く。
There is no need for him to work.	彼は働く必要はない。
He is longing for city life.	彼は都会生活にあこがれている。
He has seen much of the world.	彼は人生経験が豊富である。
He has a large store of food.	彼は食料の蓄えは十分にある。
He has made me what I am today.	彼は私を現在の私にした。
He thinks only of making money.	彼は金儲けしか頭にない。
He is a man with no standards.	彼は基準を持たない男だよ。
He is, in a word, a utopian.	彼は一言で言えば夢想家なのだ。
He is better off than before.	彼は以前より暮し向きがよい。
He is no longer living here.	彼はもうここには住んでいない。
How does he go to school?	彼はどうやって学校に通っていますか。
He must have been home then.	彼はその時家にいたに違いない。
He does not have to do this.	彼はこのことをしなくてもよい。
He has been to many places.	彼はあちこちに行ったことがある。
He lived to be eighty years old.	彼は８０歳まで生きた。
He said he got a 100 points.	彼は１００点をとったと言った。
He is a good man for the job.	彼は、その仕事に適した男だ。
He studies American history.	彼は、アメリカ史を勉強します。
All what he said was right.	彼の言ったことは全て正しかった。
Did you make out what he said?	彼の言うことがわかったか。
Try to keep up with him.	彼に遅れずに付いて行くようにしなさい。
He has no house in which to live.	彼には住む家がない。
I'll tell him so when he comes.	彼が来たらそう伝えよう。
There is no need for him to work.	彼が働く必要はない。
Do tell me what he said.	彼が言ったことを、ぜひ私に話してくれ。
Don't love two people at a time.	同時に２人を愛するな。
What does the other party want?	相手方の要求は何ですか。
I want to travel around the world.	世界を一周したい。
You can't live without water.	水なしでは、生きて行けない。
I'll join you in the library.	図書館で一緒になりましょう。
How many people are in your party?	人数は何人ですか。
Many hands make light work.	人手が多ければ仕事がらくになる。
Could you write it down, please?	書いてくださいますか。
There were forty people present.	出席者は４０人だった。
I have a problem with my car.	車のことで困ってるんだよね。
How long does it take by car?	車でどれくらいかかりますか。
Which game shall we play next?	次はどんな遊びをしようか。
Ask him what to do next.	次に何をしたらいいか彼に尋ねてごらん。
At times we go for a drive.	時々私たちはドライブに出かける。
You must make much of time.	時間を大切にしなければならない。
I took no note of the time.	時間がたつのに気がつかなかった。
What time does the game start?	試合は何時に始まりますか。
We learn much by experience.	私達は経験によって多くを学ぶ。
We all learn by experience.	私達はみな経験から学ぶものです。
We got there at the same time.	私達はそこに同時に着いた。
Our class is a small one.	私達のクラスは小人数のクラスである。
I tried to change the subject.	私は話題を変えようとした。
I will be seventeen next week.	私は来週１７歳になります。
I go to work by car every day.	私は毎日車で通勤している。
I asked where she lived.	私は彼女がどこに住んでいるのか尋ねた。
I can't make him out at all.	私は彼をまったく理解できない。
I don't like what he said.	私は彼の言ったことが気にくわない。
I did it the way he told me to.	私は彼の言う通りにした。
I gave him what money I had.	私は彼に無け無しの金を与えた。
I told him the big news.	私は彼にそのビッグニュースを知らせた。
I love you as much as him.	私は彼と同じようにあなたを愛する。
I have no small change on me.	私は小銭の持ち合わせがない。
I know how to drive a car.	私は車の運転の仕方を知っています。
I keep old books with care.	私は古い本を大切に保存している。
I'm studying art at school.	私は学校で美術を勉強しています。
I am going to study English.	私は英語を勉強するつもりです。
I've lived in Kobe before.	私は以前神戸に住んでいた事がある。
I was just in time for class.	私はやっと授業に間に合った。
I do not love him any longer.	私はもう彼を愛してはいない。
I like French food very much.	私はフランス料理が好きです。
I'll drive to Detroit.	私はデトロイトへ車を運転していきましょう。
I like both of them very much.	私はその両方とも大好きだ。
I can't pay for the car.	私はその車の代金を払うことが出来ない。
I have tried every way.	私はありとあらゆる方法をやってみました。
I live in a two story house.	私は２階建ての家に住んでいる。
I bought five books a month.	私は１か月に５冊の本を買った。
I asked where he had been.	私は、彼にどこにいたのだと尋ねた。
Will you go in place of me?	私の代わりにいってくれませんか。
Please write down my address.	私の住所を書き留めておいて。
Do it the way I told you to.	私の言ったとおりにやりなさい。
For me, time is not money.	私には、時間はお金ではありません。
We visited Nikko the next day.	私たちは翌日日光を訪れた。
We call it the Evening Star.	私たちはそれを宵の明星と呼ぶ。
Both of us are from Tampa.	私たちは２人ともタンパの出身です。
Our school is 80 years old.	私たちの学校は創立８０周年です。
You will see that I am right.	私が正しいとわかるでしょう。
The car is not available today.	今日は車が利用できない。
We have an English class today.	今日は英語の授業がある。
Were you on time for work today?	今日、会社間に合った？
I have a little money this month.	今月はとても金欠だ。
I don't need money at present.	今のところお金はいらない。
Do you have any money with you?	今お金を持っていますか。
I don't have much money now.	今あまりお金を持っていません。
You must start for Nagoya now.	今、名古屋に出発しなさい。
I have a little money now.	今、私は少しはお金を持っています。
I have little money now.	今、私はほとんどお金を持っていません。
I used to run at high school.	高校のころは走ったものです。
You can travel how you please.	好きなように旅行してよい。
Looking up, I saw him come in.	見上げると彼が入って来た。
You have a light hand, don't you?	君は手先が器用だね。
How much money do you want?	君はいくらお金がほしいのですか。
Do what you think is right.	君が正しいと思うことをしなさい。
Open your texts to page 50.	教科書の５０ページを開きなさい。
We learn much from experience.	我々は経験から多くを学ぶ。
I just don't know what to say.	何とも言いようがないなあ。
English is studied in Japan.	英語は日本で勉強されています。
The party set out for Kobe.	一行は神戸へ向けて出発しました。
I am good friends with Beth.	わたしはベスと大の仲良しです。
I want to travel with you.	わたしはあなたと、旅行に行きたい。
Room service. May I help you?	ルームサービスです。御用は。
Yumi has much money now.	ユミは今たくさんのお金を持っています。
Do your work with more care.	もっと注意して仕事をしなさい。
Do you have a smaller size?	もっと小さいサイズがありますか。
I haven't seen her for ages.	もう長いこと彼女をみかけない。
Can you give me some money?	ぼくにいくらかお金をくれないか。
Why don't you have a party?	パーティーを開いたらどうですか。
Can you come to the party?	パーティーにいらっしゃいませんか。
I go to a driving school.	ドライビングスクールに行っています。
Tom is not as old as you.	トムはあなたほど年をとっていません。
Tom and John are good friends.	トムとジョンは仲良しです。
How long has he lived there?	どのくらいそこに住んでいるの。
Tell him where he should go.	どこへ行ったらよいか電話して。
Please tell me your address.	どうぞご住所を教えてください。
Please have a second helping.	どうぞおかわりをして下さい。
There is a book on the table.	テーブルの上に本があります。
Can I have a word with you?	ちょっとお話ししてもいいですか。
I'd like to check in, please.	チェックインしたいのですが。
Don't tell me off like that.	そんな風に叱りつけないでくれ。
I think she made up that story.	それは彼女の創作だろう。
That was the end of the class.	それは授業の終わりだった。
That reads two different ways.	それは２通りに解釈できる。
That is the most I can do.	それが私にできる精一杯のことです。
That article is out of stock.	その品は品切れになりました。
Look over the papers, please.	その書類をざっと見て下さい。
The play ran for six months.	その芝居は６ヶ月間上演された。
I make little of the problem.	その事は問題にしていません。
He couldn't get the job.	彼はその仕事をやらせてもらえなかった。
Please try me for the job.	その仕事に私を使ってみてください。
It'll cost me my job.	そのために仕事を失うことになるかもしれない。
You can't have both books.	その２冊の本の両方ともはだめです。
How about some Spanish food?	スペイン料理なんかどうですか。
We will take care of this for you.	すぐに処理します。
John and I are old friends.	ジョンと私は古くからの友達です。
Is Mr Jones in the office?	ジョーンズさんは事務所にいますか。
Jim is in my black book.	ジムは私のブラックリストに載っている。
Now I must go about my work.	さあ、仕事に取り掛からなきゃ。
Can't you go on any longer?	これ以上先に進んで行けないのか。
I can't take any more work.	これ以上仕事を引き受けられない。
Could you keep this for me?	これを預かっていただけませんか。
These are as good as those.	これらはあれらと同じくらい良い。
These books are used by him.	これらの本は彼が使っています。
These are gifts for my friends.	これは友人への土産です。
Who is the author of this book?	この本の著者は誰ですか。
This store is closed at nine.	この店は９時に閉じられます。
This store is opened at eight.	この店は８時に開かれます。
This man is very, very old.	この男は非常に年をとっています。
I like this house as it is.	この家はこのままにしておきたい。
This house has eleven rooms.	この家には１１部屋があります。
Is there a hotel around here?	この辺にホテルはありますか。
This costs more than that.	こちらの方がこちらより値段が高い。
Could you sign here, please?	こちらにサインをいただけるか。
Ken was running at that time.	ケンはその時走っていました。
You must be just to them.	きみは彼らに公正であらねばならない。
How would you like to pay?	お支払いはどのようになさいますか。
How much money do you have?	お金はどのくらい持っていますか。
I don't see your point.	おっしゃることの意味がよく分かりません。
When shall I return the book?	いつその本を返しましょうか。
No. He doesn't like water!	いいや。あいつは水がキライなんだ。
I didn't care about going out.	あまり出かけたくなかった。
He doesn't have long to live.	あの人はあまり先が長くない。
You had better go in person.	あなた自身が行った方がいいよ。
She asked me how old I was.	あなたは何歳ですかと私に言った。
How come you're still working?	あなたはなぜ働いているの。
Were you told to do so?	あなたはそうするように言われたのですか。
How long have you studied?	あなたはいつから勉強していますか。
Write your name and address.	あなたの住所氏名を書きなさい。
How are your studies going?	あなたのご研究は、いかがですか。
I know what your game is.	あなたが何を企んでいるかお見通しだ。
There is no school during August.	８月には授業がない。
Look at the notes on page 10.	１０ページの注釈を見なさい。
He said, "Come with us."	「私達と一緒に来なさい」と彼は言った。
He posted on a message board.	彼が掲示板に書き込みをしました
He makes high-quality products.	彼が高品質の製品を作ります
I get older every year.	毎年新年が明けるたびにひとつ年齢を重ねます
We have three websites.	当所では３つのホームページを運営しています
The old man was run over by a car.	老人が車にひかれた。
Are there special evening rates?	夜間の割引はありますか。
I'll have to come here every year.	毎年ここに来なきゃ。
I don't go by what he says.	僕は奴の言うことは信用しないんだ。
Can I change the date of return?	返却日を変更できますか。
They have no house to live in.	彼等には住む家がありません。
She has to study science.	彼女は理科を勉強しなければなりません。
She took over the will of him.	彼女は彼の意志を引き継いだ。
I haven't seen her for ages.	彼女は長いことお会いしてません。
She traveled all over the world.	彼女は世界中を旅行した。
She provided me with some food.	彼女は私に食べ物をくれた。
She asked me where to go.	彼女は私にどこへ行ったらよいか聞いた。
She is two years older than you.	彼女は君より２つ年上だ。
She came around to my house.	彼女は急いで私の家にやって来た。
She studies English every day.	彼女は英語を毎日勉強します。
She will be back before long.	彼女はほどなくもどるでしょう。
She owns a very big house.	彼女はとても大きな家を所有している。
She is at the top of her class.	彼女はクラスでトップです。
She didn't take many photos.	彼女はあまり写真を撮らなかった。
She visits us every other day.	彼女は１日おきに訪ねてくる。
She wrote as many as ten books.	彼女は１０冊も本を書いた。
She and I are in the same class.	彼女と私は、同級生です。
She loves Tom, not me.	彼女が愛しているのはトムであって、私でない。
They sent him to North America.	彼らは彼を北米へ行かせた。
They are running in the park.	彼らは公園の中を走っています。
Some of them are my friends.	彼らのうち何人かは私の友達です。
He took her out for a drive.	彼は彼女をドライブに連れ出した。
It was she who made him do it.	彼は彼女にそれをさせられた。
He had a good look at the papers.	彼は入念に書類を見た。
He'd love to live in the city.	彼は都会の生活にあこがれた。
He replied that he did not know.	彼は知りませんと答えた。
He came running into the room.	彼は走って部屋に入ってきた。
He set out for Paris last month.	彼は先月パリへ出発した。
He lived to be seventy years old.	彼は七十歳まで生きた。
He made a sign to me to go out.	彼は私に出てけと合図した。
He did not say a word to us.	彼は私たちに一言も言わなかった。
He asked us what we wanted.	彼は私たちになにが欲しいか尋ねた。
He will be here all evening.	彼は今晩ずっとここにいるだろう。
He comes here every five days.	彼は五日に一度ここへ来ます。
He is well known in our country.	彼はわが国では有名です。
He studied law at Harvard.	彼はハーバードで法律の教育を受けた。
He had access to the papers.	彼はその書類を見る地位にあった。
At best he may take third place.	彼はいいとこ三位だろう。
He hasn't had much education.	彼はあまり教育を受けていない。
He comes here every three days.	彼は３日ごとにここへ来る。
He asked me who I was.	彼は、私に、あなたは誰ですか、と尋ねました。
He is two years older than you.	彼はあなたより２歳年上だ。
I'll ask him if he will come.	彼に来るかどうか聞いてみます。
Please ask him to call me.	彼に電話をくれるように頼んで下さい。
I have not seen him in months.	彼には何ヶ月も会っていない。
He is just the man for the job.	彼こそ適材適所という者だ。
He is the very man for the job.	彼こそその仕事の適任者だ。
We don't care what he does.	彼が何をしようと我々は気にしない。
Can you come on Sunday evening?	日曜日の晩に来られますか。
Is this your first visit to Japan?	日本は初めてですか。
I don't even have time to read.	読書をする時間さえもない。
They are all my personal belongings.	全部所持品です。
When did life come into being?	生命はいつ誕生したのですか。
People live only about 70 years.	人生わずか７０年である。
Give me some paper to write on.	書くために紙を少し下さい。
You shall have what money I have.	所持金を全部あげよう。
I don't have the address with me.	住所は今持っていない。
I gave him what money I had.	持っていたお金は全部彼にあげた。
We took him for an American.	私達は彼をアメリカ人だと思った。
I will buy a new car next month.	私は来月新車を買います。
I got my friends to help me.	私は友人に頼んで助けてもらった。
I love you more than her.	私は彼女よりあなたのほうを愛している。
I can make out what she said.	私は彼女のいうことを理解する。
I have to do right by him.	私は彼に義理を立てなければならない。
I got the money back from him.	私は彼からお金を取り返した。
I have to study Japanese.	私は日本語を勉強しなければなりません。
I've been here since Saturday.	私は土曜日からここにいます。
I've been in Sapporo before.	私は前に札幌に住んでた事がある。
I paid him the money last week.	私は先週彼にお金を払った。
I have been to the library.	私は図書館へ行ってきたところです。
I have no friends to help me.	私は助けてくれる友人がいない。
I am loved by all my family.	私は家族のみなに愛されています。
I have been here for many years.	私は何年もここにいます。
I must go some day or other.	私は何時の日か行かねばならない。
I don't know what to study.	私は何を勉強すべきか分かりません。
I have been here for a week.	私は一週間ここに滞在しています。
I've been to Sapporo before.	私は以前に札幌に行った事がある。
I'd like to visit London.	私はロンドンに行きたいと思っています。
I asked Mike to help me.	私はマイクに助けてくれるようにたのんだ。
I had a good time at the party.	私はパーティーで楽しんだ。
What size do you think I take?	私はどのサイズが合いますか。
I am going to tell you that.	私はそれをあなたに話すつもりだ。
I allowed Kate to go home.	私はケイトに、家に帰るのを許可した。
I must go some day or other.	私はいつかいかなければならない。
May I see the room, please?	私の部屋を見せていただけませんか。
My life is coming to an end.	私の人生も終わろうとしています。
My plan is different from yours.	私の計画は君のとは違う。
My family are all very well.	私の家族はみんなとても元気です。
My house is a long way from here.	私の家はここから遠い。
Will you make room for me?	私のために場所をかけてくれませんか。
We study English at school.	私たちは学校で英語の勉強をします。
We used to play in the park.	私たちはよく公園で遊んだものだ。
We have made friends with Tom.	私たちはトムと親しくなった。
Our school has ten classes.	私たちの学校には１０の学級がある。
Our class is a small one.	私たちのクラスは少人数のクラスである。
Yamamoto is one of my friends.	山本君も私の友人の一人です。
I had a good time last evening.	昨日の晩は楽しかったです。
Why don't you take the day off?	今日一日は仕事を休んだら？
You don't need to study today.	今日は勉強しなくてよろしい。
Today is the best day of my life.	今日は人生最良の日だ。
You can come and get it today.	今日取りにいらしてください。
Sales have been off this month.	今月の売り上げはよくない。
Please read between the lines.	言外の意味をとってください。
You and I are very good friends.	君と私はとても仲がいい。
Kyoto is not as large as Osaka.	京都は大阪ほど大きくない。
Ask, and it shall be given you.	求めよ、さらば与えられん。
How did she tell them?	彼女はそれをどのようにして知らせたのですか。
We need action, not words.	我々は言葉ではなく行動が必要なのだ。
We must know about it.	我々はどうしてもそれを知らなければならない。
We looked for it high and low.	我々はあちこちそれを探した。
May I ask about your family?	家族について聞いてもいいですか。
Thousands of people were there.	何千もの人々がそこにいた。
A Mr. So and So came today.	何とかさんという人が今日来ました。
What was it that you gave him?	一体何を彼にあげたのですか。
It's better than it was before.	以前と比べるとよくなった。
I think it better not to try.	やってみないほうがよいと思う。
Do your work with more care.	もっと注意をして仕事をしなさい。
Have you done with the paper?	もう新聞を読み終わりましたか。
Mary likes Japan, doesn't she?	メアリーは日本が好きですね。
Mr White has gone to Canada.	ホワイト氏はカナダへ行きました。
Mr White has gone to Canada.	ホワイト氏はカナダに行きました。
My hotel told me to call you.	ホテルで聞いて電話しています。
Why did he come with her?	なぜ彼は彼女といっしょに来たのですか。
Why do you think he said so?	なぜ彼はそう言ったと思いますか。
Why do you study every day?	なぜあなたは毎日勉強するのですか。
Which subject do you like best?	どの教科が一番好きですか。
Which subject do you like best?	どの学科が一番好きですか。
Which subject do you like best?	どの科目が一番好きですか。
How did you find my house?	どうやって私の家を見つけたのですか。
I don't like those who say so.	そんなことを言う人は嫌いだ。
That is not much of a problem.	それはたいした問題ではない。
Well, you got a point there.	そりゃ、その通りかもしれないな。
The old man asked me the time.	その老人は私に時間を尋ねた。
What is the title of the book?	その本のタイトルは何ですか。
The level of the school is high.	その学校のレベルは高い。
Susie loves Japanese music.	スージーは日本の音楽が大好きです。
I might well tell you this.	これは申し上げた方がよいでしょう。
This will do us for the present.	これで今我々に十分です。
This is the house where I live.	これが私の住んでいる家だ。
This book is not sold here.	この本はここでは売られていません。
There are no houses around here.	この辺りには人家がない。
How many credits is this course?	この科目は何単位ですか。
How long have you been here?	ここに来て、どれくらいになるの？
This is just between you and me.	ここだけの話なんだけど。
Ken must be home by now.	ケンは、今ごろ家に着いているに違いない。
Your credit card, please.	クレジットカードをみせていただけるか。
I think Ann loves Jack.	アンはジャックを愛しているのだと私は思う。
Do you know who that person is?	あの人誰だかわかりますか。
You don't have to work today.	あなたは今日は働かなくてよい。
What would you like to do today?	今日は何をしたいですか。
How many siblings do you have?	あなたは何人兄弟がいますか。
How many books do you have?	あなたは何冊の本を持っていますか。
What did you say to Paula?	あなたはポーラに何と言ったのですか。
What papers do you take in?	あなたはどの新聞をとっていますか。
How do you account for that?	あなたはそれをどう説明しますか。
Do you have a part time job?	あなたはアルバイトをしているの。
Shall I come to your office?	あなたの事務所に行きましょうか。
You may be right about that.	あなたの言う通りかもしれません。
Will you sell me your house?	あなたの家を売ってくれませんか。
I will give you the money.	あなたにそのお金を差し上げましょう。
What were you doing down there?	あそこで何をしていたのか。
You should come home before six.	６時前に帰って来なさい。
I am the oldest of the three.	３人のうちで私が一番年上です。
You must be back before ten.	１０時前に戻らなければならない。
I don't have any money on me.	お金のもちあわせがありません。
Come to my office any time.	いつでも事務所にいらしてください。
Sign up for the point site.	あなたがポイントサイトに登録をします
Other special software is needed.	別に専用のソフトが必要だ
He will open a location in Kyoto.	彼が京都市に店舗を構える
He lives every day as best he can.	彼が毎日を精一杯生きる
It comes with a special case.	それには専用のケースが付属します
I'm saving money for my old age.	老後のためにかねをためる。
What does she do in the evening?	夕方に彼女は何をしますか。
Learn little by little every day.	毎日少しずつ学びなさい。
What time do you get up every day?	毎日何時に起きますか。
I could read between the lines.	僕は、暗黙のうちに理解した。
Study or don't--it's up to you.	勉強するもしないも君次第だ。
There was no one in the room.	部屋の中には誰もいませんでした。
There is more water than is needed.	必要以上の水がある。
I'm not much of a one for art.	美術に凝っているわけでもない。
She was a Christian in life.	彼女は存命中キリスト教徒であった。
She was in America last month.	彼女は先月アメリカにいました。
She has as many books as I.	彼女は私と同じくらい本を持っている。
It was not long before she came.	彼女はほどなくやってきた。
She does not have much money.	彼女はあまりお金はもっていない。
She will be back within a week.	彼女は１週間以内に戻ります。
She's been working all day long.	彼女は、１日中働いている。
Will you give me her address?	彼女の住所を教えてくれませんか。
Please book a room for her.	彼女のために部屋を予約してください。
The story came home to her.	彼女にはその話がしみじみ感じられた。
Tell me where she lives.	彼女がどこに住んでいるかを教えてください。
They have access to the library.	彼らは図書館を利用できる。
They worked to help people.	彼らは人々を助けるために働きました。
They visit us from time to time.	彼らは時々私たちを訪れる。
He has been in Hokkaido before.	彼は北海道にいたことがある。
Does he need to help her?	彼は彼女を援助してやる必要がありますか。
He called her every other day.	彼は彼女に一日おきに電話した。
He told her that he loved her.	彼は彼女に愛してるよと言った。
He has only to ask for help.	彼は助けを求めさえすればいいのだ。
He asked me who that man was.	彼は私に、その男は誰かと尋ねた。
He did it the way I told him to.	彼は私が言うとおりにした。
He works in the planning section.	彼は企画課で働いている。
When did he say he would come?	彼は何時に来ると言いましたか。
He doesn't know English at all.	彼は英語をまったく知らない。
He is the right man for the job.	彼はその仕事に適切だった。
When did he return from Osaka?	彼はいつ大阪に戻ったのですか。
He said, "I'm from Canada."	彼は「私はカナダ出身です」と言った。
I couldn't get him on the phone.	彼に電話連絡できなかった。
It's no use asking him for help.	彼に助けを求めても無駄だ。
Will you sell your house to him?	彼に家を売るつもりですか。
He has not a little experience.	彼には少なからぬ経験がある。
He has no friend to play with.	彼には一緒に遊ぶ友達がいない。
I have known him for ten years.	彼とは１０年来の知り合いだ。
He acted like he owned the place.	彼が大きな顔をしていた。
We don't care what he does.	彼が何しようとわれわれは気にしない。
In Japan, we are paid by the month.	日本では、月給です。
How would you like these items?	内訳はどのようにしましょう？
The food isn't very good here.	当地は食べ物があまり良くない。
I've got to take a make-up test.	追試を受けなきゃならない。
China is much larger than Japan.	中国は日本よりずっと広い。
How will you travel to Osaka?	大阪にはどうやって行くんですか。
I look up to him in many ways.	多くの面で彼を尊敬しています。
Don't get in people's way.	他人の足を引っ張るようなことはするな。
We make the total about $50.	総額はおよそ５０＄ぐらいだと思う。
May I share this table with you?	相席させていただけますか。
Tell me the right time, please.	正確な時間を教えてください。
What does all this add up to?	これはいったいどういうことなの。
Life is full of ups and downs.	人生には浮き沈みがつきものだ。
What forms do we need to file?	申告にはどの書類が必要ですか。
How do you like your new class?	新しいクラスはいかがですか。
He kept at the job all day.	少年は終日その仕事を根気よくやった。
At first, I didn't like him.	初めは彼のことが好きではなかった。
I don't have the address with me.	住所は今持っていません。
Do you want me to give you a hand?	手伝ってほしいですか。
If only I could drive a car.	車を運転できさえすればいいのだが。
When should I return the car?	車はいつ返したらいいでしょうか。
We want to be international.	私達は国際人になりたいと思います。
I'll set out for China next week.	私は来週中国に発ちます。
I've known her for a long time.	私は彼女とは長い付き合いだ。
I worked hand in hand with him.	私は彼と協力して仕事をした。
I don't think that he's right.	私は彼が正しいとは思いません。
I don't care what he says.	私は彼がなんと言おうと気にしていない。
I'm getting better every day.	私は日に日に快方に向かっている。
I have not seen you for ages.	私は長い間あなたにあっていない。
I changed my address last month.	私は先月、住所を変更した。
I call on him every other day.	私は一日おきに彼を訪問します。
I have little money with me.	私はほとんど金の持ち合わせがない。
I have got a personal computer.	私はパソコンをもっています。
I'll do my best on the test.	私はテストで最善を尽くすでしょう。
Am I included in the team?	私はそのチームに含まれているのですか。
I must help these people.	私はこれらの人々を助けなければならない。
One of my friends knows you.	私の友達の一人は君を知っています。
My plan is different from yours.	私の計画はあなたのと違う。
My family is not very large.	私の家族はそれほど大家族ではない。
My house is close to the park.	私の家は公園のすぐ近くにある。
We were in the same class then.	私たちは当時は同級生だった。
We must help each other.	私たちはお互いに助け合わなくてはならない。
Our school has nine classes.	私たちの学校にはクラスが９つある。
I'll act as a guide for you.	私があなたの案内役を務めましょう。
I'd like to pay the check, please.	支払いをお願いします。
How about two weeks from Thursday?	再来週の木曜日はどう。
I'll call you up this evening.	今晩そちらにお電話いたします。
She will be here this evening.	今晩、彼女はここに来るだろう。
What are you going to do today?	今日は何をするつもりですか。
It is all up with him by this time.	今頃彼は万事休すだ。
I am not the person I used to be.	今の私は昔の私ではない。
There is no time like the present.	現在にまさる時はない。
It'll come all right in the end.	結局うまくおさまるだろう。
You had better not drive a car.	君は車を運転しない方がいい。
You can drive a car, can't you?	君は車の運転ができますよね。
You'd better not go out today.	君は今日外出しないほうがいい。
What do you need the money for?	君はなぜこの金が必要なんだ。
I think your work is all right.	君の仕事は申し分ないと思う。
You have a good friend in me.	君にはぼくというよい友達が居る。
How old will you be next year?	君たちは来年何歳になりますか。
Tell me when you will call me.	君が訪ねる時間を教えて下さい。
I just came up with the word.	偶然その単語にであったわけです。
I haven't seen him for a long time.	久しく彼に会わない。
I ran in order to be on time.	間に合うように走ってきたのです。
I like Chinese food in general.	概して私は中華料理が好きだ。
We must provide for old age.	我々は老後に備えなければならない。
It's great to have a family.	家族がいるって素晴らしいことです。
What time will the game start?	何時に試合は始まるでしょうか。
I was called on in English class.	英語の時間に当てられた。
A man's life has its ups and downs.	栄枯盛衰は世の習い。
There was no water in the well.	井戸には少しの水も無かった。
I have been to London before.	ロンドンに以前行ったことがある。
I sold off all my records.	レコードは全部売り払ってしまったんだ。
I'm going to save more money.	もっとお金をためようと思うんだ。
Mr White has gone to India.	ホワイト氏はインドへ行ってしまった。
Shall I ask Peter for help?	ピーターに手伝ってもらいましょうか。
When shall we have the party?	パーティーはいつにしましょうか。
Every country has its own history.	どの国にも歴史がある。
And why do you think that is?	どうして届かないのか分かってる？
Why did you part with your house?	どうして家を手放したの。
Please don't bother about me.	どうか私に気を使わないで下さい。
I'm just about to check in.	ちょうどチェックインするところです。
I haven't seen her since then.	それ以後彼女に会っていません。
There is no person to do it.	それをしようとする人は誰もいない。
The box was full of books.	その箱には本がいっぱい入っていました。
The shop is closed on Sundays.	その店は日曜日は閉まっている。
The shop is closed on Sunday.	その店は日曜日にはしまっている。
You had better look up the word.	その単語は調べた方がいい。
What time does the game start?	その試合は何時に始まりますか。
The word is no longer in use.	その語は今はもう使われていない。
John was another great player.	ジョンもまたえらい選手だった。
John gave Mary some money.	ジョンはメアリーに少しのお金を上げた。
Mr Johnson's was a large room.	ジョンソンさんのは広い部屋だ。
So long, have a good time.	さようなら、有意義に過ごしてください。
Are these all the sizes you have?	サイズはこれだけですか。
You may have it for the asking.	ご入用でしたらさしあげます。
Try this on. It's your size.	これを着てごらんよ君のサイズだよ。
What's the point of doing this?	これをして何のためになるの。
Please keep this book at hand.	この本を手元に置いてください。
There are ten people in this room.	この部屋に１０人いる。
This box was made by Tony.	この箱はトニー君によって作られました。
Who is the author of this story?	この小説の作者は誰ですか。
Give me a hand with this case.	この事件に手を貸してください。
This word comes from Greek.	この言葉はギリシャ語に由来している。
This house must be done up.	この家は手入れをしなければならない。
Who is the owner of this house?	この家の持ち主はだれですか。
How long have you lived here?	ここにどれくらいお住まいですか。
Both Ken and Meg are my friends.	ケンもメグも私の友達です。
It's good. You should try it.	おいしいよ。試してみるべきだよ。
No, I did it on my own account.	いや、自分からやったんです。
One day I visited an old friend.	ある日私は旧友を訪問した。
What did you do with those books?	あの本はどうしましたか。
Shall I buy some for him?	あの人のために何か買ってあげましょうか。
Do you go shopping every day?	あなたは毎日買い物に行きますか。
Have you read today's paper?	あなたは今日の新聞を読みましたか。
Did you take part in the game?	あなたは競技に参加しましたか。
What are you trying to do?	あなたは何をしようとしているのですか。
What subject do you like best?	あなたはどの学科が好きですか。
Which box do you like better?	あなたはどちらの箱が好きですか。
You have only to ask for it.	あなたはそれを求めさえすればよい。
How many rooms do you have?	あなたはいくつ部屋を持っていますか。
Write your name and address.	あなたの名前と住所を書いて下さい。
Please tell me what you think.	あなたの考えを言ってください。
Tell me all about your plan.	あなたの計画について話して下さい。
I have looked for it up and down.	あちこちでそれを捜した。
I don't care what they say.	あいつが何を言おうが僕は気にしない。
I will be back in two week's time.	２週間で帰ってきます。
I had a good time this evening.	今夜はとても楽しかったです。
You should have visited Kyoto.	ぜひ京都へ行くべきだったのに。
He will check the stock and price.	彼が在庫や価格を確認する
He has sold shares in Company A.	彼がＡ社の株式を売却しました
I should not have said that.	言わずもがなのことを言ってしまった。
Will you be seventeen next month?	来月１７歳になるのですか。
Yoko will go to Kyoto next week.	洋子は来週京都へ行くだろう。
Where can I find the post office?	郵便局はどこにありますか。
We're having some friends over.	友達を呼ぼうと思っているんだ。
Do you get on with your friends?	友達と仲良くやっていますか。
The problem is what to do next.	問題は次に何をしたらよいのか。
Look at me with your books closed.	本を閉じて私を見なさい。
What subjects do you like the best?	勉強は何が好きですか。
Could you make it another time?	別の機会にお願いできませんか。
Could you change my room for me?	部屋を替えていただけますか。
They provide value for money.	費用に値するだけの価値を提供する。
She is going to France next week.	彼女は来週フランスへ行く。
She will give a party next week.	彼女は来週パーティーを催す。
She goes to market every day.	彼女は毎日市場に買い物に行きます。
She made a point of visiting me.	彼女は必ず私を訪ねてくれた。
She's at most 20 years old.	彼女は多く見ても２０歳というところだ。
She was content with her life.	彼女は自分の生活に満足していた。
She asked me if I was all right.	彼女は私に大丈夫かと尋ねた。
She is said to have been a model.	彼女はモデルだったそうだ。
She didn't have much money.	彼女はほとんどお金を持っていなかった。
She is working on the problem.	彼女はその問題と取り組んでいる。
She made news in that country.	彼女はその国で話題の人となった。
I haven't seen her for ages.	彼女には長いことお会いしていません。
There are six people including him.	彼を入れて６人います。
Not all of them are present.	彼ら全員が出席しているわけではない。
All of them are not present.	彼らは全員出席しているわけではない。
They made us work all day long.	彼らは私たちを一日中働かした。
They made us work all day long.	彼らは私たちを１日中働かせた。
They have orders to return home.	彼らは帰国命令を受けている。
They made much of what they saw.	彼らはその光景を重大視した。
Does he study English every day?	彼は毎日英語を勉強しますか。
He is the oldest of them all.	彼は彼らみんなの中で一番年上です。
He handed the salesclerk the money.	彼は店員に金を渡した。
He studies history at college.	彼は大学で歴史の勉強をしている。
He has a large family to support.	彼は多くの扶養家族がいる。
He came running into the room.	彼は走りながら部屋へ入ってきた。
He had friends all over the world.	彼は世界中に友達がいる。
He traveled about the world.	彼は世界のあちこちを旅行して回った。
He is two years older than Ogawa.	彼は小川より二歳年上です。
He has more books than I do.	彼は私よりもたくさん本を持っている。
He is older than I by two years.	彼は私より２歳だけ年上です。
He asked me about my new job.	彼は私の新しい仕事について尋ねた。
He is not studying English now.	彼は今英語を勉強していません。
He was asking about your health.	彼は君の安否を尋ねていたよ。
Did he tell you what to do?	彼は君に何をしたらいいか教えましたか。
He doesn't have to go to school.	彼は学校へ行かなくてもよい。
He did not know what to say.	彼は何と言ってよいかわからなかった。
He is said to still be in Paris.	彼はまだパリにいるそうです。
He will be coming to the party.	彼はパーティーに来るでしょう。
Where did he find the money?	彼はどこでそのお金を手に入れたのか。
He set the box down on the table.	彼はテーブルに箱を置いた。
He was an old hand at the game.	彼はそのゲームに熟練していた。
How much money does he have?	彼はお金をどのくらい持っていますか。
It is said that he is in Britain.	彼はイギリスにいるそうだ。
Does he know what you did?	彼はあなたが何をしたのか知っていますか。
He had a large family to support.	彼には扶養家族が多かった。
He had no friend to help him.	彼には助けてくれる友がいなかった。
When would you like to see him?	彼にいつお会いになられますか。
Tell me what has become of him.	彼がどうなったか教えて下さい。
He came out of the room at last.	彼がついに部屋から出てきた。
Don't bother with what he said.	彼がいったことは気にするなよ。
Japan is not as large as Canada.	日本はカナダほど大きくない。
Do you have any Japanese foods?	日本の食料品を扱っていますか。
Tell me what you did in Tokyo.	東京で何をしたか教えてください。
Saturday is the last day of week.	土曜日は週の最後の日です。
Please phone me before you come.	電話をしてからきてください。
Can you take notes over the phone?	電話でメモが取れますか。
I have long wanted to see you.	長い間君に会いたいと思っていた。
Is there life on other worlds?	地球以外の天体に生物はいますか。
Who is going to try this case?	誰がこの事件を裁くのでしょうか。
I visited him this day last week.	先週の今日彼を訪ねました。
I can't sell it for love or money.	絶対にそれは売らないよ。
I'll tell him to call you back.	折り返し電話するよう伝えます。
Living costs are getting higher.	生活費が高くなってきている。
New Year's Day is close at hand.	正月がすぐそこまで来ている。
Water tries to find its own level.	水は水平になろうとする。
Please, you can have the paper first.	新聞を先にどうぞ。
Please send us more information.	新しい資料をお送りください。
He came in while we were at table.	食事中に彼が入ってきた。
Is this your first visit to Japan?	初めての日本訪問ですか。
Hand it over. That's all you've got?	出せ。他にないのか。
Do you know how to drive a car?	車の運転の仕方を知っているか。
How is it in a private school?	私立の学校はどういう感じですか。
We had our photo taken by him.	私達は彼に写真を撮ってもらった。
I want to learn standard English.	私は標準英語を勉強したい。
I look on him as my best friend.	私は彼を親友と見なしている。
I took him for my close friend.	私は彼を親しい友人と間違えた。
I gave him what money I had.	私は彼に持っていたお金を全部あげた。
I told him about our school.	私は彼に私たちの学校のことを話した。
I found a good friend in him.	私は彼といういい友人を手に入れた。