I think that X will become an issue in the future.	Xは今後の課題と思います
I think this was made around the Momoyama Period.	それは桃山時代前後の作品だと思います
I think this movie is from the early Showa Period.	それは昭和初期の映画だと思います
He doesn't really care about X.	彼がXをあまり気にしない
He's going to talk about that night.	彼がその日の夜の話をする
I got a look like that on my face.	自分がその顔をする
It sounds like something fell.	何かが倒れる音がした
A lot of people helped out.	いろんな人が努力をしました
Sorting will be done by hand.	人が選別業務をします
He started talking.	彼が言葉を口にした
Children studied English.	子ども達が英語の勉強をしました
Our staff can help you create it.	スタッフが作品づくりの手伝いをします
He put it this way.	彼がこういう言い方をしました
Ages 68 and below.	年齢が６８歳以下の者とする
They did not have a discussion.	彼らが議論をしませんでした
A new team had a match.	新チームが試合をしました
The person in charge will check it.	係の人がチェックをする
Children play with water.	子供たちが水遊びをする
I am in charge of it.	わたくしが管理をします
He made that a key word.	彼がそれをＫｅｙＷｏｒｄにする
He put it like that.	彼が、そんな表現をした
It made X possible.	それがXを可能とした
He turns it on.	彼がＯＮにします
He brought up X.	彼がXをネタにする
Many students have part-time jobs.	多くの学生が、アルバイトをします
X has one meaning.	Xには一つ意味が有ります
That has 2 new functions.	それには２つの新機能が有ります
I want to ask all of you two questions. 	二つ皆さんに質問が有ります
First, set the following settings:	まず、以下の設定を行います
He is open to discussion at any time.	彼が随時相談の受付を行う
They are thinking something.	彼らがなにかを考えている
X is thought to be important.	Xが重要と、考えます
He thinks about the meaning of X.	彼がXの意味を考える
I watched an old movie I hadn't seen in a long time.	久しぶりに昔の映画を見ました
Let's look at the site then.	当時のサイトを見よう
He looks at much older pictures.	彼がもっと過去の画像を見る
He watched an old video that he hadn't seen in a long time. 	彼が久しぶりに昔の映像を見た
He watches TV with me/them.	彼が一緒にテレビを見る
He watched the news for the first time in a long while.	彼が久しぶりに最近のニュースを見た
He watched that DVD.	彼がそのＤＶＤを見た
He reads the map of the events for that day.	彼がこの日のイベント地図を見る
He looks at more items in this category.	彼がもっとこのカテゴリーの商品を見る
He looks at the previous results.	彼が前回の結果を見る
I feel very good.	とても気分が良い
Natto is really good for you.	納豆は本当に体に良い
It's easy to use.	使い勝手が良い
There are many children.	子供たちの人数が多い
There are a lot of shops that aren't open.	休みの店が多い
X had little meaning.	Xがあまり意味を持たなかった
One software package includes both functions.	その両方の機能を１つのソフトウェアが持っている
I have children of about the same age.	自分が同じ年代の子供を持っている
He has a 6-year-old child.	彼は６歳のお子様を持っている
It has a lot to do with our life.	それが私たちの生活に大きな関わりを持っています
He has two faces.	彼が二つの顔を持っています
It's easy to book a hotel from Japan in Japanese.	日本から簡単に日本語でホテルの予約が出来る
It's hard for me to do X.	Xが私にはなかなか出来ない
I will have a child.	自分に子供が出来る
There are 7 ways to use it on your body.	全身に７通りの使い方が出来ます
I just can't understand it.	私には全く理解が出来ません
The test results have not come back yet.	まだ検査の結果が出ない
The results of the meeting have not come out yet.	まだ会議の結論が出ない
Stories from back in high school always come up.	必ず高校時代の話が出る
X is right on display.	Xがモロに前面に出る
I'm getting a directory access error.	ディレクトリアクセスエラーが出る
Many people ask me the same question.	私はその質問を多くの方から受けます
I'm not very interested in X.	Xにはあまり興味が無い
He didn't feel that way at all.	本人にそういう気がまったく無かった
I was not interested in it at all.	それに全く興味が無かった
I don't have a very good memory.	記憶には全く自信が無い
There is really no end.	本当にキリが無い
She/He sounded down.	声に元気が無かった
I have few pictures on hand.	手元にほとんど写真が無い
There are very few examples in the world.	世界にはあまり例が無い
He has never come all the way out here to ask about that.	彼がわざわざ訊きに来る筈が無い
It's said this period lasts for three months.	この期間が３ヶ月と言われています
I felt ～.	私は〜と感じました
He heard that for the first time.	彼はそれを初めて聞きました
A lot of time is still needed before it can be used.	利用できるまでに、まだ多くの時間が必要だ
Something is needed.　	何かが必要だ
I really need your help.	どうしてもあなたの力が必要だ
I really need money.	どうしても金が必要だ
Two students use one computer.	二人の生徒が１台のコンピュータを使う
He uses that word in this meaning.	彼はこの意味でその言葉を使います
I don't use this new function.	私はこの新機能を使っていません
You should never use your hands.	一切、手を使ってはいけません
More and more air and water come.	空気や水がどんどん中に入ります
He entered university.	彼が大学に入った
All the people must purchase health insurance.	国民全員が必ず医療保険に入ります
Many software programs can read the files in this format.	多くのソフトウェアがこの形式のファイルを読めます
He turns on the computer.	彼がパソコンの電源を入れる
He put items into the shopping cart.	彼が商品をカートに入れる
I didn't understand the meaning at all.	私にはさっぱり意味が分かりませんでした
I don't understand the word at all.	全く言葉の意味が分からない
I think I understand how people back then felt.	なんとなくそういう昔の人の気持ちが分かる
Please update the registered information.	是非更新情報の登録をお願いします
I will show two X below.	Xを２つ、以下に紹介します
I will show a part of the e-mail below.	以下にメールの内容の一部を紹介する
I will talk about the food for January.	１月の料理を紹介します
I have two children.	私には子供が二人います
There were many animals in the park.	公園の中には、動物がいっぱいいました
There are local staff on site.	現地にスタッフがいます
X is thought to be the cause.	Xが原因と思われます
People build many organizations within social organizations.	人は社会組織の中にいくつもの組織を作る
I will write about going to look at cars in my journal for the 13th.	車を見に行った話を１３日の日記に書きます
He hasn't gotten started on it yet.	彼がそれにまだ手をつけてません
He named the child.	彼が子供に名前をつけた
It provides the following functions for users.	それがユーザに以下の機能を提供します
Delivery will take a few days.	お届けまでに多少日数を頂きます
I received the message.	その旨の連絡を頂いております
It took a lot of time to get there.	たどりつくまでに、かなり時間がかかりました
It's hard on your back.	腰に負担がかかる
The man said something to the person.	男がその人に声をかけた
He took a lot of time before answering the question.	彼は答える前にじっくりと時間をかけた
I think you will learn a lot more from me.	あなたは私からもっと多くの知識を得るでしょう
He will never try that.	彼はそれに絶対に手を出しません
I can't help making a sound.	私が思わず声を出す
He doesn't know me yet.	彼はまだ、私の事を知らない
You should understand how important X is.	Xの大切さを知りましょう
He heard the word for the first time.	彼はその言葉を初めて知った
The results are shown in the figure.	結果を図に示す
Two examples will be shown below.	以下に２つの例を示します
The value is shown in figure 1.	値を表１に示す
Questions are shown below.	質問事項を以下に示す
He welcomed X.	彼がXに歓迎の意向を示した
In that case, there are three possible ways.	その場合は３つの方法が考えられます
I'm going to go to Tokyo again in July.	７月に再び東京へ行きます
He will go there again on Sunday.	彼がまた、日曜に行きます
Let's check where you are on the map.	すぐにマップで自分の位置を確認しましょう
We started talking about last year again.	また話が去年に戻った
I work hard on X in my own way.	私はXを自分なりに精一杯やる
I did a live show with him at a club.	彼と一緒にライブハウスでライブをやった
He does an event three times a day.	彼がイベントを１日で３回もやった
He looks for a real estate company.	彼が不動産会社を探す
In the end, humans will search out if it's X or not.	Xかを結局人間が探します
X received a lot of support.	Xが多くの支持を集めた
In that case, this function is used.	その際には、この関数を使用します
I received an e-mail like this from a man.	男の人からこんな内容のメールが来た
I didn't feel right about X.	Xが私にはしっくり来なかった
The delivery person came to my house three times.	うちに宅配の人が三回も来た
I can't see the other person's face at all.	全く相手の顔が見えません
Our company logs the e-mail and other information from the person in charge.	当社は担当者ｅ−ｍａｉｌ等を登録します
I log the e-mail.	Ｍａｉｌを登録する
He talks with people in the shop.	彼が店の人と話す
He presented these results at a conference.	彼がこの成果を，学会で発表しました
I make more from my side job than my main one.	副業の収入が本業を超える
They haven't noticed X at all.	Xに本人が全く気付かない
We posted pictures on the member page.	会員ページに写真を掲載しました
I'm still can't figure out men.	自分がまだ、男の人に慣れない
X doesn't really bother me.	Xがあまり気にならなかった
He/She will never become a good person.	まともな人間には決してならない
In that case, the following error message will be displayed.	その場合、以下のエラーメッセージが表示されます
The following message will display on the register page.	レジ画面に以下のメッセージが表示されます
X is possible.	Xが可能だ
The loan amount follows previous examples.	貸付金額については、従前の例による
That makes students more interested in learning.	それが学習への生徒の興味関心を高める
I will address the two issues.	私は二つの課題に取り組みます
I will study something in the university.	自分が大学で何かを学ぶ
I'm always moved by X.	私はXにいつも感動を覚えます
X has continued for 68 times.	Xが六十八回も続いた
I've always loved you.	ずっとあなたが好きだ
I really like music.	本当に音楽が好きだ
I really do like old Hollywood movies.	やっぱり前半のハリウッド映画が好きだ
X was chosen.	Xに決定を致しました
I will continue with my current work.	そのまま、今の仕事を続ける
The man keeps on talking.	更に男が話を続けます
She continued talking.	彼女が更に言葉を続けた
X is very important.	Xが大切だ
I noticed that for the first time today.	Xに今日初めて気がついた
I didn't notice at all while I was doing that.	やっている時には全然気がつかなかった
He shows children how hard he tries.	彼が最大限の努力をしている姿勢を子供たちに見せる
He will submit the application form to the committee by the 10th.	彼が１０日までに申請書を委員会に提出します
X will save children's lives.	Xが子どもの命を守ります
The man started talking about something.	男性がなにやら話を始めた
I can hear X.	Xがわたしの耳に聞こえる
He looks for the full picture.	彼が全貌を探ります
He looked at X again.	彼がXに再び目を向けた
We will set up the following committees:	本会に以下の委員会を置く
This does not mean that all information is posted on the website.	Ｗｅｂサイト上にはすべての情報が掲載されているわけではありません
That information will be posted on the association's website.	その情報が，協会などのホームページに掲載されます
There were a lot of problems going around X.	Xがいろいろ問題にされた
The children made faces at him.	彼が子どもにいやな顔をされた
I choose X.	Xを私が選ぶ
Today, I noticed X for the first time.	Xに今日、初めて気が付いた
The application gave an error message.	アプリケーションでエラーが発生した
You can see how it/he/she is doing now with the camera.	カメラで現在の様子が見られます
You can watch videos for free.	動画が無料で見られる
Answer 24 questions.	２４の質問に答える
It displays 150 of the 1,290 in order.	順に１，２９０件中１５０件を表示します
He added the following functions to the system.	彼がシステムに以下の機能を追加しました
They try to understand each other better.	彼らがさらにお互いの理解を深める
X is very important.	Xが重要だ
He told me that it was because life is getting harder these days.	暮らしにくくなったからだと彼が私に理由を説明する
He always has a lot of people around him.	彼の周りにはいつも多くの人が集まります
I'm heading to Kyoto Park.	京都公園に向かう
The page was updated.	ページを更新しました
I met so many people.	私が本当に多くの人と会う
BarR is looking for part-time staff.	ＢａｒＲではただいまアルバイトスタッフを募集しています
There are two courses in this package.	このパックには、２つのコースをご用意しています
A support network needs to be built.	支援のネットワークづくりが求められる
The amount of water is small.	水の量が少ない
Please enter your current password here.	ここに、現在のパスワードを入力します
Please enter your information on the order form.	注文フォームにお客様の情報を入力する
They all had a lot of their own problems.	それらはそれぞれ多くの問題を抱えていた
He had four children.	彼は４人の子どもを抱えていた
He searched for the blog article.	彼がブログ記事を検索しました
Next, I will give you two examples.	次に２つの例を挙げます
He called the cell phone.	彼がその携帯に電話を掛けた
It really got to me.	それがとてもわたしの心に響いた
I really saw the light.	本当に目から鱗が落ちました
She'll fall in love with a man one of these days.	彼女がやがて男と恋に落ちる
That doesn't sound right to me.	それが腑に落ちない
I will give you two examples below.	以下に例を２つあげます
There are a lot of people like that around.	そのような人が周りにいっぱい居ました
Such person was there too.	あそこにもそんな奴が１人居た
That means X.	それがXを意味します
The code will apply from the 1st of this month.	その規定は今月１日から適用する
We have applied information technology for the security systems.	われわれはＩＴ技術をセキュリティシステムに適用しました
We understand how important personal information is.	当社は個人情報の重要性を認識しています
We will change the services of this rental server as follows:	下記の通りレンタルサーバサービスの内容を変更します
Billy will come to Japan in the early evening.	ビリーさんが夕方頃に日本にやってくる
It has more than two-thirds of the votes.	３分の２以上の議決を経る
I never get around to updating it.	なかなか更新まで手が回りません
He visited a few more stores.	彼があともいくつかの店を回りました
Of course, all services are free of charge.	もちろん完全無料で全てのサービスが受けられます
It makes me feel like this.	それが私をこんな気持ちにさせる
He was born in 1944 in Tokyo, Japan.	彼は１９４４年日本の東京に生まれた
We had a baby in Japan.	日本で子どもが生まれた
It would good for access management or something like that.	そのほうがアクセス権管理などになにかと便利だ
Seven more functions have been added to it.	それがさらに七つの機能を備えた
The offer for office space has been closed.	貸し事務所募集を終了しました
He supports the children of Asia.	彼がアジアの子どもたちを支援します
It's much faster to buy.	買う方が断然早い
It's too early to check in.	まだチェックインには時間が早い
It's much faster to do it like this.	断然こっちのほうが早い
Each of us is supporting today's society.	一人ひとりが今の社会を支えています
The official site is now open!	公式サイトがオープンしました
He met many people.	彼が多くの人に出会いました
X is not so easy for me.	Xがなかなか私には難しい
I feel like there is that.	それがあるように私には感じられる
We all do our best to practice every day.	みんなで日々の練習に励みます
He is moving to a Japanese-style room.	彼が和室に場所を移す
There are always a lot of people around him.	彼がいつも大勢の人に囲まれている
Well, let's get back to the subject.	さて、話を本題に戻します
He always goes through the material.	彼が資料には必ず目を通す
He has put information for 2001 up on the page.	彼がそのページに２００１年の情報を載せました
It's hard to find X.	Xがなかなか見付からない
As a result, more than 40 items were found.	結果４０点以上の商品が見付かりました
We support all those continuing their education.	当社は進学を目指す全ての人を応援します
X cause many problems.	Xが多くの問題を引き起こす
We will send the following message to each user.	それぞれのユーザに以下のメッセージを送信します
He received a message from her.	彼が彼女からメッセージを受け取りました
I was not really in love with her.	自分はべつに彼女に恋愛感情をいだいていなかった
He ended up choosing between them.	彼がいずれかの方法を選択することになりました
The house will be built in Denenchofu.	田園調布に家が建つ
Of course, all services are available free of charge.	もちろん無料で全てのサービスが利用できます
It will provide two functions to this.	それがこれには、２つの機能を持たせます
It will allow a little more room for the space.	若干スペースに余裕を持たせます
It's hard to find time for X.	Xになかなか時間が取れない
Something similar to the current system was built.	ほぼ現在の体制が整った
Registrants will receive the following services for free:	登録者は無料で以下のサービスを受けることができます
Mr. Yamada always said 〜.	〜といつも山田先生が仰いました
I really want to have my own child.	どうしても自分の子供が欲しい
We will ship your order within a week of receiving your e-mail order.	商品は、ご注文メール受け取り後、１週間以内に発送します
Many requests will be coming from the committee members.	各委員から多くの要望が出されます
Mr. Yamada is continuing on from the last time.	山田さんは前回に引き続いてです。
He started to drive to Kyoto again.	彼が再び京都方面へ車を走らせた
He kept on filming.	彼がずっとカメラを回した
He will step into the shop.	彼が店内に一歩足を踏み入れる
It turned out really well. 	それがなかなかいい感じに仕上がりました
I've never brought it with me.	持って行ったためしがない
He will be in charge of the design.	彼がデザインを手掛ける
I've always end up going for X.	Xについつい手が伸びた
I had a lot of X.	Xが私には多かった
There are too many people.	あまりに人が多すぎます
People are not that interested in him any more.	彼がそれほど興味を持たれない
The result is about the same as the personal record.	結果が自己記録にほぼ肩を並べる
He has always had problems with X.	彼がXにはいつも苦労していた
My hands moved on their own.	勝手に手が動く
First, he takes a step.	彼がまずは一歩を踏み出す
He is planning an event on the 27th of this month.	彼がイベントを今月の２７日に企画します
This is much easier.	このほうがよっぽど楽だ
He takes pictures.	彼が写真を撮影する
The following functions have been added to this controller:	この調節計に以下の機能が追加されました
The store is always full of energy.	店内がいつも活気に満ちている
The streets are full of info.	巷には情報が溢れている
It makes us more human.	それが人間性を育む
He will post a comment on this article.	彼がこの記事にコメントを投稿する
He copies the file to the directory 1.	彼がファイルを１のディレクトリにコピーします
Our company moved our office to the following place on 16th.	弊社は事務所を１６日より下記に移転しました
Words like that are always running around in my head.	そんな言葉がいつも頭の中を駆け巡る
I like X a lot.	Xが大変気に入る
X becomes very important.	Xが大変重要になります
The running time was too short.	あまりも上映時間が短かった
The following code is written in the program:	プログラムの中に、以下のコードを記述します
I can't understand X at all.	Xが私には全く理解できない
A lot of people really supported me.	私は本当に多くの人たちに支えられました
Could you put your comments on the blog?	ブログの方にコメントを頂けますか
There are many functions on this.	こちらには多くの機能が搭載されています
Users apply to use our service.	利用者が当社にサービスの利用を申し込む
What's important is how much should be given.	どれくらい与えられるかが肝心だ
It always moves me.	その姿にはいつも心を打たれます
What color is good for me?	自分にはどんな色が似合うか
He turned red at her words.	彼が彼女の言葉に、思わず顔を赤らめた
I can meet a lot of you.	多くの皆さんにお会いできる
Let's all join forces.	みんなの力を結集しよう
It meets the W3C web standards.	それがＷ３Ｃのウェブ標準規格に準拠しています
The blog has not been updated for a while.	しばらくブログの更新が滞りました
I felt so small.	かなり肩身が狭かった
On the day of the game, he will watch it with me/them.	彼が一緒に当日の試合を観戦する
The user edits two files.	ユーザーが２つのファイルを編集します
The following will be added to the level 1 functions:	レベル１の機能に下記の機能をプラスする
I shouldn't have logged off.	ログアウトするんじゃなかったよ。
It is very hot today.	今日はとても暑い。
People who don't have a computer can't make full use of this MP3 player function.	パソコンを持ってない人は、このMP3プレーヤー機能をフルに使いこなせません。
Have I answered your question?	私は質問に答えたでしょうか。
Click the picture to go to the next page!	画像をクリックすると次ページへ移ります！
I'd like to get a bank loan; how do I go about that?	銀行融資を受けたいのだけど手続きはどうしたらいいの？
I've heard of pseudomyopia, but I never thought my own child would come to have it.	仮性近視というのは知ってましたが、まさか自分の子供が仮性近視になるなんて思ってませんでした。
People who want to put out an ezine on education, come this way!	教育のメルマガを発行したい方はこちら！
"I'm back." "Welcome home."	「ただいまー」「お帰りなさい」
If you give up, that's the end of the match.	あきらめたら、そこで試合終了ですよ。
Can I have a few words with you?	ちょっと顔を貸してくれませんか。
OK! Bring it on!	よし、かかってこい！
This site is in a toplist. If you found it interesting, please click!	ランキング参加中です。面白ければ、ポチッと♪
But I understand what he says.	でも、私は彼の言うことが分かります。
It's not as if he can't run fast.	彼は走るのが速くないわけではない。
I also gave him a little something as a Christmas present the other day.	私も先日クリスマスプレゼントにちょっとしたものをあげました。
This a recent photo?	これは、最近の写真？
The present password is "eosdigital".	現在のパスワードは"eosdigital"です。
I don't always get up early.	私はいつも早起きするわけではない。
What! You going to take her side again!?	何よ！またその子の肩を持つ気！？
Get a move on!	なにちんたら歩いてんだ。
By 'Torii' you mean that red objet d'art at the top of the steps?	鳥居と言うと、階段を上がったところにあった赤いオブジェ？
She fell in love with him.	彼女は彼に思いを寄せた。
It would be great if there was a Japanese edition.	日本語版があったらいいな。
Tell me the meaning of life.	生きる意味を教えてくれ。
You can put into practice the plan you thought up.	自分達で考えた企画を実行することができます。
I met him last week for the first time in ages.	私は先週しばらくぶりに彼に会った。
I'd like the bill, please.	勘定書をお願いします。
We'll watch each other and help each other out.	俺たちはお互いに見てて、持ちつ持たれつですよ。
Please come again.	またお越しください。
If so then I want you to do something for me. That will make us even.	だったら、私のお願いを聞いて欲しいの。それでチャラ。
Shhh, she'll hear you!	しーっ、聞こえちゃうってば。
That's because, you see, I've known he isn't that sort of person from a long time back.	こいつがそんな玉じゃないことなんてとうの昔に解っていたからさ。
Use only as directed.	あくまで説明書に従ってお使いください。
I can't find my watch.	腕時計が見つからないんです。
Let's change the subject.	話題を変えましょう。
Let's talk it out.	話をつけようじゃないか。
It isn't as if a child learning to talk studies.	話すことを学んでいる子どもは学ぶわけではない。
Don't talk!	話しかけるな。
I want to talk to you about something.	話したいことがあるのだけど。
Can we talk in private?	話があるんだけど。
It is said that some British people like a Japanese-style room.	和室が好きな英国人もいると言われます。
Old people need something to live for.	お年寄りには生きがいが必要だ。
History presents us with many different answers to each question.	歴史はそれぞれの問題にいくつもの異なった答えを私たちに与える。
Quote me an example.	例を一つ示してください。
The examples are as follows.	例は次の通りです。
Young men such as you are needed for this work.	例えばあなたのような若い人たちがこの仕事には必要だ。
For example, do you like English?	例えば、君は英語が好きですか。
For example, it is 7:00 a.m. in London now.	例えば、ロンドンは今は朝７時です。
Take Jennifer for example.	例えば、ジェニファーを見てごらんよ。
There is a conference going on in the next room.	隣の部屋では会議中です。
You never read a book without being the better for it.	良書を読めば、必ずそれだけ賢くなる。
You'll feel better.	良くなるでしょう。
I tried to get good marks.	良い点を取ろうと努力をした。
All you have to do is study hard to get into a good college.	良い大学に入るためには、あなたは一生懸命勉強するだけでよいのです。
Could you charge it to my room?	料金は部屋につけておいていただけますか。
I understand.	了解しました。
No road is long with good company.	旅は道連れ世は情け。
A person named West called while you were out.	留守中にウェストという人から電話があったよ。
Taking off is easier than landing.	離陸するほうが着陸するよりたやすい。
Take it easy.	落ち着けよ。
Take care lest you should fall.	落ちないように注意しなさい。
You will have to study harder next year.	来年はもっと勉強しなければいけませんよ。
You will have to study harder next year.	来年はもっと一生懸命に勉強しなければいけませんよ。
You'll have to study harder next year.	来年はあなたはもっと勉強しなければいけませんよ。
We will be studying very hard this time next year.	来年の今ごろ、私達は必死に勉強しているでしょう。
You will have studied English for four years next March.	来年の３月で君は英語を学んで４年たつことになる。
We will have lived in Kyoto for eight years next March.	来年の３月で京都に８年住んだことになる。
A new hotel will be built here next year.	来年ここに新しいホテルが建てられるだろう。
I'd like to see you again next week.	来週また会いたい。
Try us again next Monday.	来週の月曜日にもう一度お寄りになってみて下さい。
Next week a family will move in.	来週になると一家族が入ってくる。
Next week, millions of people will be watching the TV program.	来週になると、何十万人もの人がその番組を見ているだろう。
We are going to have a baby next month.	来月赤ん坊が生まれるんです。
We are moving next month.	来月引っ越しするんです。
I am moving next month.	来月に引っ越す予定です。
I am moving next month.	来月には引っ越す予定です。
As many men as came were welcomed.	来た人たちはみな歓迎された。
The next year, World War I broke out.	翌年、第一次世界大戦が始まりました。
I brought the point home to the student.	要点を学生に十分理解させた。
The point is they're too young.	要するに彼らは若すぎるということだ。
In a word, life is short.	要するに人生は短い。
In a word, life is short.	要するには人生は短い。
We must have a new supply of forms.	用紙を補充しなければならない。
How much would you want to pay for the tour?	予算はどのくらいでしょうか。
Did you call me last night?	ゆうべ私に電話くれた？
It wasn't very hot last night.	夕べはあまり暑くなかった。
I had a date with Jane last night.	夕べジェーンとデートした。
Can you direct me to the post office?	郵便局へ行く道を教えてくれませんか。
The post office is down the street.	郵便局は通りに沿ってあります。
The post office is just off the main street.	郵便局は大通りから少し離れたところにあります。
The post office is down the street.	郵便局はその通りを下ったところです。
Let's play.	遊びましょう。
More play will mean less time to study.	遊びが増えれば勉強する時間が減ることになるだろう。
Yumi studies English hard.	由美は英語を一生懸命勉強する。
Yumi studied English last night.	由美はゆうべ英語を勉強した。
I was watching TV when Yumi came.	由美が来たとき私はテレビを見ていた。
Yuki! It's great to see you again!	由紀！また会えてうれしいわ。
I've made lots of friends.	友達もたくさんできました。
It is easy to make a man one's friend, but hard to keep him so.	友人を作るのはたやすいが友情を保つのは難しい。
I have few friends.	友人は少ししかいない。
I have a few friends.	友人は少しいる。
I haven't met friends.	友人とは会っていない。
Even a child knows what it is like to be without friends.	友達がいないと言うことがどんなことかは、子供でさえ知っている。
It is very important to keep your word.	約束を守ることはとても大切なことである。
Let them all come.	矢でも鉄砲でも持ってこい。
Please help me welcome Mr. Nomura.	野村さんを歓迎するのを手伝ってください。
At night we can see more stars there than in Tokyo.	夜は、そこでは東京よりたくさんの星が見える。
Do you offer any night tours?	夜のツアーはありますか。
Stars can be seen at night.	夜には星が見える。
When night came on, we returned home.	夜になって、家へ帰った。
Don't go to such a place at night.	夜にそんなところへ行ってはいけません。
It was night.	夜だった。
Day is breaking.	夜が明けかけてきた。
Night came on.	夜がやってきた。
It is very hot at night.	夜、とても暑い。
The question is how he will get the money.	問題は彼がどうやってその金を手に入れるかである。
The question is who will go there for him.	問題は誰が彼のかわりにそこへ行くかだ。
The question is who will do it.	問題は誰がそれをするかという事です。
The question is not what education is for so much as how you go about it.	問題は教育の目的というよりも教育をどう行うかである。
The question is which to choose.	問題はどっちを選ぶかだ。
The question is where to buy the book.	問題はどこでその本を買うかです。
The question is this: who called her on the phone?	問題はこうなるのだ．つまり誰が彼女に電話をかけたかだ。
The question is this.	問題はこうです。
The question is when to start.	問題はいつ始めるかだ。
The question is which to choose.	問題は、どちらを選んだらよいかということだ。
The question is not so much what it is as how it looks.	問題は、その本質よりもむしろ外観である。
We should know the result by Thursday.	木曜までには結果が分かるはずだ。
You, too, know Mr. Kimura, don't you?	木村さんはあなたもご存じでしょう。
I met a Mr Kimura at the party.	木村さんという人にパーティーで会ったよ。
It is good that you do not have to study so hard.	猛烈に勉強しなくてもすむとは、結構ですね。
Any book will do as long as it is interesting.	面白ければどんな本でも結構です。
It's interesting.	面白いですね。
May I see your license?	免許証を拝見できますか。
Can I see your license, please?	免許証を見せていただけますか。
Put out the light.	明かりを消しなさい。
Turn off the light.	明かりを消して。
Don't turn off the light.	明かりを消さないで下さい。
Will you turn on the light?	明かりをつけていただけません？
Did you hear your name called?	名前を呼ばれるのが聞こえましたか。
Her name was Linda, and she was a year younger than Tony.	名前はリンダで、トニーより１つ年下でした。
I heard my name called.	名前が呼ばれるのを聞いた。
Did you hear your name called?	名前が呼ばれるのが聞こえましたか。
Answer to your name when it is called.	名前が呼ばれたら返事をしろ。
Answer to your name when it is called.	名前が呼ばれたら返事をしてください。
Nagoya is to the east of Kyoto.	名古屋は京都の東の方にある。
You may get it free of charge.	無料でそれが得られる。
Don't work too hard!	無理するなよ！
Take it easy.	無理しないでね。
You should take it easy.	無理してはいけませんね。
Adults only.	未成年者お断り。
I have never been to Paris.	未だパリに行ったことがありません。
If you should meet him, tell him to call me up.	万一彼に会ったら、私に電話をするように言ってください。
What would become of us if war should break out?	万一戦争が起こったら、我々はどうなるのだろう。
The act ended and the lights were turned on.	幕が終わり明かりがついた。
I hear from my friend every year.	毎年友達から便りがある。
I studied English very hard every day, but I didn't learn a lot.	毎日一生懸命に英語を勉強したが、あまり身につかなかった。
Is it this hot every day?	毎日こんなに暑いのですか。
I hear from my friend every month.	毎月友達から便りがある。
Mahjong is one of the most interesting games.	麻雀は最も面白いゲームのなかのひとつです。
Let's get down to business.	本論に入ろう。
Let me tell you about our special.	本日の特別料理について説明します。
The stock prices are on the low side today.	本日の株価は下がり気味です。
Today's movie is The Sound of Music.	本日の映画は「サウンド・オブ・ミュージック」でございます。
It was really interesting.	本当に面白かったよ。
What do you really think of him?	本当に彼のことをどう思いますか。
It is not what a man has but what he is that is really important.	本当に大事なのは、財産ではなく、人間である。
It's really hot there.	本当に暑いところなんだね。
It was real hard work.	本当に骨の折れる仕事だった。
You really did a good job.	本当によくやってくれたね。
I don't really care that much.	本当にそんなに気にはなりません。
Is it really the case?	本当にそうだろうか。
That's really great!	本当にすばらしいですね。
Can I really have it at this price?	本当にこの値段でこれ買えるんですか。
Really?	本当に？
Let's get down to business.	本題に入ろう。
Not all the students of this school go on to university.	本校の生徒の全員が大学に進学するわけではない。
Do you really love me?	本気で私のこと愛しているっていうの？
Do you really mean it?	本気でそう言ってんのか。
Do you mean what you say?	本気ですか。
I mean it!	本気だよ。
Reading books is very interesting.	本を読むのはとてもおもしろい。
Reading a book is interesting.	本を読むことは面白い。
To read books is important.	本を読むことは大切です。
Put your books in order.	本を整頓しなさい。
Bring your books down.	本を持って降りなさい。
I have bought a lot of books.	本をたくさん買ったんだ。
Put the book back where it was.	本はもとあった場所に戻しておきなさい。
They have few books.	本はほとんどない。
I turn over a page of the book.	本のページをめくる。
Books and friends should be few but good.	本と友は数が少なく質が良くなければいけない。
I can run as fast.	僕も同じくらい速く走れる。
Me, too.	僕もだよ。
Let me join in the game.	僕もゲームに加えて下さい。
I mean what I'm saying.	僕は本気で言っているんだ。
I'll be watching you.	僕は片時も君から目を離さない。
I practiced my English on him.	僕は彼を相手にして英語を練習した。
I feel good in a special way.	僕は特別気持ちがいい。
I live above my means.	僕は収入を越えた生活をしている。
I'm young.	僕は若い。
I have no energy today.	僕は今日は元気がない。
I never meant to have you pay the bill.	僕は君に勘定を持ってもらうつもりは無かった。
I have bought the same camera as you have.	僕は君と同じカメラを買った。
I put the lighter out.	僕はライターの火を消した。
I had never seen so much money.	僕はその時まで、そんな大金を見たことがなかった。
I run as fast as Jim.	僕はジムと同じくらい走るのが速い。
I thought hard.	僕はじっと考えた。
I like this color as well.	僕はこの色もまた好きだ。
I would like to have this camera.	僕はこのカメラが欲しい。
I meet him at the club.	僕はクラブで彼にあいます。
I have three cameras.	僕はカメラを３台持っている。
I'm always looking at you.	僕はいつも君ばかり見ているんだよ。
I take sides with you.	僕はあなたの見方です。
Please put my room in order while I am out.	僕の留守中に部屋を掃除しておいて下さい。
Can you hear I'm calling?	僕の声は届いていますか。
My car is broken and it's in the shop now.	僕の車は故障しているんで、今修理工場に入っているんだ。
Would you please take my picture?	僕の写真を撮ってくれませんか。
My watch keeps good time.	僕の時計は正確だ。
Where is my watch?	僕の時計はどこだ？
I don't know where my watch is.	僕の時計どこにあるか知らない。
Do you know what I mean?	僕の言いたいことがわかる？
There is a Tanaka in my class, too.	僕のクラスにも田中という名前の人がいる。
Why don't you come to the movies with me?	僕に一緒に映画を見に行かないか。
I can't understand this business.	僕にはこいつが理解できない。
Who are you to talk to me like that?	僕にそんな口の利き方をするなんて、君は何様のつもりだい。
We are not always at home on Sundays.	僕たちは日曜日にいつも家にいるとは限りません。
I'll take care of the bill.	僕が払っとこう。
It's been three months since I met her.	僕が彼女に会ってから３ヶ月がたちました。
Were I in your position, I shouldn't know what to do.	僕が君の立場なら、どうしていいか分からないだろう。
I'll pay the bill.	僕がおごるよ。
There are a lot of places to see in Hokkaido.	北海道には見るべきところがたくさんあります。
I've never been to Hokkaido.	北海道には一遍も行ったことがない。
If you face north, the east is on your right.	北を向くと、東は右側になる。
You are not to break the law.	法律を犯してはいけない。
It is very important to keep the law.	法律を守る事はとても大切である。
You are not to break the law.	法を犯してはならない。
The bill will never go through.	法案はまず可決されないだろう。
I lead a fast way of living.	放蕩生活を送る。
How much is it including insurance and tax?	保険、税金を含めて、合計金額はいくらになりますか。
Both work and play are important.	勉強も遊びも大事だ。
Is the school work hard?	勉強は難しいの。
I don't feel like studying.	勉強する気がない。
It's a student's business to study.	勉強するのは学生の務め。
It is a student's business to study.	勉強することが学生の仕事です。
No answer is also an answer.	返事のないものも返事。
Can't think of an answer?	返事に困っている？
The least you could do is to answer me.	返事ぐらいしろよ。
Not having received a reply, he wrote to her again.	返事がなかったので、彼はもう一度彼女に手紙を書いた。
Since I didn't receive a reply, I wrote to her again.	返事がなかったので、私は彼女に再度手紙を書いた。
Not having got a reply, May wrote to Bill again.	返事がこなかったので、メイはビルに再び手紙を書いた。
Show me another example.	別の例を示しなさい。
Give me another example.	別の例をあげてください。
Let's think out another way.	別の方法を考え出そう。
Please show me another example.	別の実例を教えてください。
Show me another watch.	別の時計を見せてください。
Let me put it in another way.	別の言い方で言ってみよう。
Let me buy you another one.	別のを買わせて下さい。
Would you bring me another one, please?	別のをいただけますか。
Show me another camera.	別のカメラを見てください。
The meeting was closed.	閉会した。
I can't hear you.	聞こえませんよ。
I can't hear it.	聞こえないよ。
The more I hear, the more interesting it becomes.	聞けば聞くほどますます面白くなる。
Hear and see and be still.	聞け、見よ、しかし黙っていよ。
I need to hear it.	聞きたいの、私は。
Do you hear me?	聞いてるの？
I'm broke.	文無しなんだ。
Can I buy it on easy payment?	分割払いでよろしいですか。
I know what you mean.	分かる、分かる。
I think I understand.	分かるような気がする。
Do you follow?	分かりますか。
I understand.	分かってるよ。
Material standards of living were never higher.	物質的な生活水準が今日ほど高かったことはない。
The story got more and more interesting.	物語はますます面白くなった。
The action of the story takes place on an island.	物語の筋はある島を舞台に展開する。
Prices will continue to go up.	物価は上がり続けるだろう。
Prices will continue as they are.	物価は現状のまま続くだろう。
Prices are about to go up again.	物価がまた上がろうとしている。
Not a sound was heard.	物音一つ聞こえなかった。
Let's put all the cards on the table.	腹を割って話そう。
What movies just opened?	封切られたばかりの映画はなんですか。
The men followed him.	部下は彼のあとに続いた。
How much is the room charge?	部屋代はいくらですか？
Does the price of the room include the service charges?	部屋代にサービス料は含まれていますか。
Put your room in order.	部屋を片付けなさい。
Put your room in order.	部屋を整頓しなさい。
Please air the room.	部屋の空気を入れ替えてください。
When we entered the room, we took up our talk.	部屋に入ると私達は再び話を始めた。
Not a sound was heard in the room.	部屋には物音一つ聞こえなかった。
There were few children in the room.	部屋には子供たちはほとんどいなかった。
There were many children in the room.	部屋には子供たちがたくさんいた。
There were a few children in the room.	部屋には子ども達が少しいた。
Few children were in the room.	部屋にはほとんど子供がいなかった。
There were a lot of people in the room.	部屋にはたくさんの人々がいました。
There wasn't a single book in the room.	部屋には１冊の本もなかった。
Charge it to my room.	部屋につけておいてください。
He's in charge of the department.	部の責任者は彼です。
Let it be on your head!	不幸は私の責任だ。
Few people live to be more than a hundred.	百歳以上生きる人はほとんどいない。
Few people live to be 100 years old.	百歳まで生きる人はほとんどいません。
You may ask me any amount of money you need.	必要なだけのお金を私に請求してよい。
There is always a next time.	必ず又の機会が来る。
I'll do it by all means.	必ずやります。
I will come by all means.	必ずうかがいましょう。
By all means, you must come.	必ずあなたは来なくてはいけません。
Miwako, I want you to meet Kenny.	美和子さん、こちらケニーさんです。
Miyuki has a camera, but she doesn't like it.	美由紀はカメラを持っている、しかし彼女はそれが好きでない。
I don't like traveling by air.	飛行機で旅行するのは嫌い。
How much will it cost you to go by air?	飛行機で行くとどれくらいかかりますか。
Jobs are hard to come by with so many people out of work.	非常にたくさんの人が失業しているので仕事は得がたい。
It's not easy to figure out the cost.	費用がいくらかを算出するのは容易ではありません。
Have you figured out the cost?	費用がいくらかかるか算出してみましたか。
They moved to a new house.	彼等は新しい家へ引っ越した。
They are at war with the country.	彼等はその国と戦争中である。
They are what we call hot rodders.	彼等はいわゆる暴走族です。
They are always hard up for food.	彼等はいつも食べる物に困っている。
I couldn't bear to look at her.	彼女を見るに耐えられなかった。
She wants to move out and find a place of her own.	彼女を家を出て独立したがっている。
Let's put her in charge of that.	彼女をその任務に就けよう。
They are both good students.	彼女らは２人ともよい生徒です。
Is she coming, too?	彼女も来るのですか。
She continued her talk.	彼女は話し続けた。
She majored in history.	彼女は歴史を専攻した。
She has received a good education.	彼女は立派な教育を受けた。
She is too young to go to school.	彼女は幼くて学校には行けません。
She felt blue.	彼女は憂鬱だった。
Her face lit up.	彼女は明るい顔になった。
She turned on the light.	彼女は明かりをつけた。
She turned off the lights.	彼女は明かりを消した。
She has not come here yet.	彼女は未だここに来てない。
She has never been to Hokkaido.	彼女は未だかつて北海道へ行ったことがない。
She practiced typing every day.	彼女は毎日タイプの練習をした。
She acted like a real baby.	彼女は本当に赤ん坊のようにふるまいました。
She turned a page of her book.	彼女は本のページをめくった。
She is two years younger than me.	彼女は僕より２歳年下だ。
She did it against her will.	彼女は不本意ながらもそうした。
She did not answer all the questions.	彼女は必ずしもすべての質問に答えたわけではない。
She is hard on him.	彼女は彼らにつらくあたる。
She has as many books again as he.	彼女は彼の二倍も本を持っている。
She took what he said as meaning agreement.	彼女は彼の言葉を同意を意味していると受け取った。
She couldn't look him in the face.	彼女は彼の顔を見ることができなかった。
She looked him in the face.	彼女は彼の顔を見た。
She couldn't look him in the face.	彼女は彼の顔をまともに見ることができなかった。
She applied to him for help.	彼女は彼に助けを求めた。
She gave him a watch.	彼女は彼に時計をやった。
She talks to him as if he were a child.	彼女は彼に向かってまるで彼が子供であるかのように話す。
She knows better than to answer back to him.	彼女は彼に口答えするほど愚かではない。
She handed out a key to him.	彼女は彼に鍵を手渡した。
She is hard on them.	彼女は彼につらくあたる。
She had something to talk over with him.	彼女は彼と話があった。
She has broken with him.	彼女は彼と絶交した。
She was longing to hear from him.	彼女は彼からの便りを待ちこがれていた。
She tried to look much younger than she really was.	彼女は年よりうんと若くみせようとした。
She looks young for her age.	彼女は年のわりには若く見える。
She studies hard.	彼女は熱心に勉強する。
She is great with child.	彼女は妊娠している。
She used to go to the movies on Sundays.	彼女は日曜日には映画を見に行くのが常だった。
While in Japan, she bought the camera.	彼女は日本にいた時にそのカメラを買った。
She brought up two children.	彼女は二人の子を育てた。
She has just turned twelve.	彼女は12歳になったばかりである。
She kept on writing stories about animals.	彼女は動物の話を書き続けた。
She wrote a book about animals.	彼女は動物に関する本を書いた。
She's always on the go.	彼女は働きづめだ。
She may have known the answer.	彼女は答を知っていたのかもしれない。
She has moved house six times since she came here.	彼女は当地に来て以来６回引っ越しをした。
She saw many animals on the way.	彼女は途中で多くの動物を見た。
She has gone over to the other side.	彼女は転向した。
She is working night and day.	彼女は昼も夜も働いている。
She worked side by side with men.	彼女は男たちに伍して働いた。
She was born and brought up in Osaka.	彼女は大阪で生まれ大阪で育てられた。
She is a college student.	彼女は大学生です。
She has something different.	彼女は他の人と一味違う。
She works as hard as any other student.	彼女は他のどの学生にも劣らず勉強する。
She talks a very fast game.	彼女は早口でまくしたてて、人をまるめこみます。
She is used to getting up early.	彼女は早起きに慣れている。
She said she had met him on the previous day.	彼女は前の日に彼に会ったと言った。
Her hands are full taking care of the baby.	彼女は赤ん坊で手いっぱいだ。
She has been studying French for a few years.	彼女は数年間フランス語を勉強している。
She is very human.	彼女は人間性に富んでいる。
She may know the facts.	彼女は真実を知っているかもしれない。
She's writing something in her study.	彼女は書斎で何か書き物をしている。
She studied English as hard as she could.	彼女は出来るだけ一生懸命英語を勉強した。
She studied French as hard as possible.	彼女は出来るだけ一生懸命フランス語の勉強した。
She turned off all the lights at ten.	彼女は十時に明かりを全部消した。
She has ten children.	彼女は十人の子持ちなんだ。
She continued studying all her life.	彼女は終生研究を続けました。
She tried to make both ends meet.	彼女は収入内でやりくりしようとした。
She has something in her hand.	彼女は手に何か持っている。
She looks young.	彼女は若く見える。
She's not young, is she?	彼女は若くはありませんね。
She is now better off than when she was young.	彼女は若い頃より今は暮らし向きがよい。
She has a picture.	彼女は写真を持っている。
She does talk a lot.	彼女は実によくしゃべる。
She put up her hand to ask a question.	彼女は質問をするために手を上げた。
She can ask and answer questions.	彼女は質問をし、答えることができる。
She couldn't answer the question.	彼女は質問に答えることができなかった。
She has as many as seven children.	彼女は七人も子供がいる。
She put her room in order.	彼女は自分の部屋を片づけていた。
She brought up her child at the cost of her life.	彼女は自分の生活を犠牲にして子供を育てた。
She is looking for her car keys.	彼女は自分の車の鍵を捜している。
She thought that our watches were the same.	彼女は自分の時計を私の時計と同じものだと思った。
She looked her child in the face.	彼女は自分の子供の顔をじっと見た。
She lets her children have their own way too much.	彼女は自分の子どもに甘い。
She talked on and on about her family problems.	彼女は自分の家族問題についてどんどん話しつづけた。
She talked about her family.	彼女は自分の家族について話をした。
She gave up her plans against her will.	彼女は自分の意思に反して計画を断念した。
She has large interests in the car industry.	彼女は自動車産業の株をたくさん持っている。
She said she would be twenty years old the following year.	彼女は次の年で２０歳になるといった。
She is never on time.	彼女は時間どおりこない。
She came to know the fact.	彼女は事実を知るに至った。
She turned down our offer of help.	彼女は私達の援助の申し出を断った。
She told us the road was closed.	彼女は私達にその道路が閉鎖されていると教えてくれた。
She means more than my life to me.	彼女は私の命より大事である。
She turned down my offer.	彼女は私の申し出を断った。
She takes care of my children.	彼女は私の子供達の世話をしてくれる。
She takes care of my children.	彼女は私の子供の世話をしてくれる。
She takes care of my children.	彼女は私の子供たちの世話をしてくれる。
She gets up the earliest in my family.	彼女は私の家族の中で一番早く起きる。
She turned down my request.	彼女は私の依頼を断った。
She told me an interesting story.	彼女は私に面白い話をした。
She turned her back to me.	彼女は私に背中を向けた。
She asked me a question.	彼女は私に質問をした。
A watch was given to me by her.	彼女は私に時計をくれた。
She answered me back.	彼女は私に口答えした。
She was very short with me.	彼女は私にひどく不愛想だった。
She said to me "Let's go shopping."	彼女は私に「買い物に行こう」といった。
She is as young as I am.	彼女は私と同じくらい若い。
She takes care of my children.	彼女は私たちの世話をしてくれる。
She told us an interesting story.	彼女は私たちにおもしろい話をした。
She is only hard on me.	彼女は私だけにつらく当たる。
She saw me enter the store.	彼女は私が店に入るのを見た。
She runs faster than I do.	彼女は私より速く走る。
She loves her children.	彼女は子供達を愛している。
She worked hard on account of her children.	彼女は子供達のために一生懸命働いた。
She liked to take care of the children.	彼女は子供の世話をするのが好きでした。
She called her children into the room.	彼女は子供たちに部屋に入るように言った。
She made cookies for the children.	彼女は子供たちにクッキーを作ってあげた。
She told the children an interesting story.	彼女は子供たちにおもしろい話をした。
She sent her children off to school.	彼女は子供たちが学校へ行くのを見送った。
She watched the children going back to school.	彼女は子供たちが学校へもどっていくのをみました。
She did not turn up.	彼女は姿を現さなかった。
She's hard at it.	彼女は仕事に精を出している。
It took her more than three months to read through the magazine.	彼女は雑誌を読み終えるのに３か月以上かかった。
She was born last year.	彼女は昨年生まれた。
She entered this school last year.	彼女は昨年この学校に入学した。
She is a gifted artist.	彼女は才能豊かな画家さ。
She ended up a movie star.	彼女は最後に映画のスターになった。
She was never to see her home again.	彼女は再び故郷には帰らぬ運命にあった。
She is going to have a baby this month.	彼女は今月赤ちゃんが生まれる予定です。
What do you figure she is doing now?	彼女は今何をしていると思いますか。
She has never fallen in love.	彼女は今までに一度も恋をした事が無い。
She had never seen New York before.	彼女は今までニューヨークを見物したことがなかった。
She has always been at the head of her class.	彼女は今までずっとクラスの首席です。
She is better off than she was when I met her last.	彼女は今では、私がこの前会ったときより暮らし向きがよい。
She's hard at it now.	彼女は今せっせとやっています。
She won't come just yet.	彼女は今すぐには来ないだろう。
She has changed a lot since high school.	彼女は高校時以来ずっと変わった。
She turned against her old friend.	彼女は古い友人を嫌った。
She is in conference now.	彼女は現在会議中である。
She is not as young as she looks.	彼女は見掛けほど実際に若くない。
She is not as young as she looks.	彼女は見かけほど若くない。
She is not as young as she looks.	彼女は見かけほど若くはない。
She is really in good health.	彼女は健康その物だ。
She could not help thinking that health is important.	彼女は健康が大切だと思わざるをえませんでした。
She directed the planning of the project.	彼女は計画の立案を指示した。
She directed the planning of the project.	彼女は計画の立案を指揮した。
She works as hard as her siblings.	彼女は兄弟たちと同じくらい一生懸命に働く。
Did she show you the picture?	彼女は君にその写真を見せましたか。
She continued her job in the bank.	彼女は銀行に勤め続けた。
She continued her job in the bank.	彼女は銀行での仕事を続けた。
She forced me to go out with her.	彼女は強制的に私を連れ出した。
She forced me to go out with her.	彼女は強制的に私を一緒に連れ出した。
She came over to France for a holiday.	彼女は休暇過ごしにフランスにやって来た。
She boards students.	彼女は学生を下宿させている。
She is a student.	彼女は学生だ。
She talked about her school life.	彼女は学校生活について語った。
She is not as young as she looks.	彼女は外見ほど若くはない。
She looked at the picture.	彼女は絵を見ました。
She kept from talking during the meeting.	彼女は会議中話さないようにした。
She has put her house up for sale.	彼女は家を売りに出した。
How she talks!	彼女は何ておしゃべりなんだろう。
She was born and brought up on the backstreets.	彼女は下町で生まれ育った。
She is interested in music.	彼女は音楽に興味がある。
She understands music.	彼女は音楽がわかる。
She gets good marks in English.	彼女は英語の点数がよい。
She got good marks in English.	彼女は英語でよい点を取った。
She got 80 marks for English.	彼女は英語で８０点をとった。
She read the book all night.	彼女は一晩中本を読んだ。
She has never fallen in love.	彼女は一度も恋をした事がない。
She has never been asked for a date.	彼女は一度もデートに誘われたことがないのよ。
She must have studied very hard.	彼女は一生懸命勉強していたに違いない。
She is hard at work.	彼女は一生懸命働いている。
She worked hard.	彼女は一生懸命働いた。
She ran as fast as she could.	彼女は一生懸命に走った。
She continued studying all her life.	彼女は一生涯勉強を続けた。
She brought up nine children in her life.	彼女は一生のうちに９人の子供を育てました。
She is well brought up.	彼女は育ちがよい。
She was a medical student.	彼女は医学生でした。
She became a great artist.	彼女は偉大な画家になった。
She has never seen it before.	彼女は以前にそれを見たことがありません。
She had an easy delivery.	彼女は安産だった。
She turned off the radio.	彼女はラジオを消した。
She had a radio.	彼女はラジオを持っていた。
She turned down the radio.	彼女はラジオの音を小さくした。
She works hard.	彼女はよく働く。
She talks a lot.	彼女はよくしゃべる。
She made a tour around Europe.	彼女はヨーロッパを旅行した。
She's practicing English so she can get a better job.	彼女はもっと良い仕事につけるように英語を練習しています。
She's practicing English so she can get a better job.	彼女はもっとよい仕事に就けるように英語の練習をしています。
She felt like going to Tohoku again.	彼女はもう一度東北に行きたい気がしました。
Is she here yet?	彼女はもうここにきていますか。
She put off going to Mexico.	彼女はメキシコ行きを延期した。
She talks about Paris as if she had been there many times.	彼女はまるで何度も行ったことがあるかのようにパリの話をする。
She hasn't come yet.	彼女はまだ来ていない。
She's but a child.	彼女はまだ子供にすぎない。
She hasn't turned up yet.	彼女はまだ現れない。
She is not up yet.	彼女はまだ起きていません。
She's not yet heard the news.	彼女はまだそのニュースを聞いてはいない。
She is not here yet.	彼女はまだここへ来ていません。
She hasn't come here yet.	彼女はまだここに来ない。
She has not come here yet.	彼女はまだここに来ていない。
She has come to know something like love.	彼女はほのかな恋心を知るようになる。
She talked about Paris as if she had been there many times.	彼女はパリについて何回も行ったことがあるように話した。
How fast she is running!	彼女はなんて速く走っているのでしょう。
How young she is!	彼女はなんて若いのでしょう。
What color do you think she likes?	彼女はどんな色が好きだと思いますか。
Do you know what color she likes?	彼女はどんな色がすきか知っていますか。
She put two calls in for Tom.	彼女はトムに二度電話を入れた。
She is a student who studies very hard.	彼女はとても熱心に勉強する学生です。
She must have worked very hard.	彼女はとても熱心に働いたにちがいない。
She's a very interesting person.	彼女はとても興味深い人です。
She works very hard.	彼女はとても一生懸命勉強する。
She looks very young.	彼女はとてもわかく見えます。
She asked a very good question.	彼女はとてもよい質問をした。
She has a very good figure.	彼女はとてもスタイルがいい。
She lives just down the street.	彼女はとおりをちょっといった所にすんでいる。
They say that she was born in Germany.	彼女はドイツ生まれのようだ。
They say that she was born in Germany.	彼女はドイツで生まれたそうだ。
She ran as fast as possible.	彼女はできる限り速く走った。
She ran as fast as possible.	彼女はできるだけ速く走った。
She studied French as hard as possible.	彼女はできるだけ一生懸命フランス語を勉強した。
She tried to run as fast as she could.	彼女はできるかぎり速く走ろうとした。
Did she have a hard time?	彼女はつらい目にあったか。
She is no more than a child.	彼女はただの子供にすぎない。
She has a lot of history books.	彼女はたくさんの歴史の本を持っています。
She has a lot of English books.	彼女はたくさんの英語の本を持っています。
She has a lot of money.	彼女はたくさんお金を持っている。
She couldn't see it, but she could feel and hear it.	彼女はそれを見ることはできませんが、それを感じはしました。
She had never seen New York before, so I offered to show her around.	彼女はそれまでニューヨークを見学したことがなかったので、彼女に案内して回りましょうと申し出た。
She talks as if she knew all about it.	彼女はそれについて全てを知っているかのように話す。
Having heard the story before, she didn't want to hear it again.	彼女はその話を以前に聞いたことがあったので、それをまた聞きたくなかった。
She met him the day before, that is to say May fifth.	彼女はその日の前日、つまり５月５日に彼に会った。
She broke down when she heard the news.	彼女はその知らせを聞いて泣き崩れた。
She replied that she had never seen the man before.	彼女はその男の人に以前会ったことがないと答えた。
She replied she had never met the man before.	彼女はその男に会ったことがないと返事をした。
She took the case into court.	彼女はその事件を裁判ざたにした。
She cared for the children.	彼女はその子供たちの世話をした。
She took care of the child.	彼女はその子の世話をした。
She worked hard to get the work done.	彼女はその仕事を終わらせようと良く働いた。
She was pleased to see the results.	彼女はその結果をみて喜んだ。
She felt like giving up the plan.	彼女はその計画をあきらめたい気がした。
She put the money in the bank.	彼女はその金を銀行に預けた。
She needn't have come to the meeting.	彼女はその会合に来る必要はなかったのに。
She has changed a lot since then.	彼女はそのときからずいぶん変わった。
She took the case into court.	彼女はそのことを裁判ざたにした。
She has something to do with the group.	彼女はそのグループと何か関係がある。
She has always lived in Otaru.	彼女はずっと小樽で暮らしている。
She has no figure.	彼女はスタイルが悪い。
She has a good figure.	彼女はスタイルがいい。
She asked Shinji to take Rei's ID-card to her the next day.	彼女はシンジに、明日レイにＩＤカードを届けるよう頼んだ。
She kept on talking.	彼女はしゃべりつづけた。
She said that she has never been there.	彼女はこれまでそこに行った事はないと言った。
She is a member of this organization.	彼女はこの団体の会員である。
She played an important part in this project.	彼女はこの企画で重要な役割を演じた。
She has a large office in this building.	彼女はこのビルに大きなオフィスを構えている。
She couldn't think what to give the children for Christmas.	彼女はクリスマスに子供たちに何を与えたらいいか思い付かなかった。
She was looked up to by all the club members.	彼女はクラブの会員全員から尊敬されていた。
She runs fastest in our class.	彼女はクラスの中で一番足が速い。
She studies as hard as any student in her class.	彼女はクラスのどの生徒にも劣らず一生懸命勉強する。
She has seen a lot of life.	彼女はかなり人生経験をつんでいる。
She was at one time faced with the problem.	彼女はかってその問題に直面した。
She answered that she would visit me.	彼女はお伺いしますと返事した。
She worked hard in order to save money.	彼女はお金をためるために一生懸命働いた。
She is hard up for money.	彼女はお金にとても困っている。
She likes talking best of all.	彼女はおしゃべりが一番好きです。
She fell on her face.	彼女はうつぶせに倒れた。
She was similar to me in many ways.	彼女はいろいろの点で私に似ていた。
She always keeps her word.	彼女はいつも約束を守る。
She's always short with me.	彼女はいつも僕にそっけない。
She always keeps her room in good order.	彼女はいつも部屋をきれいに整頓している。
She is always hard at work.	彼女はいつも熱心に勉強しています。
She always keeps the garden.	彼女はいつも庭の手入れをしている。
She always gets her own way.	彼女はいつも自分勝手にふるまう。
She always lets her children do what they want to.	彼女はいつも自分の子供たちのしたい様にさせている。
She thinks that she's always right.	彼女はいつも自分が正しいと思っている。
She always cared about my health.	彼女はいつも私の健康を気にかけていた。
She always takes care of her children.	彼女はいつも子供の世話をします。
She always lets her children do what they want to.	彼女はいつも子供たちにやりたいことをやらせる。
I don't like her, because she always puts on airs.	彼女はいつも気どっているので、ぼくはきらいだ。
She always tries something new.	彼女はいつも何か新しいことにアタックしている。
She always works hard.	彼女はいつもよく働く。
Does she always go there?	彼女はいつもそこに行きますか。
It is always the case with her.	彼女はいつもそうなんだ。
She was talking all the time.	彼女はいつもしゃべってばかりいた。
She is always well made up.	彼女はいつもうまく化粧している。
She always gets up at six.	彼女はいつも６時に起きる。
She always keeps her word.	彼女はいつでも約束を守る。
She always has to be the one giving orders.	彼女はいつだって自分が命令する立場にいないと気がすまないのです。
She must come at all events.	彼女はいずれにしても来なければならない。
She has not a few friends in America.	彼女はアメリカにかなり多くの友人がいる。
She is more human in thinking than you.	彼女はあなたよりも考え方が人間的だ。
She talked childishly.	彼女はあどけない物の言い方をした。
She was born at six a.m. on July 17.	彼女は７月１７日の午前６時に生まれた。
She has brought up five children.	彼女は５人の子供を育てた。
She said that she had met him three months before.	彼女は３か月前に彼に会ったと言った。
She is a second year student.	彼女は２年生です。
She was never to see her children again.	彼女は２度と子供たちにあえない運命にあった。
She entered her twenties.	彼女は２０代に入った。
She was born at six a.m. on July 17, 1990.	彼女は１９９０年７月１７日の午前６時に生まれた。
She was born in the 1950s.	彼女は１９５０年代の生まれです。
She was born in 1946, on August 19, in California.	彼女は１９４６年８月１９日にカルフォルニアで生まれた。
She has no less than ten children.	彼女は１０人もの子供を育てている。
She has ten children.	彼女は１０人の子持ちなのだ。
She is good at making up interesting stories.	彼女は、面白い話を作るのが得意である。
I can't figure out what she really wants.	彼女が本当は何が欲しいのか、私にはわからない。
She is human.	彼女は、人間です。
She takes care of my children.	彼女は、私の子どもの世話をしてくれる。
Her story was not interesting.	彼女の話は面白くなかった。
Her library has 3,500 books and includes many first editions.	彼女の蔵書は全部で３５００冊で多くの初版が入ってる。
She's going to have a baby in July.	彼女の出産予定は７月だ。
Don't let him know her address.	彼女の住所を彼に知らせてはいけない。
Her hands are never still.	彼女の手はじっとしていない。
Her hands are never still.	彼女の手はうごきっぱなしだ。
I took a picture of her.	彼女の写真をとった。
Her car broke down on the way.	彼女の自動車は途中で動かなくなった。
I know of her, but I have never met her.	彼女の事は聞いていますが、会った事はありません。
Her job is to take care of babies.	彼女の仕事は赤ん坊の世話をすることです。
Her means are small.	彼女の財産は少ない。
She talks too aloofly.	彼女の口振りはいかにもそらぞらしい。
Her words were as follows.	彼女の言葉は次の通りだった。
Her words were as follows.	彼女の言葉は次のとおりであった。
How do you feel about what she said?	彼女の言うことをどう思いますか。
I can't understand what she says.	彼女の言うことはわからない。
The students around her were talking about the test.	彼女の近くの学生たちはテストについて話していた。
Her face turned red.	彼女の顔は真っ赤になった。
We had a welcome party for her.	彼女の歓迎会を行った。
Her house is a little way off the road.	彼女の家は道路から少し離れている。
Her acting is on the level of a professional.	彼女の演技はプロ並みです。
If it had not been for her help, you would never have done it.	彼女の援助がなかったら、君は決してそれを果たせなかっただろう。
Her youngest child is five years old.	彼女の一番下の子供は５歳です。
Her family moved to Brazil.	彼女の一家はブラジルへ移住して行った。
I know of her, but I have never met her.	彼女のことは聞いてはいますが、会ったことはありません。
There are about forty students in her class.	彼女のクラスには約４０人の生徒がいる。
Her CDs are not bought by young people.	彼女のＣＤは若者には買われていません。
One of her three cars is blue and the others are white.	彼女の３台の車は１台が青で残りは白だ。
One of her three cars is blue and the others are red.	彼女の３台の車の１台は青で、残りは赤だ。
Let's not talk to her.	彼女に話し掛けるのはよそう。
I fell in love with her.	彼女に恋している。
We shall never see her match.	彼女に匹敵する人はもう現れないだろう。
Have you called her yet?	彼女に電話しましたか。
There is no use talking to her.	彼女に説教しても無駄である。
She is going to have a baby.	彼女に赤ちゃんが生まれる。
I didn't know that she had a child.	彼女に子供がいるとは知らなかった。
I saw her again.	彼女に再び会った。
I have met her before.	彼女に会った事がある。
I had never seen her.	彼女に会ったことがなかった。
She has no one to turn to.	彼女には頼れる人がいない。
She had no one to turn to.	彼女には頼れるものが誰もいなかった。
She has a few friends.	彼女には友だちが少しはいる。
She has few friends.	彼女には友だちがほとんどいない。
She has very few close friends.	彼女には親友がほとんどいない。
She has no less than twelve children.	彼女には子供が十二人もいる。
She has no children, does she?	彼女には子供がいないのですね。
She has an important air about her.	彼女には威張った様子がある。
I've met her before, but I can't place her.	彼女には以前会ったことがあるが、誰だか思い出せない。
She has a lot of work to do.	彼女にはやる仕事がたくさんある。
I can't really read her.	彼女にはついていけないよ。
I don't want to be the one who breaks the news to her.	彼女にその知らせを伝える役だけはごめんだ。
When did you meet her?	彼女にいつ会ったのですか。
Shall I send a few books for her?	彼女に２、３の本を送りましょうか。
You should watch your language when you talk to her.	彼女と話をするとき言葉づかいに気をつけたほうがいいですよ。
I met up with her on the street.	彼女と町で偶然あった。
Will you meet her?	彼女と会うつもりですか。
I don't feel at home in her company.	彼女と一緒にいるとくつろげない。
I haven't met her.	彼女とは会っていない。
There is much talk that she is going to France next month.	彼女が来月フランスへ行くと言ううわさでもちきりだ。
I heard her come here.	彼女が来るのが聞こえた。
When she turned up, the party was over.	彼女が来たときパーティーは終わった。
I saw her enter the room.	彼女が部屋にはいるのを見た。
The lot fell to her to help him.	彼女が彼を助ける巡り合わせになった。
She drove a car down a country road.	彼女が田舎道を車で走って行った。
She's going to be in charge.	彼女が責任者になる人だ。
She is no match for me.	彼女は弱すぎる。
We must take into account the fact that she is old.	彼女が歳取っていることを考慮に入れなければならない。
Since she's been gone, I want no one to talk to me.	彼女が行ってしまってからは、私はもう誰とも話などしたくない。
The war broke out when she was in Hiroshima.	彼女が広島にいるときに戦争が起こった。
She gave an address of welcome.	彼女が歓迎のあいさつを述べた。
She works so hard that she can get good results.	彼女がんばっているから、いい結果が出せるよ。
Have you heard from her?	彼女から便りはありましたか。
I have not heard from her for a month.	彼女から一ヶ月も便りがありません。
Her answer couldn't be understood.	彼女からの返事は納得できないものだった。
It was a camera that she bought there.	彼女がそこで買ったのは、カメラだった。
I saw her coming up the road.	彼女がこちらへやって来るのを見た。
I heard that she came here.	彼女がきたと、きいた。
I really don't understand what's up with her.	彼女がいったいどうなってしまったのか、私にはわからない。
It's hard to please him.	彼を満足させるのは難しい。
When I called on him, he was hard at work.	彼を訪ねたとき、彼は忙しく働いていた。
Bring him in.	彼を中に入れなさい。
It took a long time to bring him around to our point of view.	彼を説得して私達の見解に引き入れるには、相当な時間がかかった。
Keep watch on him.	彼を見張れ。
He is hard to please.	彼を喜ばせるのは難しい。
He shall not come into this house again.	彼をこの家へ２度と入れさせないつもりだ。
They all tried to talk at one time.	彼らは一度に話そうとした。
Let them come in.	彼らを入らせなさい。
They parted, never to see each other again.	彼らは別れて二度と再び会う事はなかった。
They have to figure out the cost.	彼らは費用を計算してみなければならない。
They ask her many questions.	彼らは彼女にたくさんの質問をする。
They let him tell the story.	彼らは彼に話をさせた。
They supplied money to him.	彼らは彼にお金を与えた。
They saw him enter the room.	彼らは彼が部屋に入るのを見た。
They were never to meet again.	彼らは二度と会えない運命にあった。
They would never meet again.	彼らは二度と会うことはなかった。
They made the road more even.	彼らは道路をもっと平らにした。
They live on the other side of the road.	彼らは道の反対側に住んでいる。
They became all the better friends because they entered the same college.	彼らは同じ大学に入ったので一層なかよくなった。
They entered into a discussion.	彼らは討論を始めた。
They are out in the garden.	彼らは庭に出ています。
They worked hard day and night.	彼らは昼夜一生懸命働いた。
They made up and became friends again.	彼らは仲直りしてまた友達になった。
They were for the most part young people.	彼らは大部分が若者だった。
They were for the most part young people.	彼らは大部分が若者であった。
They study in order that they may enter the university.	彼らは大学へ入る目的で勉強している。
They are not at all interested.	彼らは全然興味を持っていない。
They named their baby Jane.	彼らは赤ん坊をジェーンと名づけた。
What do they call their baby?	彼らは赤ちゃんを何と呼ぶのですか。
They are in the hands of the gods.	彼らは神の手の中にいるのである。
They moved to a new house.	彼らは新しい家に引っ越した。
They are short of food.	彼らは食料が不足しています。
They are not little children.	彼らは小さな子供ではありません。
It is important for them to do their best.	彼らは自分の最善を尽くすことが大切だ。
They owned the lot between them.	彼らは自分たちで土地を所有した。
They have something in common.	彼らは似たところがある。
They are short of funds.	彼らは資金が不足している。
They forced me to sign my name.	彼らは私に無理やり署名させた。
They made us work all night.	彼らは私たちを一晩中働かせた。
They had started earlier than us.	彼らは私たちより先に出発していた。
They had started earlier than we had.	彼らは私たちよりも先に出発していた。
They supplied us with food.	彼らは私たちに食料を供給してくれた。
They won't allow us to enter the garden.	彼らは私たちが庭に入るのを許そうとしないのだ。
They named their child Thomas.	彼らは子どもをトーマスと名付けた。
They set out last night.	彼らは昨夜出発した。
They were called out three times last night.	彼らは昨夜３度呼び出された。
They are high school students.	彼らは高校生です。
They formed a project to build a new school building.	彼らは校舎新築の計画を立てた。
They drove the car by turns.	彼らは交代で運転した。
They are talking with each other.	彼らは互いに話し合っている。
They set the time and place of the wedding.	彼らは結婚式の日取りと場所を決めた。
They completed the picture hand in hand.	彼らは協力してその絵を仕上げた。
They wanted to take pictures of Kyoto.	彼らは京都の写真を撮りたがっていました。
They all tried to talk at one time.	彼らは皆同時に話そうとした。
They call us problem children.	彼らは我々を問題児と呼ぶ。
They broke down the house.	彼らは家を取り壊した。
They are saving their money for the purchase of a house.	彼らは家を購入するため貯金をしている。
They are building a house.	彼らは家を建てている。
They set about building a house.	彼らは家の建築にとりかかった。
They are talking about music.	彼らは音楽の話をしている。
They were for the most part young people.	彼らは一般的に言って若者です。
They talked about love.	彼らは愛情についてはなした。
They aren't children any more, but not adults yet.	彼らはもう子供ではないがまだ大人ではない。
They did not feel like playing any more.	彼らはもうそれ以上遊ぶ気がしなかった。
They are all college students.	彼らはみんな大学生です。
They all longed for the holiday.	彼らはみんな休暇を待ち焦がれていた。
They all longed for the holidays.	彼らはみんなにその休暇を待ちこがれた。
They all longed for the holidays.	彼らはみんなその休憩を待ち焦がれた。
They all longed for the holidays.	彼らはみんなその休暇を待ちわびた。
They questioned him.	彼らはまた尋ねて言った。
They haven't come back home yet.	彼らはまだ家に戻ってきていません。
I haven't heard a word from him as yet.	彼らはまだなんとも言ってきてない。
They have not yet heard of it.	彼らはまだそのことを聞いていない。
They're at it again.	彼らはまたけんかをしている。
They each received a present.	彼らはひとりひとりプレゼントをもらった。
How hard they work!	彼らはなんて熱心に働くのだろう。
They are having a really good time.	彼らはとても楽しい時を過ごしている。
They moved in just the other day.	彼らはつい先日引っ越してきた。
They didn't feel like playing any more.	彼らはそれ以上遊ぶ気がしなかった。
They entered into a discussion about the issue.	彼らはその問題に関する討議を始めた。
They named the baby Momotarou.	彼らはその赤ん坊を桃太郎と名付けました。
They submitted the case to the court.	彼らはその事件を法廷に持ち出した。
They broke down the old house.	彼らはその古い家を取り壊した。
They all longed for the holiday.	彼らはその休暇を待ちこがれた。
They kept talking all the time.	彼らはその間ずっとしゃべり通しだった。
They were school children then.	彼らはそのころ小学生でした。
They talked about what they should do with the money.	彼らはそのお金をどう処理すべきかについて話し合った。
They should not talk here.	彼らはここで話をすべきではないのだ。
They welcomed as many men as came.	彼らはきた人をみな喜んで迎えた。
They talked to each other.	彼らはお互いに話し合った。
They will fall in love with each other.	彼らはお互いに恋をするようになるでしょう。
They are not interested in saving money.	彼らはお金を貯めることに関心がありません。
Now they have three children.	彼らはいま三人の子供がいる。
They are always short of money.	彼らはいつも金に不自由している。
It is always the case with them.	彼らはいつもそうだ。
They are talking about this and that.	彼らはあれこれと話をしています。
They move from place to place.	彼らはあちこちへと移動してきます。
They were to meet here at seven.	彼らは７時にここで会う予定になっていた。
They were never to return to their country.	彼らは２度と祖国へ戻ることはなかった。
They were never to see each other again.	彼らは２度と互いに会えない運命であった。
They are both school children.	彼らは２人とも学童である。
They are both good students.	彼らは２人ともよい生徒です。
They have twelve children.	彼らは１２人の子持ちです。
They had a talk about the future life.	彼らは、来世について話しあった。
They are human.	彼らは、人間です。
They are artists.	彼らは、画家だ。
They all longed for the holidays.	彼らは、みんなその休暇を待ち焦がれた。
Both of them were not present at the meeting.	彼らの両方がその会合に出席したわけではなかった。
They were, for the most part, college students.	彼らの大部分は大学生だった。
They were for the most part high school students.	彼らの大部分が高校生だった。
They were for the most part young people.	彼らの大多数は若者です。
Not all of them are present at the meeting today.	彼らの全員が今日の会合に出席しているわけでもない。
Their plan sounds interesting to me.	彼らの計画は面白そうだ。
Their living room is as large again as my house.	彼らの居間は我が家の２倍の広さがある。
They had a baby last week.	彼らに先週子供が生まれた。
A baby was born to them.	彼らに赤ちゃんが生まれた。
A child was born to them.	彼らに子供が産まれた。
I told them again to turn down the radio.	彼らにラジオの音を小さくするように何度も言った。
They had a lot of children to provide for.	彼らには養っていかねばならない子供がたくさんいた。
They have not less than ten children.	彼らには少なくとも１０人の子供がいる。
They had only one child.	彼らには子供が一人しかいなかった。
They have something in common with each other.	彼らには何か共通したところがある。
They have a lot in common.	彼らには、共通点が多い。
It's important for them to go out.	彼らにとって、外に出かけるのは大切なことです。
My association with them didn't last long.	彼らとのつきあいは長く続かなかった。
You must take action for their early release.	彼らが早く釈放されるように手を打っていただきたい。
The research done by them shows that Americans are not interested in Japan.	彼らが行った調査によると、アメリカ人は日本に興味を持っていないことがわかる。
Here is a new video for them to watch.	彼らが見る新しいビデオがここにあるよ。
It's Spain that they are going to on holiday.	彼らが休暇に行こうとしているのはスペインだ。
It is important that he find out what they are doing.	彼らが何をやっているのかを彼が見つけだすことが大切だ。
Both he and I are high school students.	彼も私も高校生です。
He kept talking.	彼は話しつづけた。
He is easy to talk to.	彼は話しかけやすい人だ。
He has a lot of books on history.	彼は歴史の本をたくさん持っている。
He works very hard.	彼は良く働きます。
He received a good education.	彼は立派な教育を受けた。
He is a man of mean understanding.	彼は理解の良くない人です。
Will he come to the meeting next week?	彼は来週会議にくるでしょうか。
He said that he was going home the following day.	彼は翌日に家に帰ると言った。
He is a man of few wants.	彼は欲の少ない人だ。
He has four children to provide for.	彼は養っていかなければならない四人の子供がいる。
He did not show up at the party last night.	彼は夕べのパーティーに出席しなかった。
He didn't show up at the party last night.	彼は夕べのパーティーには現れなかった。
He found it hard to make friends.	彼は友達を作るのが難しいとわかった。
He had few friends and little money.	彼は友達も金もほとんどなかった。
He has few friends.	彼は友達がほとんどいない。
He has a few friends.	彼には数人の友人がいます。
He is a student at Yushu High School.	彼は優秀高校の生徒である。
He called on me at night.	彼は夜私を訪ねてきた。
He called on me at night.	彼は夜私を訪ねた。
He was used to going out at night.	彼は夜の外出になれていた。
He used to read at night.	彼は夜いつも読書をしたものだ。
He parted from me saying that he would see me the next day, but I have not heard from him since.	彼は明日会おうと言って別れたが、それから何の音沙汰もない。
He made me sign the paper against my will.	彼は無理やり私にその書類に署名させたのです。
He made me go against my will.	彼は無理に私を行かせたのです。
He was forced to buy stocks.	彼は無理に株を買わされた。
He got full marks.	彼は満点を取った。
He is the baby of the family.	彼は末っ子だ。
He calls her up every night.	彼は毎晩彼女に電話する。
He practiced every day at home.	彼は毎日家で練習した。
He watches TV every day.	彼は毎日テレビを見ます。
I hear he is good at mahjong.	彼は麻雀が上手だそうです。
He isn't really sad; he's only acting.	彼は本当に悲しいのではない、そのふりをしているだけだ。
He will be really pleased.	彼は本当に喜ぶでしょう。
He is a really good worker.	彼は本当によく働く人だ。
He does know the fact.	彼は本当にそのことを知っている。
Do you think he will really give up?	彼は本当にあきらめると思うか。
He doesn't mean it; he's just acting.	彼は本気でそう言ってるのでない、芝居をしているだけだ。
He showed what he meant.	彼は本音を出した。
He came to see me any time he felt like it.	彼は僕を訪ねたいと思うときはいつでも訪ねてきた。
He has fewer friends than I.	彼は僕より友達の数が少ない。
He showed me her picture.	彼は僕に彼女の写真を見せてくれた。
He broke the law.	彼は法を犯した。
He is a man of understanding.	彼は物わかりのよい人だ。
He put the room in order.	彼は部屋を整頓した。
He was seen to enter the room.	彼は部屋に入るのを見られた。
He was seen to enter the room.	彼は部屋に入るところを、見られた。
He entered the room.	彼は部屋に入った。
He is a common sort of man.	彼は品がない。
He likes air travel.	彼は飛行機旅行が好きだ。
He doesn't like traveling by air.	彼は飛行機で旅行するのが好きではない。
He is a very important person.	彼は非常に重要な人物だ。
He brought her to our place.	彼は彼女を連れてうちをたずねてきた。
He loves her. She loves him, too.	彼は彼女を愛している。彼女も彼を愛している。
He said so to her face.	彼は彼女の面前でそう言った。
He didn't try to answer her back.	彼は彼女に言い返そうとはしなかった。
He asked her some questions.	彼は彼女にいくつか質問をしました。
He said that he had met her a week before.	彼は彼女に１週間前に会ったといった。
He fell in love with her.	彼は彼女と恋におちた。
He had a good time talking with her.	彼は彼女とおしゃべりをして楽しいひとときを過ごした。
He got no answer from her.	彼は彼女から返事を得られなかった。
He is the only child they have.	彼は彼らのひとり息子です。
He supplied food and money to them.	彼は彼らに食べ物と金を支給した。
He was too old to work any more.	彼は年を取りすぎていて、もう働けなかった。
He is too old.	彼は年をとり過ぎている。
He is too old to try it.	彼は年をとっているのでそれをしてみることができない。
He is old, but at all events he works well.	彼は年をとっているが、とにかくよく働く。
He has to study hard.	彼は熱心に勉強しなければなりません。
He used to come here for a talk on Sundays.	彼は日曜日にはよく話しに来たものだった。
He's not always at home on Sundays.	彼は日曜日にはいつも家にいるわけではない。
He's always at home on Sundays.	彼は日曜日にはいつも家にいる。
He always wanted to study Japanese.	彼は日本語を勉強したいとずっと思っていた。
He's very much interested in the Japanese language.	彼は日本語に非常に興味を持っていますよ。
He is very much interested in Japanese history.	彼は日本の歴史に非常に興味を持っている。
He is one of the greatest artists in Japan.	彼は日本の最高の芸術家の１人です。
He doesn't know a lot about Japan.	彼は日本についてはよく知りません。
He was never to see her again.	彼は二度と彼女に会えない運命になっていた。
He never turned back again.	彼は二度と再び戻らなかった。
He never turned back again.	彼は二度ともどらなかった。
He never said it again.	彼は二度とそれを言わなかった。
He was never to come here.	彼は二度とここには戻ってこない運命だった。
He was put in a cell.	彼は独房に入れられた。
He kept on writing stories about animals.	彼は動物の話を書き続けた。
He knows a lot about animals.	彼は動物についてたくさんの事を知っています。
He loves animals.	彼は動物が好きだ。
He couldn't move and had to call for help.	彼は動くことができず、助けを大声で求めねばなりませんでした。
He answered, No.	彼は答えた。「ちがいます」
He applied for a job with the Bank of Tokyo.	彼は東京銀行へ就職の願書を出した。
He moved to Tokyo.	彼は東京に引っ越した。
He is one of the up and coming young men of the party.	彼は党の活動的な若手のひとりである。
He said he would give me a call, but he hasn't yet.	彼は電話をくれるといったのに、まだしてこない。
He has an estate in the country.	彼は田舎に地所を持っている。
He is leading an easy life in the country.	彼は田舎で安楽な生活を送っている。
He moved from place to place.	彼は各地を転々と移動した。
He likes taking care of the garden.	彼は庭の世話をするのが好きです。
He likes to work in the garden.	彼は庭で仕事をすることが大好きだ。
He likes to work in the garden.	彼は庭で仕事をすることが好きだ。
He has taken to gardening.	彼は庭いじりをするようになった。
He was born in Nagasaki.	彼は長崎で生まれました。
He had to work hard day and night.	彼は昼も夜も一生懸命働かなけばならなかった。
He wrote a lot of books on China.	彼は中国に関する本をたくさん書いた。
He gave a short talk.	彼は短い演説をした。
Who is he talking to?	彼は誰と話しているの？
He was a general in the Second World War.	彼は第二次世界大戦では陸軍大将だった。
He ran too fast for me to keep up with him.	彼は大変速く走ったので私は付いて行く事が出来なかった。
He is a most important person.	彼は大変重要な人物です。
He has a store on the main road.	彼は大通りに店を構えている。
He was born in Osaka.	彼は大阪で生まれた。
He got a lot of money.	彼は大金を手にした。
He put a large amount of money into the industry.	彼は大金をある産業に投じた。
He studied hard in order to get into college.	彼は大学に入れるように一生懸命勉強した。
He worked hard to support a large family.	彼は大家族を養うために懸命に働いた。
He'll never amount to much.	彼は大した人物にはなれないわね。
He's well built.	彼は体格が良い。
He understands her problems more or less.	彼は多少彼女の問題を理解している。
He asked the same question of many people.	彼は多くの人に同じ質問をした。
He works as hard as any other student.	彼は他のどの学生にも劣らず熱心に勉強する。
He can run fast.	彼は速く走れる。
He can run so fast!	彼は走るのがとても早い。
He is used to getting up early.	彼は早起きに慣れている。
He is used to getting up early.	彼は早起きには馴れている。
He tried to get up early.	彼は早起きしようとした。
He did not get up early.	彼は早く起きなかった。
He does not get up early.	彼は早く起きない。
He said it was out of the question.	彼は全く不可能だと言った。
He doesn't study as hard as he used to.	彼は前ほど勉強しない。
He said that he had met her on the previous day.	彼は前の日に彼女と会ったといった。
He gave the same answer as before.	彼は前と同じ返事をした。
He is the man you met the other day.	彼は先日君が会った人です。
He moved to Tokyo last month.	彼は先月東京に引っ越した。
He is easy to get on with.	彼は折り合っていきやすいひとです。
He is no better than a baby.	彼は赤ん坊同然だ。
He does not work so hard as he used to.	彼は昔ほど一生懸命働かない。
They say that he has a lot of old money.	彼は昔のお金を持っているそうです。
He has a lot of books for the young.	彼は青少年向きの本をたくさん持っている。
He was born and brought up in Tokyo.	彼は生まれも育ちも東京です。
He was born in Ohio but brought up in Texas.	彼は生まれはオハイオだが育ったのはテキサスだ。
He broke the world record.	彼は世界記録を破った。
He is off work for a few days.	彼は数日間休暇を取っている。
He comes here every few days.	彼は数日おきにここに来る。
He has changed a lot, and he is not what he was.	彼は随分変わってしまって昔の彼ではなくなっている。
He has changed a lot, and he is no longer what he used to be.	彼は随分変わってしまって昔の彼ではない。
He didn't meet the standards.	彼は水準を満たしていなかった。
He lived a hard life.	彼は辛い人生を送った。
He is a man of high social status.	彼は身分の高い人です。
He is a man of position.	彼は身分のある人です。
He ran an ad in the paper.	彼は新聞に広告を載せた。
He built a new house.	彼は新しい家を建てた。
I heard that he bought a new computer.	彼は新しいコンピューターを買ったらしい。
He turned around and looked back.	彼は振り向いて後ろを見た。
He was always on the people's side.	彼は常に民衆の味方であった。
He studies day and night.	彼は四六時中勉強している。
He is on board ship.	彼は乗船している。
He is always on the move.	彼は少しもじっとしていない。
He saved money little by little, so that he could build a new house.	彼は少しずつお金をためたので、新居を立てることができた。
He will be a Shakespeare in the future.	彼は将来シェイクスピアのような偉大な劇作家になるだろう。
He wants to be an Edison in the future.	彼は将来エジソンのような発明家になりたいと思っている。
He will be a Newton in the future.	彼は将来、ニュートンのような大科学者になるだろう。
He was forced to sign the document.	彼は書類に署名せざる得なかった。
He was forced to sign the document.	彼は書類に署名せざるをえなかった。
He played an important part.	彼は重要な役割を演じた。
He had to address the meeting.	彼は集会で演説しなければならなかった。
He works few days a week, and gets little money.	彼は週に何日も働かないし、収入もほとんど無い。
He works a few days a week, and gets a little money.	彼は週に２、３日働いて少しお金をもらう。
He tried to make both ends meet.	彼は収入の範囲でやりくりしようとした。
He put the phone down.	彼は受話器を下に置いた。
He made a lot of easy money.	彼は手を濡らさずに大金をつかんだ。
He looks young.	彼は若そうだ。
He could run fast when he was young.	彼は若い頃速く走ることができた。
He was better off when he was young.	彼は若い頃は暮らし向きがよかった。
It is said that he studied law when he was young.	彼は若い頃に法律を学んだそうだ。
He used to get up early when he was young.	彼は若いころは早起きだった。
He is young, but experienced.	彼は若いけれども経験がある。
Young as he is, he has a large family to provide for.	彼は若いが養わなければならない大家族がある。
Isn't he a young American student?	彼は若いアメリカの学生ではありませんか。
He came crawling to me to ask for a loan.	彼は借金を頼みに頭をペコペコ下げてやって来た。
He took a picture.	彼は写真を撮った。
He is really a Hercules.	彼は実際ヘラクレスのような力の持ち主だ。
He tried to find out what he was up against.	彼は自分の前にどんな障害が立ちふさがっているのか知ろうと努めた。
He answered as follows.	彼は次のように答えた。
He goes there now and again.	彼は時々そこに出かける。
He has something to do with the case.	彼は事件といくらか関係がある。
He is running short of funds.	彼は資金が不足しつつある。
He tried writing a short story.	彼は試しに短い物語を書いてみた。
He works us too hard.	彼は私達をこき使っている。
He came up with an answer to our problem.	彼は私達の問題への解決を見つけた。
He came up with an answer to our problem.	彼は私達の問題の答えをみつけた。
He showed us some pictures.	彼は私達に写真を見せてくれた。
He turned down my application.	彼は私の申請を却下した。
He forced me to go.	彼は私を無理矢理行かせた。
He let me work in this office.	彼は私を彼の会社で働かせてくれた。
He looked at me and said, "Watch out."	彼は私を見て危ないといいました。
He took no notice of me.	彼は私を気にも留めなかった。
He's younger than me.	彼は私より年少だ。
He can run faster than I.	彼は私より速く走れる。
He is younger than me by three years.	彼は私より三つ年下です。
He does not run as fast as I.	彼は私ほど速くは走らない。
He entered my room.	彼は私の部屋に入った。
He made reference to my book.	彼は私の著書に言及した。
He turned down my offer.	彼は私の申し出を拒否した。
He lives above me.	彼は私の上の階にすんでいる。
He didn't answer my question.	彼は私の質問に答えなかった。
He looked me in the face.	彼は私の顔をまともにみた。
He looked me in the face.	彼は私の顔をじっと見た。
He helped me to move.	彼は私の引っ越しを手伝ってくれた。
He put in a good word for me.	彼は私のために口添えをしてくれた。
He put in a good word for me.	彼は私のために口をきいてくれた。
He asked me two questions.	彼は私に二つ質問をした。
He keeps on phoning me, and I really don't want to talk to him.	彼は私に電話し続けてくる。そして私は本当に彼と話したくはない。
He asked me a question.	彼は私に尋ねた。
He did me a good turn.	彼は私に親切にしてくれた。
He gave me an example.	彼は私に実例をあたえてくれた。
He asked me a question.	彼は私に質問した。
He got me a watch.	彼は私に時計を買ってくれた。
He gave me a watch.	彼は私に時計をくれた。
He gave me back talk.	彼は私に口答えした。
He gave me a select brand of canned goods.	彼は私に缶詰の極上品を贈ってくれた。
He told me that would come again.	彼は私にまた来ると言った。
He answered not a word to me.	彼は私には一言も答えなかった。
He told me that the book was interesting.	彼は私にその本はおもしろいと言った。
He told me an interesting story.	彼は私におもしろい話をしてくれた。
He sent me some American magazines.	彼は私にアメリカの雑誌を数冊送ってくれた。
He told me not to drive too fast.	彼は私にあまり車のスピードを出すなと言った。
He asked a few questions of me.	彼は私に２、３の質問をした。
He said that he had seen the picture before.	彼は私に、その絵は前に見たことがあると言った。
He is not young any more than I am.	彼は私と同様若くない。
He has the same camera as I have.	彼は私と同じカメラを持っている。
He brought us a small gift each time he called on us.	彼は私たちを訪ねるたびにちょっとした土産を持ってきた。
It is possible that he will come to our party.	彼は私たちのパーティーに来るかもしれない。
He's going to join our club.	彼は私たちのクラブにはいるつもりだ。
He is in charge of our class.	彼は私たちのクラスの担任だ。
He wants to see us again.	彼は私たちにまだ会いたがっている。
He told us an interesting story.	彼は私たちにおもしろい話をした。
He is the last man that I want to talk with.	彼は私が最も話をしたくない人だ。
He doesn't want me to go, but I mean to.	彼は私が行くことを望まないが、私は行くつもりだ。
It was I who met him.	彼に会ったのは私だ。
He was always watching TV when he was a child.	彼は子供の頃、いつもテレビばかり見ていた。
He isn't a history major.	彼は史学専攻ではない。
He applied for a job.	彼は仕事に応募した。
He need not have come to the party last night.	彼は昨夜のパーティーに来なくてもよかったのに。
He came back about nine last night.	彼は昨夜９時ごろ戻ってきた。
He had a new house built last year.	彼は昨年新しい家を建てた。
He joined the club last year.	彼は昨年そのクラブに加わった。
Last night, he studied all night long.	彼は昨日、一晩中勉強しました。
Last night, he studied all night long.	彼は昨日は一晩中勉強しました。
He was watching TV last night.	彼は昨日の夜はテレビを見ていました。
He is the first Japanese that traveled in space.	彼は最初に宇宙旅行をした日本人です。
He tried it over and over again.	彼は再三再四それをやってみた。
He is used to hard work.	彼は困難な仕事に慣れている。
He becomes a university student this year.	彼は今年大学生になります。
He feels a lot better today.	彼は今日はとても気分がよい。
He is making the document now.	彼は今書類を作成しています。
He hasn't yet turned in the report this month.	彼は今月まだ報告書を提出していない。
He is in conference now.	彼は今会議中です。
He is on the radio.	彼は今ラジオに出ている。
He has never been to Okinawa before.	彼は今まで沖縄へ行ったことがない。
He is watching TV now.	彼は今テレビを見ている。
He's now short of money.	彼は今お金に困っている。
He is not a high school student.	彼は高等学校の生徒ではありません。
He is a student at a high school.	彼は高校の生徒です。
He is a man of few words.	彼は口数の少ない人だ。
He is a man of few words.	彼は口数が少ない男だ。
He is a man of few words.	彼は口が重い。
He has gone to Paris on official business.	彼は公用でパリへ行っている。
He has no friends to talk with.	彼は語り合う友達がいません。
He is as great an artist as lived.	彼は古来まれな芸術家だ。
He chose every word with care.	彼は言葉を一つ一つ注意深く選んだ。
He came early, as he had been asked to do.	彼は言われたとおりに早く来た。
He was welcomed by the people there.	彼は現地人に歓迎された。
He is the greatest living artist.	彼は現存する最高の芸術家である。
He looked for the key.	彼は鍵を探した。
He is not as young as he looks.	彼は見かけほど若くない。
He got well again.	彼は健康状態を取り戻した。
He got well again.	彼は健康が回復した。
He never looked back.	彼は決して振り返って見ませんでした。
He is not interested in art at all.	彼は芸術にまったく関心がない。
He runs as fast as you.	彼は君と同じくらい速く走る。
He wants a watch like yours.	彼は君が持っているような時計を欲しがっている。
He is in the banking line.	彼は銀行関係の仕事をしています。
He had a lot of money in the bank.	彼は銀行に多額の預金があった。
He works at a bank.	彼は銀行で働いています。
He got a loan from the bank.	彼は銀行からお金を借りた。
He tried to buy into the club.	彼は金を使ってそのクラブの一員になろうとした。
He said that he had a lot of money.	彼は金をたんまり持っているといった。
He has much money but few friends.	彼は金はたくさん持っているが、友達はほとんどいない。
He is hard up for money.	彼は金に困っている。
He is a hard man to get at.	彼は近づきにくい人だ。
I hear he is looking for work.	彼は勤め口を探しているそうだ。
He's had a holiday and looks all the better for it.	彼は休暇を取ったが、それでそれだけで元気になったようだ。
He never got a holiday.	彼は休暇をとったためしがない。
He's gone on holiday to the Mediterranean.	彼は休暇で地中海へ行っている。
He has a good memory.	彼は記憶力がよい。
He has a good memory.	彼は記憶が良い。
He was hard to please.	彼は気難しかった。
He is hard to please.	彼は気難しい人である。
He is hard to please.	彼は気難しい。
He is hard to please.	彼の機嫌を取るのは難しい。
He knows a lot of people.	彼は顔が広い。
He has a good position in a government office.	彼は官庁で相当な職についている。
He is full of energy.	彼は活力に満ち溢れている。
He is a student.	彼は学生です。
He found a broken camera.	彼は壊れたカメラを見つけた。
He is up and about again.	彼は回復してまた動き回っている。
He got an important position in the company.	彼は会社で重要な地位を得た。
He won't be in time for the meeting.	彼は会合に間に合わないだろう。
He bought the lot with a view to building a house on it.	彼は家を建てるつもりでその土地を買った。
He put up a notice about the change in price.	彼は価格変更のビラをはり出した。
What does he mean to do?	彼は何をしようとしているのか。
I think he is planning something.	彼は何か企んでいるように思える。
He is good for something.	彼は何かの役に立つ。
He is interested in music.	彼は音楽に興味があります。
He has two pencils; one is long and the other short.	彼は鉛筆を２本持っている。１本は長くあとの１本は短い。
He joined the English club.	彼は英語部に入った。
He got full marks in English.	彼は英語で満点を取った。
He got 90 marks out of 100 in English.	彼は英語で９０点をとった。
English is not easy for him to learn.	彼は英語がなかなか覚えられない。
He's broke.	彼は一文なしだ。
He turned down her request for a day off.	彼は一日休みたいという彼女の要請を拒否した。
He studied very hard.	彼は一生懸命勉強した。
He is a hard worker.	彼は一生懸命働く。
He worked very hard.	彼は一生懸命働きました。
He must work hard.	彼は一生懸命働かなければならない。
He ran as fast as he could.	彼は一生懸命走った。
He must have studied English hard.	彼は一生懸命英語を勉強したに違いない。
He tries hard.	彼は一生懸命がんばる。
He is a medical student.	彼は医学の学生だ。
He is a member of the committee.	彼は委員会の委員だ。
He used to get up early.	彼は以前早起きだった。
He came a little earlier than he used to.	彼は以前より少し早く来た。
He studies much harder than before.	彼は以前よりもずっと一生懸命に勉強している。
He used to go out at night.	彼は以前よく夜に外出したものです。
He came all the way to talk over a problem with me.	彼はわざわざ私が抱えている問題について話し合うためにやってきた。
He has a face which is easy to understand.	彼はわかりやすい顔をしている。
He took many pictures in London.	彼はロンドンで多くの写真を撮った。
He turned on the radio.	彼はラジオをつけた。
He knows how to make a radio.	彼はラジオの作り方を知っている。
He started to learn Spanish from the radio.	彼はラジオでスペイン語を勉強し始めた。
He works very hard.	彼はよく働きますね。
He works hard. So he does.	彼はよく働くね。まったくです。
He talks a lot.	彼はよくしゃべる。
He was well brought up.	彼はよくしつけられた。
He made a tour of Europe.	彼はヨーロッパ旅行をした。
He is a good student.	彼はよい生徒です。
He has a good memory.	彼はよい記憶力をもっている。
He must have been brought up in a good family.	彼はよい家庭で育ったにちがいない。
He has got a good camera.	彼はよいカメラを持っている。
He will learn the facts in the course of time.	彼はやがてその事実をしるだろう。
He has become a memory.	彼はもはや思い出の人となってしまった。
He is no longer a child.	彼はもはや子供ではない。
He has a good memory.	彼はもの覚えがよい。
He says that he will study English harder.	彼はもっと熱心に英語を勉強するつもりだと言っている。
He worked hard so as to save more money.	彼はもっとお金を貯めるために一生懸命働いた。
Has he come yet?	彼はもう来たかい。
They say that he will never return.	彼はもう戻って来ないだろうといううわさだ。
He is no longer a member of our club.	彼はもう私達のクラブのメンバーではない。
He is no longer a child.	彼はもう子供ではありません。
Has he returned yet?	彼はもう帰ってきましたか。
They made him do the work again.	彼はもう一度その仕事をさせられました。
He is hard on fifty.	彼はもうすぐ５０才だ。
Has he come yet?	彼はもう来ましたか。
He knows the art of making people feel at home.	彼はみんなを気楽にさせるこつを知っている。
He ran the fastest of all.	彼はみんなのなかで最も速く走った。
He talks as if he were an old man.	彼はまるで老人のような話し方をする。
He does not watch TV at all.	彼はまったくテレビを見ない。
He hasn't come yet.	彼はまだ来ない。
He came back again.	彼はまた戻ってきた。
He hasn't come of age yet.	彼はまだ成年に達していない。
He is still young.	彼はまだ若い。
I have not yet done with the work.	私はまだ仕事を終えていない。
He is not down yet.	彼はまだ降りてこない。
He is still full of energy.	彼はまだ元気盛んだ。
He hasn't returned yet.	彼はまだ帰ってきていません。
He has not come home yet, has he?	彼はまだ家に帰ってきていませんね。
He came here again.	彼はまたここに来た。
He'll be here again.	彼はまたここに帰ってきますよ。
He is still on the right side of forty.	彼はまだ４０歳以下だ。
He has few or no books.	彼はほとんど本を持っていない。
He had little social life.	彼はほとんど人付き合いをしなかった。
He runs a lot of hotels.	彼はホテルをたくさん経営している。
He had heard some other stories.	彼はほかにいくつかの話も聞いていた。
He boarded the ship.	彼はボートに乗り込んだ。
He is very good at poker.	彼はポーカーがとても上手だ。
He answered that he knew no French.	彼はフランス語は知らないと答えた。
He understands French.	彼はフランス語がわかる。
He is a student at Harvard.	彼はハーバード大学の学生だ。
He's a party animal.	彼はパーティー人間です。
He moved to New York, where he looked for a job.	彼はニューヨークへ引っ越して、そこで仕事を探した。
How fast he can run!	彼はなんと速く走れるのでしょう。
How fast he runs!	彼はなんと速く走るんだ。
How fast he runs!	彼はなんて速く走るんだろう。
How fast he runs!	彼はなんて速く走るのでしょう。
How fast he runs!	彼はなんて早く走るんでしょう。
What a lot of books he has!	彼はなんてたくさんの本を持っているんだろう。
How fast does he run?	彼はどれくらい速く走りますか。
He is an easy mark at cards.	彼はトランプのいいカモだ。
He's shorter than Tom.	彼はトムより背が低い。
He's much younger than Tom.	彼はトムよりずっと若い。
He works as hard as any other student.	彼はどの生徒にも劣らず熱心に勉強する。
He works as hard as any student.	彼はどの学生にも劣らずよく勉強する。
How fast does he run?	彼はどのくらいの速さで走りますか。
He studies very hard.	彼はとても熱心に勉強する。
He runs very fast.	彼はとても速く走る。
He drives very fast.	彼はとても速く運転する。
He's very young. He's much younger than Tom.	彼はとても若い。彼はトムよりずっと若い。
He is very young.	彼はとても若い。
He asked a very good question.	彼はとてもよい質問をした。
He has an interesting book.	彼はとてもおもしろい本を持っています。
Go where he will, he will be welcomed.	彼はどこへ行っても歓迎されるだろう。
Where was he born?	彼はどこで生まれたのですか。
He came to understand it at last.	彼はとうとうそれを理解するようになった。
He would let me help him.	彼はどうしても私に手伝わせようとした。
He turned the key.	彼はドアのキーを回した。
He likes to watch TV.	彼はテレビを見るのが好きだ。
He ran as fast as he could.	彼はできる限り早くはしりました。
He ran as fast as he could.	彼はできるだけ速く走った。
He is trying to study as hard as he can.	彼はできるだけ一生懸命勉強しようとしている。
He took as much care as possible.	彼はできるだけ気をつけていた。
He put down the book on the table.	彼はテーブルの上に本を置いた。
He lived a hard life.	彼はつらい人生を送った。
He is something of an artist.	彼はちょっとした芸術家だ。
I found him working in the garden.	彼はちょうど庭掃除をしていました。
He was chosen to be a member of the team.	彼はチームの一員に選ばれた。
He is leading a fast life.	彼はだらしない生活をしている。
He reads a lot of books.	彼はたくさんの本を読みます。
He wrote a lot of stories.	彼はたくさんの物語を書いた。
He saved a lot of money.	彼はたくさんのお金を貯めた。
He has a lot of money.	彼はたくさんのお金を持っている。
He worked very hard.	彼はたいへん一生懸命働きました。
He runs very fast.	彼はたいそう速く走る。
He is not much of an artist.	彼はたいして立派な芸術家ではない。
Never has he been to such a place.	彼はそんな場所に行ったことがない。
He need not have run so fast.	彼はそんなに速く走る必要がなかったのに。
Need he run so fast?	彼はそんなに速く走る必要があるのか。
Never has he returned since.	彼はそれ以来一度も戻っていない。
Never has he returned since.	彼はそれ以来１度も戻ってこない。
He took it from her by force.	彼はそれを力ずくで彼女から奪った。
When he heard it, he saw red.	彼はそれを聞いてカッとなった。
What do you think he meant by that?	彼はそれをどんなつもりで言ったのだと思いますか。
He doesn't know who built those houses.	彼はそれらの家をだれが建てたのか知らない。
He is very direct about it.	彼はそれについて単刀直入だ。
He asked a question about it.	彼はそれについて質問した。
He has something to do with it.	彼はそれといくらか関係がある。
He got interested in the story.	彼はその話に興味を持った。
He has a good understanding of the problems.	彼はその問題を良く理解している。
He understands the problem.	彼はその問題を理解している。
He needs to answer the question.	彼はその問題に答える必要がある。
He continued reading the book.	彼はその本を読みつづけた。
He hasn't read the book yet.	彼はその本をまだ読んでしまっていない。
He didn't notice the change, but I did.	彼はその変化に気がつかなかったが、私は気がついた。
He put the box on the table.	彼はその箱をテーブルの上に置いた。
He came down the road.	彼はその道をやってきた。
He applied for the position.	彼はその地位を志願した。
Do you think he is good for the position?	彼はその地位に適していると思いますか。
He was pleased to hear the news.	彼はその知らせを聞いて喜んだ。
He is at the head of the class.	彼はその組の首席だ。
He is on board the ship.	彼はその船に乗っている。
He added up the figures.	彼はその数字を合計した。
He felt pleased with the new car.	彼はその新しい車が気に入ったと思った。
He has given up trying to put the papers in order.	彼はその書類を整頓しようとするのをあきらめた。
He needs to answer the question.	彼はその質問に答える必要がある。
He could not answer that question.	彼はその質問に答えられなかった。
He wasn't watching TV then.	彼はその時テレビを見ていなかった。
He took no account of the fact.	彼はその事実を考慮に入れなかった。
He is still too young for the job.	彼はその仕事をするのにまだ若すぎる。
It is possible for him to do the job.	彼はその仕事をすることが出来る。
He applied for the job and got it.	彼はその仕事に志願し採用された。
He doesn't turn to that work.	彼はその仕事に向いていない。
It was possible for him to do the work.	彼はその仕事ができた。
He put the plan into practice.	彼はその計画を実行に移した。
He put the plan into practice.	彼はその計画を実行した。
We understand that he is for the plan.	彼はその計画に賛成と聞いている。
He pointed out that the plan would cost a lot of money.	彼はその計画には多額のお金がかかるだろうということを指摘した。
He has some money in the bank.	彼はその銀行にいくらか預金がある。
He opened a checking account with the bank.	彼はその銀行で当座預金口座を開いた。
He applied for a position in the office.	彼はその会社に職を申し込んだ。
He applied for a position in the office.	彼はその会社に職を求めた。
He is present at the meeting.	彼はその会合に出席している。
He took part in the meeting.	彼はその会議に参加した。
He was present at the meeting.	彼はその会に出席していた。
He was debarred from entering the club.	彼はその会に加入させてもらえなかった。
He put a mark on the page.	彼はそのページに印をつけた。
He wanted to hear about the news.	彼はそのニュースを詳しく聞きたがった。
He heard the news on the radio.	彼はそのニュースをラジオで聴いた。
He will take charge of the class.	彼はそのクラスを担任するだろう。
He may come here yet.	彼はそのうち来るかもしれない。
He was the very man for such a position.	彼はそういう職にうってつけの人であった。
He used all available means.	彼はすべての利用できる手段を使った。
He studies hardest of all the students.	彼はすべての学生の中で一番よく勉強する。
He is said to know a lot about Spain.	彼はスペインについてはいろいろ知っているようだ。
He's always been living in Tokyo.	彼はずっと東京に住んでいる。
He reads this book hard.	彼はこの本を一生懸命読んでいる。
He lives on this street.	彼はこの通りに住んでいる。
He's a student at this college.	彼はこの大学の生徒です。
He didn't come to the last meeting.	彼はこの前の会には来なかった。
He put this information to good use.	彼はこの情報をうまく利用した。
He showed me how to use this camera.	彼はこのカメラの使い方を教えてくれた。
He will by no means come.	彼はけっして来ないでしょう。
He turned around.	彼はぐるりとふりかえった。
He can run the fastest in the class.	彼はクラスの中で一番速く走ることが出来ます。
He comes to school earlier than any other student in the class.	彼はクラスの他のどの生徒よりも早く登校する。
He has always been at the head of the class.	彼はクラスでずっと一番だ。
He felt at home.	彼はくつろいだ。
He turned Christian.	彼はキリスト教徒になった。
He isn't going to buy a camera.	彼はカメラを買うつもりはない。
He has a camera.	彼はカメラを持っています。
He did an amount of work.	彼はかなりの仕事をした。
He was hard up.	彼はお金に非常に困っていた。
He is hard up for money.	彼はお金にひどく困っている。
He was born in Ohio.	彼はオハイオ州で生まれた。
He was brought up in Australia.	彼はオーストラリアで育てられた。
He was put out.	彼はおいだされた。
He received a good education in England.	彼はイングランドで立派な教育をうけた。
He knows lots.	彼はいろいろ知っている。
He is always looking to the future.	彼はいつも未来に目をむけている。
He is always on the go.	彼はいつも忙しくしている。
He is always studying.	彼はいつも勉強している。
He always takes sides with her.	彼はいつも彼女の味方をする。
He always takes sides with her.	彼はいつも彼女の見方をする。
He is always reading.	彼はいつも読書している。
He always tries to see the good in others.	彼はいつも他人の良いところを知ろうとする。
He is always at the top of the class.	彼はいつも成績がクラスで一番だ。
He really has it out for people.	彼はいつも人にやつあたりをします。
He is always on my side.	彼はいつも私の味方だ。
He is always with me.	彼はいつも私といっしょです。
He's always trying to say something to us.	彼はいつも私たちに何か言いたそうにしています。
He always reads a magazine.	彼はいつも雑誌を読む。
He is always at home on Mondays.	彼はいつも月曜日には家にいる。
He's always looking at you. He must love you.	彼はいつも君を見ている。きっと君が好きなんだ。
He's always looking at you.	彼はいつも君を見ている。
He is always pressed for money.	彼はいつも金に困っている。
He is always willing to help others.	彼はいつも喜んで他人を手伝う。
He always works hard.	彼はいつも一生懸命働く。
He always studies hard.	彼はいつも一生懸命に勉強している。
He always says one word too many.	彼はいつも一言多い。
He is always up to no good.	彼はいつもよからぬ事を企んでいる。
He always plays well.	彼はいつもよいプレーをする。
He always takes notes.	彼はいつもメモをつけています。
He is always up and doing.	彼はいつもばたばたと活動している。
It is always the case with him.	彼はいつもそうだ。
He's always short of money.	彼はいつもお金に困っている。
He is always asking for money.	彼はいつもお金が欲しいと言っている。
He's always short of money.	彼はいつもお金が乏しい。
He is a man hard to get on with.	彼はいっしょにやっていくのが難しい男です。
He can come up with any amount of money.	彼はいくらでもお金を出せる。
He does not study hard, but does very well at school.	彼はあまり勉強しない。しかし学校の成績はとてもよい。
He can't run very fast.	彼はあまり速く走ることができない。
He couldn't run very fast.	彼はあまり速く走れなかった。
He talks too fast.	彼はあまり速くしゃべりすぎる。
He was too young to go to school.	彼はあまりにも幼いので学校に行けなかった。
He is said to have been born in Africa.	彼はアフリカで生まれたと言われている。
He was born in Africa.	彼はアフリカで生まれた。
Young as he is, he has a large family to support.	彼はあのように若いのに、養わなければならない大家族を抱えている。
He doesn't understand you.	彼はあなたのいう事をわかっていません。
He wants to meet you.	彼はあなたに会いたがっていますよ。
He is something in the FBI.	彼はＦＢＩの大物だ。
He set out for London early in July.	彼は７月初めにロンドンへ向かった。
He has two children, aged 4 and 1.	彼は４歳と１歳の２児の父親だ。
He will come back in a few days.	彼は２、３日したら帰ってくるでしょう。
He will come home in a few days.	彼は２、３日以内に帰宅する。
He changed a few words.	彼は２、３の単語を入れかえた。
He returned home from Europe in 1941, when the war broke out.	彼は１９４１年にヨーロッパから帰ってきたが、その年に戦争が起こった。
He turned off all the lights at eleven.	彼は１１時に明かりを全部消した。
He said, "My car is always breaking down."	彼は「僕の車は故障ばかりしている」といった。
He has a good art of talking.	彼は、話術が巧みだ。
He showed me the camera which he had bought the day before.	彼は、前の日に買ったカメラを、私に見せてくれた。
He is human.	彼は、人間です。
He looked through a magazine.	彼は、雑誌にざっと目を通した。
He has broken the record.	彼は記録を破った。
He is in charge of our class.	彼は、我々のクラスの担任だ。
He got an easy English book.	彼は、やさしい英語の本を手にいれました。
Go easy on him. He's still new around here.	彼は、まだ新人なんだから大目に見てやれよ。
He is watching TV.	彼はテレビを見ています。
He need not get up so early.	彼は、そんなに早く起きる必要はない。
He is not more than two or three years younger than I am.	彼は、せいぜい２、３歳僕より若いだけです。
He did this before my face.	彼は、このことを僕の面前でやった。
I don't care for the way he talks.	彼の話し方が気にいらないのです。
I take sides with him.	彼の味方になる。
I've got to hand it to him. He works hard.	彼の努力には、頭が下がるよ。
He is always talking big.	彼の大風呂敷はいつものこと。
Let me go in place of him.	彼の代わりに僕を行かせて下さい。
Let me go in place of him.	彼の代わりにぼくに行かせてください。
At best he'll get 1,000 votes.	彼の取れるのはよくて千票でしょう。
Hard work has made him what he is.	彼の今日あるのは勉強のおかげである。
Let him do as he likes.	彼の好きなようにやらせなさい。
I am in agreement with most of what he says.	彼の言っていることの大方に私は同感である。
What he said also applies in this case.	彼の言った事はこの場合にも当てはまる。
I did not understand him at all.	彼の言ったことの意味が全然分からなかったよ。
I didn't understand in the least what he said.	彼の言ったことが少しも理解できなかった。
What he says is very important.	彼の言うことは非常に重要である。
Don't always take sides with him.	彼の肩ばかり持つなよ。
Don't let what he said get to you. He was just getting back at you for what you said.	彼のせりふは割り引いて聞いてよ。単に売り言葉に買い言葉というだけなんだから。
I thought he was an American but he turned out to be an Englishman.	彼のことをアメリカ人だと思ったがイギリス人だった。
Do not take any notice of him.	彼のことは無視していなさい。
At times I can't understand him.	彼のことがわからなくなることがときどきあります。
Let me go in place of him.	彼のかわりにぼくに行かせて下さい。
Did you hear of him?	彼のうわさを聞きましたか。
Try to bring out the best in him.	彼のいいところを引き出すようにしなさい。
It is no use talking with him.	彼に話しても無駄である。
Don't tell him the answer.	彼に答えを教えてはいけません。
Let me put him on.	彼に代わってもらいます。
Try sounding him out and see if he'll come around.	彼に打診して、賛成してくれるかどうか確かめてみなさい。
I think it is important to tell him the facts.	彼に事実を話す事が大切だと思います。
I couldn't make him understand my English.	彼に私の英語は通じなかった。
Let him say what he will.	彼に言いたい事を言わせておけ。
He shall go to the bank.	彼に銀行に行かせよう。
This is the second time that I have met him.	彼に会ったのはこれで２度目です。
I will meet him some other time.	彼に会うのはこの次にしましょう。
Can you meet him?	彼に会うことは出来ますか。
I would like to meet him.	彼に会いたいものだ。
I let him get the credit.	彼に花を持たせてやった。
We will let him try.	彼にやらせてみよう。
Let him at it.	彼にやらせておけ。
It is no use asking him again.	彼にもう一度頼んでも無駄だ。
Have you sent him a Christmas card yet?	彼にもうクリスマスカードを送りましたか。
He gave me a hard time.	彼にひどい目に合わされた。
He had no friend to talk to.	彼には話しかける友人がいなかった。
He has no friends to fall back on.	彼には頼れる友人がいない。
He has a position.	彼には役職がついている。
He has a good case against her.	彼には彼女に反論する立派な言い分がある。
I don't want to see him again.	彼には二度と会いたくないんです。
I haven't met him before.	彼には前に会ったことがない。
He has not less than five children.	彼には子供が少なくとも５人はいる。
Has he any children?	彼には子供が何人かいますか。
He has not more than three children.	彼には子供がせいぜい３人ぐらいしかない。
He hasn't any children.	彼には子供がいません。
He has no children.	彼には子供がいない。
Does he have any children?	彼には子供がいますか。
He has no less than twelve children.	彼には子供が１２人もいる。
He has three children.	彼には三人の子供がいます。
He is giving me a hard time.	彼には困っているんです。
He has no close friends to talk with.	彼には語り合う親しい友がいない。
He can't have heard you.	彼には君の声が聞こえたはずがない。
He shall have a holiday one of these days.	彼には近いうちに休みをやろう。
I can't put up with him.	彼には我慢できない。
As is the case with him, he reported the event.	彼にはよくあることだが、軽はずみにその事件を報道した。
I can't put up with him any longer.	彼にはもう我慢ならない。
I'll be seeing him again.	彼にはまた会うだろう。
He had a lot of work to do.	彼にはする仕事がたくさんある。
He has no title to this land.	彼にはこの土地の所有権はない。
He has something of the artist in him.	彼にはかなり芸術的な素質がある。
Give him a break!	彼にチャンスを与えてやれ！
Let's ask him.	彼にたずねよう。
Let him do it.	彼にそれをさせなさい。
When I told him I liked the picture, I really meant that.	彼にその絵は良いねと言ったのは正直な気持ちだった。
Let him pay for it.	彼にお金を払わせれば？
He is a good match for me.	彼なら相手にとって不足なし。
He'll always come through.	彼ならいつでも力になってくれるよ。
It doesn't pay to talk with him.	彼と話し合っても割に合わない。
I want to have a talk with him.	彼と話がしたい。
I am meeting him next Friday.	彼と来週の金曜日あうつもりです。
I fell into company with him.	彼と仲間になった。
Who is younger, he or I?	彼と私とどちらのほうが若いですか。
I can't bear to work with him.	彼と一緒に働くなんて耐えられない。
I met him for the first time.	彼とは初対面です。
I haven't met him.	彼とは会っていない。
I'm always meeting him there.	彼とはそこでばったり会う。
I've been friends with him since we were children.	彼とはお互い子供のときからつきあっている。
Don't get too close with him.	彼とはあまり親しくするなよ。
He and I have been good friends since we were children.	彼との子供のころから仲良しだ。
My association with him did not last long.	彼とのつきあいは長く続かなかった。
I am to meet him there.	彼とそこで会うことになっている。
When I understood him I thought better of him.	彼という人間がわかって彼を見直した。
I am to meet him at ten.	彼と１０時に会うことになってるの。
Let me know the time when he will come.	彼が来る時を知らせて下さい。
I think it possible that he may come.	彼が来ることはありうると思う。
Will you let me know when he comes?	彼が来たら教えてくれませんか。
Let's do it when he comes.	彼が来たらそれをやろう。
Let me know in no time when he comes.	彼が来たらすぐに知らせて下さい。
I can't figure out what he really wants.	彼が本当は何が欲しいのかわからない。
I heard him go out of the room.	彼が部屋を出る音が聞こえた。
He was seen to enter the room.	彼が部屋に入るのが見えた。
I saw him enter the room.	彼が部屋にはいるのを見た。
He's in charge of the sales department.	彼が販売部の責任者だ。
Did you notice him coming in?	彼が入ってきたのに気づきましたか。
He came to Japan as a child.	彼が日本に来たのは子供のときでした。
I saw him enter the store.	彼が店に入るのが見えた。
I really like him!	彼が大好き！
It was in 1950 that he was born.	彼が生まれたのは１９５０年だ。
It is important for him to get the job.	彼が職を得ることは重要なことだ。
I heard him go out.	彼が出ていく音が聞こえた。
He played an important part.	彼が重要な役を果たした。
We must take into account the fact that he is young.	彼が若いことを考慮に入れなければならない。
I know he is watching me.	彼が私を見ているのを知っている。
Only a few understood what he said.	彼が言ったことを理解したのはほんの少数だった。
Don't take any notice of what he said.	彼が言ったことなど気に留めるな。
Few students could understand what he said.	彼が言うことを理解できた生徒はほとんどいなかった。
What he says is very important.	彼が言うことは非常に重要である。
He was seen to enter the building.	彼が建物にはいるのが見られた。
He broke into a house.	彼が家に押し入った。
Have you heard from him?	彼から便りがありましたか。
I have had no news from him yet.	彼からまだ何の便りももらっていない。
I haven't heard a word from him as yet.	彼からまだ何ともいってきていない。
I haven't heard a word from him as yet.	彼からはまだ何も言ってきていない。
I have not heard a word from him as yet.	彼からはまだ何とも言ってきていない。
I haven't heard from him for ages.	彼からずいぶん長い間便りがない。
He hasn't come yet.	彼がまだ来ていない。
When he came to Tokyo for the first time, this college had not been opened yet.	彼がはじめて東京へきたころは、この大学はまだ開校されていなかった。
I can't make out why he isn't here yet.	彼がなぜまだここに来ないのか僕にはよく分からない。
I can't figure out why he did it.	彼がなぜそれをしたのか理解できない。
I can't figure out why he said so.	彼がなぜそう言ったのか理解することができない。
I can't figure him out.	彼がどんな人物かよくわからない。
He is the very person I was talking of.	彼がちょうど私が話していた人です。
It must be easy for him to find the way.	彼がその道を見つけることはやさしいに違いありません。
He designed the new building.	彼がその新しいビルを設計した。
He is in charge of the class.	彼がその学級の担任だ。
It will take some time before he understands it.	彼がそのことを理解するにはしばらく時間がかかるだろう。
He must have entered this room.	彼がこの部屋に入ったにちがいない。
It is easy for him to answer this question.	彼がこの質問に答えることは容易です。
It is fact that he wants to visit Egypt.	彼がエジプトに行きたがっているのは事実だ。
He never visits us without bringing some presents for my children.	彼がうちに来るときは必ず子供に土産を持ってくる。
I don't know when he entered the building.	彼がいつそのビルに入ったのかわからない。
I tried all possible means.	八方手をつくした。
A white ship came into view.	白い船が見えてきた。
We worked hard so as to increase our sales.	売り上げを伸ばすために懸命に働いた。
Do you charge for delivery?	配達は有料ですか。
We have two deliveries every day.	配達は毎日２回あります。
Do you charge for delivery?	配送は有料ですか。
If I could only turn my back.	背を向けることしかできないならば。
Is that all you can talk about - the Internet?	馬鹿の一つ覚えのように、インターネット、インターネットって言うなよ。
My water broke.	破水しました。
The older ones do not always know more than the younger ones.	年上の者がいつも年下の者より物知りだとは限らない。
One is never too old to learn.	年を取り過ぎて学べないということはない。
Aged people like to keep the world the way it is. On the other hand young people love to change the world.	年をとった人は世の中を現在あるがままにしておきたがる。他方、若者は世の中を変えたがる。
Year followed year...	年が過ぎていきました。
If you study hard, you will become a good student.	熱心に勉強すれば、君は立派な生徒になるだろう。
Running hard is important for you.	熱心に走ることはあなたにとって重要です。
What time does the club open?	入場は何時からですか。
We always take it easy on Sundays.	日曜日はのんびりしています。
I don't receive on Sundays.	日曜日はどなたにもお会いしません。
I'm not always home on Sundays.	日曜日はいつも家にいるとは限らない。
He did not work on Sunday night.	日曜日の夜、彼は勉強しなかった。
Monday follows Sunday.	日曜日の次に月曜日がくる。
We are against working on Sundays.	我々は日曜日に働くのは反対だ。
Let's meet on Sunday.	日曜日に会おう。
We'll meet on Sunday.	日曜日に会いましょう。
It being Sunday, I didn't get up early.	日曜日だったので、私は早く起きなかった。
Sunday is followed by Monday.	日曜の次に月曜が来る。
Let's meet on Sunday.	日曜に会おう。
I have a watch of Japanese make, which keeps very good time.	日本製の時計を持っていますが、とても時間が正確です。
The Japanese have a lot in common with the Chinese.	日本人は中国人と多くの共通点を持つ。
Few Japanese can use English well.	日本人で英語をうまく使える人はほとんどいません。
Some students are not interested in Japanese history.	日本史に興味のない生徒もいる。
What is the hard part of learning Japanese?	日本語学習のむずかしい部分は何ですか。
Japanese has something in common with Korean.	日本語は朝鮮語と共通点がある。
Welcome to Japan.	日本へようこそ。
Japan has much trade with the USA.	日本は米国と多額の貿易を行っている。
Japan is an island country.	日本は島国だ。
Japan is the best country under the sun.	日本は天下第一の国である。
Japan is to the east of China.	日本は中国の東方にある。
Japan has a lot of trade with Canada.	日本はカナダと大量の貿易をしている。
Japan does a lot of trade with Canada.	日本はカナダとの貿易が盛んだ。
Japan does a lot of trade with Britain.	日本はイギリスと多くの貿易をしている。
Japan is doing a lot of trade with the U.S.	日本はアメリカと多くの取引をしている。
Japan trades with lots of countries in the world.	日本は、世界の多くの国々と貿易している。
There are no easy answers to the land problem in Japan.	日本の土地問題には簡単な解決策はない。
The main islands of Japan are Hokkaido, Shikoku, Honshu and Kyushu.	日本の主要な島は、北海道、四国、本州、九州です。
Do you have any Japanese magazines?	日本の雑誌はありますか。
Japanese high school students go to school 35 weeks a year.	日本の高校生は年に３５週間学校に行く。
Are you interested in Japanese music?	日本の音楽には興味がありますか。
Do you have a similar saying in Japanese?	日本にも同様のことわざがありますか。
Few Indians live in Japan.	日本にはほとんどインド人は住んでいない。
Japan and Britain are island countries.	日本とイギリスは島国である。
In Japan, all children go to school.	日本では子供はみんな学校に行く。
The day is short and there's a lot of work.	日は短く仕事は多い。
The sun sets in the west.	日は西に沈む。
The sun comes and goes.	日は昇りそして沈む。
It is getting hotter day by day.	日に日に暑くなってきている。
The sun has gone down.	日が沈んでしまった。
The sun having set, we all started for home.	日が沈んだので私たちはみんな家へ向かった。
The sun is up.	日が出ている。
The days are becoming shorter.	日がだんだん短くなっている。
I will never fall in love again.	二度と恋なんかするものか。
Don't come again.	二度と来るな。
Never will I see her again.	二度と彼女に会うことはないだろう。
He never turned back again.	二度と彼はふりむかなかった。
Never will I see her again.	二度と再び彼女に会うことはないだろう。
I will not do it again.	二度としません。
Never again did I see you.	二度とあなたに会うことはない。
Never did I see him again.	二度と、私は彼には会わなかった。
Money set them against each other.	二人の反目の原因は金だ。
Two heads are better than one.	二人の頭脳は一人の頭脳に勝る。
Two men met face to face.	二人の男が面と向かい合った。
Two heads are better than one.	二つの頭は一つの頭にまさる。
The two roads join here.	二つの通りがここで交わる。
Choose between the two.	二つの中から一つを選びなさい。
I had to choose between the two.	二つのうちどちらか選ばなければならなかった。
I feel there is just no way out.	奈落の底には抜け道はなく。
There is a post office at the end of the street.	突き当たりに郵便局があります。
I continued reading the book.	本を読み続けた。
I found the book interesting.	読んでみると、その本はおもしろかった。
Are you single?	独身ですか。
I'll make this a special case, but try to keep it short.	特別扱いしますが、なるべく短めにしてくださいね。
Easy come, easy go.	得やすいものは失いやすい。
May I have a road map?	道路地図を下さい。
The road goes north from here.	道路はここから北へ延びている。
Don't play in the street.	道路で遊んではいけません。
Let's live it up!	道楽しよう。
You lead the way and I will follow you.	道を先導してください、そうすればついていきます。
Make way for the children, please.	道を開けて子どもを通してください。
There will be an answer.	道は必ず開けてゆく。
I just ran into her on the street.	道でばったり彼女に会いましてね。
Business results of the company were much better than other companies in the industry.	同業他社に比べて業績がずっと良かった。
The same applies to my class.	同じ事が私のクラスにもいえます。
Let me buy you a new one.	同じのを買わせてちょうだい。
Animal bodies are made up of cells.	動物の体は細胞でできている。
I like taking care of animals very much.	動物の世話をするのがとても楽しいんです。
I can't move.	動けないのです。
Don't move, please.	動かないでください。
Don't work too hard.	働き過ぎないように。
Watch your head!	頭上に気をつけて！
Keep your head down.	頭を上げるなよ。
Watch your head!	頭に気をつけて！
I move that we continue the discussion.	討論を継続することを動議します。
We will continue the discussion.	討論を継続する。
The movie will have started before we get there.	到着する前に映画が始まってしまうんでしょうね。
Read your paper over again before you hand it in.	答案を提出する前にもう一度読み直しなさい。
It was easy to answer.	答は簡単でした。
For the time being, I am studying French at this language school.	当分、この語学学校でフランス語を勉強します。
Life here is much easier than it used to be.	当地の生活は、以前に比べると、ずっと楽だ。
I have few friends here.	当地にはほとんど友人はいない。
He was hard on forty at the time.	当時彼は４０歳になるところだった。
I was a baby in those days.	当時私は赤ん坊だった。
I was a high school student at that time.	当時私は高校生でした。
No one lived on the island at that time.	当時その島には誰も住んでいなかった。
Go for broke!	当たって砕けろ。
Let's call Tokyo the Big Mikan!	東京をビッグミカンってよぼうよ！
This is the hottest day I have had since I came up to Tokyo.	東京へ来てからこんなに暑い日は初めてです。
All sorts of people live in Tokyo.	東京には色々な人が住んでいる。
There is an air service between Tokyo and Moscow.	東京・モスクワ間に航空便があります。
There's no way off the island.	島を出る手だてはありません。
Sunday follows Saturday.	土曜日の次は日曜日がくる。
How about going to the movies on Saturday?	土曜日に映画を見に行くのはどうですか。
All the students go home early on Saturday.	土曜日には生徒はみんな早く帰宅する。
Shall you be going to the meeting on Saturday?	土曜日には会合にお出かけになりますか。
How's Saturday night?	土曜の夜はどうかな？
It was Saturday night.	土曜の夜だった。
Would you like to see a live performance of a play with me Saturday?	土曜に私と芝居の公演を見ませんか。
Land prices are running higher every year.	土地の価格は毎年上昇している。
My car broke down on the way.	途中で私の車が故障した。
I'm talking on the phone.	電話中なんですよ。
I'm talking on the phone.	電話中です。
She asked if she could use the phone, so I let her.	電話を使ってもいいかと彼女に聞かれたので使わせてあげた。
The phone was out of order again.	電話はまた故障していた。
Answer the phone, please.	電話に出てください。
Answer the phone.	電話にでなさい。
Let's make a phone call.	電話しよう。
I hear the phone.	電話が鳴っています。
Don't turn off the light.	電気を消すな。
Turn off the light.	電気を消しなさい。
Could you turn off the lights?	電気を消していただけませんか。
Please turn on the light.	電気をつけて下さい。
I haven't heard from Tanaka for the last six months.	田中君からこの半年間何の消息もない。
Please put me through to Mr Tanaka.	田中さんに電話をつないでください。
Tamori was born in 1945, that is, when World War II ended.	田森は、１９４５年すなわち第二次世界大戦が終わった年に生まれた。
Many young people in the country long to live in the city.	田舎の青年の中には都会の生活にあこがれるものが多い。
I'd like to move to the country.	田舎に引っ越したい。
The message reads as follows.	伝言は次のように書いてある。
A change of air will do you a lot of good.	転地療養は大いに君のためになるだろう。
The change of air had done me much good.	転地は私に非常にためになった。
A change of air will do you good.	転地があなたにとって効果があるでしょう。
I took good care that I did not fall.	転ばないように十分気をつけた。
Take care not to fall.	転ばないように気をつけなさいよ。
The shop had sold out its stock of that magazine.	店はその雑誌の在庫を売り尽くしました。
I worked all night.	徹夜で勉強した。
Is my paper looked over before submitting?	提出する前に私の論文に目を通して下さいますか。
Let's join hand in hand.	提携しましょう。
The garden is common to the two houses.	庭は二軒の家の共有のものです。
Why don't I try to do something about the garden?	庭の手入れでもしようかな。
I'll water the garden.	庭に水をまこう。
I'd like a room facing the garden.	庭に面した部屋に替えてください。
What is in the garden?	庭には何がありますか。
Mail order is the main form of direct marketing.	通信販売がダイレクト・マーケティングの主な形態である。
There were a lot of people on both sides of the street.	通りの両側には大勢の人がいた。
No one was to be seen in the street.	通りには誰一人見えなかった。
No one was to be seen on the street.	通りには人影は見られなかった。
There were hundreds of cars on the street.	通りには何百もの車があった。
We see a lot of cars on the street.	通りにはたくさんの車が見える。
No one was to be seen in the street.	通りには、人の姿は全く見えなかった。
I met him in the street.	通りで彼に会った。
I met a party of students on the street.	通りで学生の一行にあった。
I have to take the test again.	追試を受けなくてはいけません。
Look at the setting sun.	沈んでいく太陽を見てごらん。
Naoko can run fast.	直子さんは速く走る事が出来る。
I will have been to Nagasaki three times if I go there again.	長崎へもう一度いくと３回行ったことになる。
Short accounts make long friends.	長くつき合うには掛けは禁物。
The long war came to an end at last.	長かった戦争がやっと終わった。
Short accounts make long friends.	長い付き合いにかけは禁物。
The long discussion came to an end at last.	長い講義がやっと終わった。
The long discussion came to an end at last.	長い議論がやっと終わった。
For a long time I wanted to meet him.	長い間彼に会いたいと思っていた。
I have not heard from him for a long time.	長い間彼から便りが無い。
It was a long time before she understood me.	長いこと彼女は私を理解してくれなかった。
The superexpress Nozomi runs faster than the Hikari.	超特急のぞみはひかりより速く走る。
It is my practice to get up at 6 a.m.	朝６時に起きるのが私の習慣です。
I put up a notice.	張り紙を出した。
Post No Bills.	張り紙お断り。
Each time an author re-writes a book, it is a new edition.	著者が本を書き直す度に新版となる。
Is there a parking lot?	駐車場は、ありますか。
I received an item that I did not order.	注文していない品物を受け取りました。
Do you offer any day tours?	昼間のツアーはありますか。
Night always follows day.	昼の後には必ず夜がやってくる。
Do you offer any day tours?	昼のツアーはありますか。
The Chinese are a hard-working people.	中国人は勤勉な国民である。
The Chinese are a hard-working people.	中国人はよく働く国民です。
They are the only students who study Chinese.	中国語を勉強している学生は彼らだけです。
Let's take a break, shall we?	中休みをしようよ。
Let's break off, shall we?	中休みしようじゃないか。
Let me in.	中に入れてよ。
Let me in.	中に入れて。
Some of them are too much to bear.	中には耐え難いものもある。
Land prices still show no sign of evening out.	地価は依然として落ち着く気配を見せない。
Please let me know.	知らせてください。
If he had known, he might have come earlier.	知っていたら、彼はもっと早く来たかもしれない。
A man is as old as he feels.	男の年齢は気持ち次第だ。
I saw a man enter the room.	男がその部屋に入るのが見えた。
In short, I don't want you to work for that company.	端的に言うと、私はあなたにその会社で働いて欲しくない。
It was not easy to get a lot of money in a short time.	短時間で多額のお金を得ることは容易ではなかった。
Who is the person in charge?	担当の方はどなたですか。
No one took notice of him.	誰も彼に気づかなかった。
No one loves war.	誰も戦争を好むものはいない。
No one really knows what a UFO is like.	誰も実際にはユーフォーがどのようなものか知らない。
No one replied to the question.	誰も質問に答えなかった。
No one knew how to answer the question.	誰もその問いにどう答えたら良いかわからなかった。
No one could find the answer.	誰もその答えが分からなかった。
No one can move the big box.	誰もその大きな箱を動かすことができない。
No one knew how to answer the question.	誰もその質問にどのように答えたらよいかわかりませんでした。
No one knows the fact.	誰もその事実を知りません。
No one was present at the meeting.	誰もその会合に出席していなかった。
Who were you talking to?	誰に話しかけていたんだ。
I don't know who to turn to.	誰に頼っていいかわからない。
Who shall I choose?	誰に白羽の矢を立てようかな。
Every man can't be an artist.	誰でも芸術家になれるとは限らない。
Who built it?	誰が立てたのですか。
Who will take charge of their class?	誰が彼らのクラスの担任になるのだろうか。
The question is who is going to tell him.	誰が彼に伝えるのかが問題です。
Who do you think will be chosen?	誰が選ばれると思いますか。
Who loves war?	誰が戦争を好むか。
Who do you think was watching TV in this room last night?	誰が昨夜この部屋でテレビを見ていたと思いますか。
Who built it?	誰が建てたのですか。
Who lives in the room below?	誰が階下に住んでいますか。
Who's in charge of the sales section?	誰が営業部を担当しているのですか。
Who should I meet but Tom?	誰かと思えばなんとトム君だった。
Who put you up to it?	誰がそんなことをさせたの。
Who is going to put this into English?	誰がこれを英語に訳してくれますか。
Who will take care of the baby?	誰がこの赤ちゃんを世話してくれるの。
Who is in charge of this building?	誰がこのビルのかんりしゃですか。
Do you know who is looking at that picture?	誰があの絵を見ているか知っていますか。
Who can run fastest in your class?	誰があなたのクラスで一番速く走ることが出来るのですか。
World War II ended in 1945.	第二次世界大戦は１９４５年に終わった。
The Second World War broke out in 1939.	第二次世界大戦は１９３９年に勃発した。
It was in 1939 that the Second World War broke out.	第二次世界大戦が勃発したのは１９３９年でした。
Let's take up the second problem, shall we?	第二の問題を取り上げましょう。
World War I broke out in 1914.	第一次世界大戦は1914年に勃発した。
When did World War II break out?	第２時世界大戦は、いつ起こったか。
I have to type in a really big document.	大量の文書を入力しなきゃならない。
Our water supply is very short.	大変な水不足です。
It's really good.	大変おいしいですよ。
It was very hot.	大変、暑い日だった。
I'm about to tell you something important.	大切な話があるんです。
What is important is not what you do, but the way you do it.	大切なことは、何をやるかではなく、それをいかにやるかだ。
Now, this is really important.	大切なことなんだから。
A lot of people applied for the job.	大勢の人がその職を申し込んだ。
Only adults can see this film.	大人だけこの映画が見える。
Two adults, please.	大人２枚ください。
They may even ask if you are all right or if there is something they can help you with.	大丈夫ですか、とか、何かお手伝いできることはありますか、などとさえ尋ねるかもしれない。
You've really helped me a lot.	大助かりでした。
Please let me know when you come to Osaka.	大阪に来るときは私に知らせてください。
Mr. Obama wants to move to Tokyo from Osaka.	オバマさんが大阪から東京に転入したいです。
They run the university with a view to making a lot of money.	大金を稼ぐつもりで、彼らは大学を経営している。
Are you a college student?	大学生ですか。
I am a university student.	大学生です。
The college breaks up on Tuesday.	大学は火曜日に学期が終わる。
A university job would give you a lot more free time.	大学の仕事のほうが、今よりもはるかに自由な時間を持てるでしょう。
I've made a lot of friends since I entered college.	大学に入って友達がたくさんできた。
What do you plan to major in in college?	大学では何を専攻するつもりですか。
There were lots of people.	大ぜいの人たちがいた。
It's not important.	大したことじゃないんだから。
I will be only too pleased to help you.	大いに喜んで手伝いましょう。
I'll be only too pleased to help you.	大いに喜んでお手伝いいたしましょう。
Short accounts make long friends.	貸借の期間が短ければ交友期間は長い。
The sun sets in the west.	太陽は西に没する。
The sun sets in the west.	太陽は西に沈む。
The sun is just setting.	太陽は今沈むところだ。
The sun sends out light.	太陽は光を放つ。
The sun is about to set.	太陽はまさに沈もうとしている。
The sun was about to come up.	太陽はまさに昇ろうとしていた。
The sun is about to set.	太陽が沈もうとしている。
The sun was setting.	太陽が沈みかかっていた。
The sun is coming up.	太陽が昇ってきた。
The sun came out.	太陽が出てきた。
The sun is just setting.	太陽が今沈むところだ。
The sun was about to set.	太陽がまさに沈むところだった。
If it were not for the sun, we could not live at all.	太陽がなければ、我々は生きてゆけないだろう。
If it were not for the sun, we could not live at all.	太陽がなければ、我々は生きていられないだろう。
The sun is going down.	太陽が沈んでいく。
For all I know, he was born in Italy.	多分彼はイタリア生まれだ。
It is important for you to read many books.	多くの本を読むことが大切です。
The world has seen a lot of changes in many fields.	多くの分野で世の中はずいぶん変わりました。
Many students bought the book.	多くの生徒がその本を買った。
To talk with a lot of people is good for health.	多くの人々と話すことは、健康に良い。
In common with many people he likes holidays.	多くの人と同じように彼は休日が好きだ。
Meeting many people is an important part of a party.	多くの人と知り合うことがパーティーの重要な部分だ。
Many a man has made the same error.	多くの人が同じ過ちをおかした。
Many people applied for the position.	多くの人がその職に申し込んだ。
A lot of people look up to you. Don't let them down.	多くの人があなたを尊敬しています。彼らをがっかりさせないで下さい。
Many young people were present at the party.	多くの若者がそのパーティーに出席した。
A lot of jobs are done by computers.	多くの仕事がコンピューターによってなされている。
Many countries are experiencing similar problems.	多くの国が似たような問題を経験している。
Many a student studies at the library.	多くの学生が図書館で勉強している。
A lot of students are present at the meeting.	多くの学生がその会合に出席しています。
Many students are looking for part-time jobs.	多くの学生がアルバイトを探しています。
The common language of many Asians is English.	多くのアジア人の共通言語は英語だ。
Do not look too much to others for help.	他人からの援助をあまりあてにしてはいけない。
I have to study hard to keep up with the other students.	他の生徒についてゆくために一生懸命に勉強しなければならない。
If you want to include other information, please let us know.	他に記載すべき情報があれば教えてください。
Do you have any other questions?	他に何か質問がありますか。
Let's go!	行きましょう。
Please send it by special delivery.	速達便でお願いします。
Can you make it special delivery?	速達にしてくれませんか。
Do watch your step.	足元に御用心願います。
Watch your step.	足下に注意して下さい。
We're short of something.	足りないものがあります。
You are at it again.	相変わらずやってるね。
You never change, do you?	相変わらずだね。
Please come to talk to me.	相談に来てください。
Is that the way you talk to me?	相手を見て物を言うがよい。
It is good for the health to get up early.	早起きは体のためにはよい。
It is good to get up early.	早起きはよいことだ。
Getting up early is very good.	早起きはたいへんよい。
I'm used to getting up early.	早起きには慣れているんだ。
I'm used to getting up early.	早起きになれているから。
Get up early, and you'll be in time.	早起きすれば間に合いますよ。
If you get up early, you will feel so much the better.	早起きすれば、それだけもっと気分が良くなるだろう。
I'm used to getting up early.	早起きするのに慣れているから。
Let's start early, shall we?	早く出発しよう。
Would it be better to start early?	早く出発したほうがよいだろうか。
Get up early.	早く起きろ。
You had better get up early.	早く起きるほうがよい。
If you get up early, you can be in time for school.	早く起きれば、あなたは授業に間に合います。
You had best go home early.	早く帰宅すべきだ。
Come home early, Bill.	早く帰りなさいビル。
Come home early.	早く帰ってらっしゃい。
Come home early, Bill.	早く帰ってらっしゃい、ビル。
You may go as long as you come home early.	早く帰ってくるなら行ってもいい。
Come home early, Bill.	早く帰っていらっしゃい。
You should have come earlier.	早くこればよかったのに。
You are early.	早かったね。
All students have access to the library.	全学生はみんな図書館に入ることができる。
All the students are present.	全ての生徒が出席している。
Every means has not been tried.	全ての手段が試みられたわけではない。
Please answer all the questions.	全ての質問に答えなさい。
Really, you are so mean!	全くもう、本当にいじわるなんだから。
Really, you are so mean.	全くもう、本当にいじわるだ。
I haven't seen Karen since we fell out last month.	前月仲たがいして以来カレンには会っていない。
See above.	前記参照。
That's really great!	前よりずーっと良くなっていますよ。
We took up that problem at the last meeting.	前の会議でその問題を取り上げた。
I have met her before.	前に彼女に会ったことがあります。
You ran into him earlier, didn't you?	前、偶然彼に会いましたね？
How many people are on board the ship?	船中にはどのくらいの人がいるのですか。
It must have been broken during shipping.	船積みの時壊れたに違いない。
The ship changed its course.	船は進路を変えた。
You had better have gone by ship.	船で行く方がよかったのに。
Mr Masuzoe always has lots of books with him.	舛添氏はいつも本をいっぱい抱えている。
What is the best way to put an end to the war?	戦争を終わらせる最善の方法は何ですか。
What do you think of war?	戦争をどう思いますか。
The war is still going on.	戦争はまだ進行中です。
The war ended in 1945.	戦争は１９４５年に終わった。
War broke out in 1939.	戦争は１９３９年に勃発した。
The war broke out in 1939.	戦争は１９３９年に起きた。
The day will come when there will be no war.	戦争のない時代が来るだろう。
The time may come when we will have no war.	戦争のない時代が来るかもしれない。
The war brought their research to an end.	戦争で彼らの研究はストップした。
How old were you when the war broke out?	戦争が勃発したとき、あなたはいくつでしたか。
The year the war ended, I was born.	戦争が終わった年に、私は生まれた。
We had lived there for ten years when the war broke out.	戦争が始まったとき、私たちはそこに１０年間住んでいた。
May there be no war!	戦争が起こりませんように。
What will become of us if a war breaks out?	戦争が起こったら私達はどうなるのだろうか？
What will become of us if a war breaks out?	戦争が起こったら私たちはどうなるの。
He was living in London when the war broke out.	戦争が起こったとき、彼はロンドンで暮らしていた。
What will become of us if a war breaks out?	戦争がおこったら我々はどうなるのでしょうか。
What's your major?	専攻は何ですか。
Rome was not built in a day.	千里の道も一歩から。
Your party doesn't answer.	先方がお出になりません。
I met him the other day.	先日彼に会った。
I bought a watch the other day. It keeps good time.	先日時計を買ったがそれは時間が正確だ。
I met him on the street the other day.	先日私は通りで彼にあった。
The other day I met an old friend on the street.	先日私は通りで級友と会った。
The other day, I met him in Kyoto.	先日京都で彼にあった。
I bought a camera the other day.	先日カメラを買いました。
I met Meg in Kyoto last week.	先週京都でメグにあった。
Up to last week, I hadn't received a reply.	先週までに私は返事を受け取っていなかった。
When I met Hanako last Sunday, she said she had returned three days before.	先週の日曜に花子に会ったら、彼女は３日前に帰ったと言った。
We had the meeting in this room last Friday.	先週の金曜日この部屋で会合があった。
Last week's meeting was the longest we have had this year.	先週の会議は今年の会議の中で最高に長かった。
I read a few books last week.	先週、私は少し本を読んだ。
I read few books last week.	先週、私はほとんど本を読まなかった。
I heard from him last month.	先月彼から便りがあった。
I had an easy delivery last time.	先回は安産でした。
Last I met him, he was very well.	先だって彼にあったときには、彼はとても元気だった。
Never play on the road.	絶対に道路で遊ぶな。
It's now or never.	絶好のチャンスだよ。
It was really close.	接戦でしたね。
Do you have any in red?	赤色のはありますか。
The baby must be taken good care of.	赤ん坊は十分世話されなければならない。
The baby's age is now two years.	赤ん坊の年は今は２歳です。
The baby has taken to him.	赤ん坊がかれになついた。
Bringing up a baby is hard work.	赤ちゃんを育てるのは重労働です。
Babies are interesting to watch.	赤ちゃんは見ていて楽しい。
The baby was crawling on all fours.	赤ちゃんは四つん這いになってはっていた。
See what the baby is doing!	赤ちゃんが何をやっているのか見ておいて。
Have you named your new born baby?	赤ちゃん、もう命名した？
Some are red and others are white.	赤いものもあれば白いのもある。
I used to a lot.	昔はよくした。
The old days have gone never to return.	昔の日々は過ぎ去ってしまい決して帰って来ない。
I'm not as young as I was.	昔のような元気はない。
In early times all books were copied by hand.	昔、書物はすべて手で書き写された。
Well, let me take it back and figure it out for you.	席に持ち帰って調べてやるよ。
Please pay the tax.	税金をお支払いください。
Where should I pay the tax?	税金はどこで払うのですか。
What's the price per night including all charges?	税、その他全て込みだと１泊いくらですか。
Do you have any in blue?	青色のはありますか。
The bill came to over $25.	請求書は合計２５ドル以上になった。
Try hard.	精一杯やってみなさい。
I was born on February 14, 1960.	生年月日は１９６０年２月１４日です。
All the students have gone home.	生徒達はみんな家に帰りました。
The students could not give an answer.	生徒は答えられなかった。
No students could answer the question.	生徒は誰もその質問に答えられませんでした。
There are about a thousand students in all.	生徒は全部で約千人です。
The students range in age from 18 to 25.	生徒の年齢は１８歳から２５歳にわたっている。
We're getting fewer and fewer students.	生徒の数がだんだん減ってきた。
The students answered in order.	生徒たちは順番に答えを言った。
All the students look up to him.	生徒たちは皆彼を尊敬している。
All the students like holidays.	生徒たちはみんな休日が好きだ。
The students parted into three groups.	生徒たちは３つのグループに分かれた。
Mark the right answer.	正しい答えに印をつけなさい。
Mr Hoshino is hard to please.	星野氏は気難しい。
It is interesting to look at the stars.	星を見ることは興味深いことだ。
Stars can be seen at night.	星は夜に見ることが出来る。
It is interesting to watch stars.	星をながめるのは興味深い。
It sounds as if the government doesn't know what to do.	政府もなすすべがないようだ。
The government issued the following statement.	政府は次のような声明を出した。
The government makes us pay tax.	政府は私たちに税金を払わせる。
The government turned down the request.	政府はその要求を却下した。
The government has set up a committee to look into the problem.	政府はその問題を調査するために委員会を設立した。
Come and see us by all means.	是非とも訪ねてきてください。
Please come to my house by all means.	是非とも私の家にお越しください。
Please do so by all means.	是非ともそうしてください。
By all means.	是非どうぞ。
I'd like that a lot.	是非そうしたいですね。
A lot of students around the world are studying English.	世界中の多くの学生が英語を学んでいる。
Let's call out to the people around the world.	世界中の人々に向かって声を発してみよう。
There are a body of languages in the world.	世界にはたくさんの言語がある。
There are more than 4000 languages in the world.	世界には４０００以上の言葉がある。
Live and let live.	世の中は持ちつ持たれつだ。
You shouldn't go out for a few days.	数日は外出しないように。
There are some children playing in the park.	数人の子供が公園で遊んでいる。
The figures add up to 230.	数字は合計２３０となる。
The water is running with great force.	水道の水が勢いよく出ている。
The water supply was turned off.	水道の水が止められた。
The water ran over the banks.	水は堤防を越えた。
Water is important for humans.	水は人間にとって大切だ。
Living without water is out of the question.	水なしで生きることはまったく不可能である。
Don't talk in the reading room.	図書室ではしゃべるな。
There are a lot of books in the library.	図書館にはたくさんの本があります。
We have a lot of children's books in the library.	図書館にはたくさんの児童書がある。
There are a lot of students in the library.	図書館にはたくさんの学生がいます。
Talking in the library is not allowed.	図書館ではおしゃべりをしてはいけません。
What you are is more important than what you have.	人柄のほうが財産よりも重要である。
The more we know about life, the better we can understand what we read.	人生を知れば知るほど、我々は読む本の内容をよく理解する事が出来る。
Life is so important for him.	人生は彼にとってとても大切なものだ。
Life doesn't always go the way we want it to.	人生は思うようにはいかないものだ。
People say that life is short.	人生ははかないよ、とひとは言う。
Life is at best very short.	人生はせいぜいよくみてもも、大変短い。
Life is at best very short.	人生はせいぜいよくみてもたいへん短い。
Life is more interesting than any book.	人生はいかなる本よりも興味深い。
How short life is!	人生なんて短い。
There is no returning on the road of life.	人生という道を引き返すことはできない。
There is no returning on the road of life.	人生という道で後戻りはできない。
The best time of life is when we are young.	人生で一番よいときは、我々が若いときです。
The best time of life is when you are young.	人生で一番いい時は、若い時です。
People used to think that only humans could use language.	人々は人間しか言語を使えないと以前は考えていた。
People were moving faster and faster.	人々はもっともっと早く動くようになりました。
Man is the only animal that can talk.	人間は話す事の出来る唯一の動物だ。
Man is the only animal that talks.	人間は話ができる唯一の動物である。
Man is a social animal.	人間は社会的な動物です。
The men form a society.	男は社会を形成する。
People love to talk, talk, talk.	人間はしゃべることが大好きだ。
What one is is more important than what one has.	人格は財産よりも重要である。
He who helps others, in turn shall be helped by them.	人を助ける者は、今度は人から助けられるであろう。
He who helps others, in turn shall be helped by them.	人を助けるものは、今度は人から助けられるだろう。
Man is a social animal.	人は社会的動物である。
I'm not good at meeting people.	人に会うのは苦手だ。
I can't talk with people.	人と話ができません。
Any student with an I.D. card has access to the library.	身分証明書を持っている学生なら、誰でも図書館に入ることができる。
Do you have any ID?	身分証明をお持ちですか。
Kobe is the city which I was born in.	神戸は私が生まれた町です。
Please fax me the application form.	申込書をファックスで送ってくれませんか。
In order to apply, you have to go in person.	申し込むには君本人が行く必要がある。
The function of the press is to provide the common people with facts.	新聞の働きは一般大衆に事実を提供することだ。
A new student came into the class.	新入生が教室へ入ってきた。
Many questions came up about the quality of the new product.	新製品の品質に多くの疑問が出てきた。
The new fact has come to light.	新事実が明らかになった。
We moved into a new house.	新居へ引っ越した。
New facts have been brought to light.	新たな事実が明らかになった。
You must turn in your old license in order to get a new one.	新しい免許証をもらうには古いのを返さねばならない。
It always takes time to get used to a new place.	新しい土地に慣れるには、時間がかかるものですよね。
How fast the new Shinkansen goes!	新しい新幹線の速いこと！
It is easy to make friends even in the new places.	新しい場所でも友達を作るのは簡単だ。
Please let me know your new address.	新しい住所を連絡して下さいね。
Please let me know your new address.	新しい住所を連絡してください。
Take great care when you put your hand to a new business.	新しい事業に手をつけるときはよく気をつけなさい。
The new industry brought about changes in our life.	新しい産業は私たちの生活に種種の変化をもたらした。
When will the new magazine come out?	新しい雑誌はいつ出版されますか。
I hear you'll set up a new company.	新しい会社を作るそうですね。
I am looking for a part-time job so I can buy a new video camera.	新しいビデオカメラを買えるように、アルバイトの口を探しています。
The new computer is ten times as fast as the old one.	新しいコンピューターは旧型よりも１０倍速い。
Don't look back cause you know what you might see.	振り向くなよ、なにが見えるかは見当つくんだから。
Few people are free from cares.	心配ごとのない人はほとんどいない。
The light turned red.	信号は赤に変わった。
I didn't notice the light turn red.	信号が赤になるのに気づかなかった。
They got over to the other side while the light was red.	信号が赤いうちに彼らは向こう側へ渡った。
Food has been in short supply.	食糧が不足している。
We ran short of food.	食糧が不足した。
We have run short of food.	食べ物をきらしてしまった。
Some food was brought to them.	食べ物が彼らの所へ運ばれた。
Do you have this in any other colors?	色違いはありませんか。
The color will not go off.	色はさめないでしょう。
The color has come out well.	色の上がりがよい。
Please let me know the status.	状況をお知らせください。
Always do what is right.	常に正しい事をせよ。
You must always do what is right.	常に正しいことをしなければならない。
You should always do your best.	常にベストを尽くしなさい。
Could you make it a little shorter for me?	丈を少し詰めていただけますか。
When does the movie start?	上映は何時からですか。
See the example given above.	上に上げた例を見なさい。
Please give us three references.	照会先を３件ください。
Please have some copies made.	焼き増ししてください。
Do you want small bills or large?	少額の札にいたしますか、それとも高額の札にいたしましょうか。
Won't you take something off this price?	少し値引きしてくれませんか。
We're a little early.	少し早めに着きました。
The work will come easy with a little practice.	少し訓練すれば、その仕事は楽になるだろう。
Could you take care of the baby for a while?	少しの間、赤ん坊を見てくれませんか。
Let me know when you get the package.	小包を受け取ったら、知らせてください。
Please include lots of small change.	小銭を多めに入れてください。
You can get only NHK in the Ogasawara islands.	小笠原諸島では、ＮＨＫの電波しか入らない。
Could you find me a house that has a small garden?	小さな庭つきの家を探してくれませんか。
Even a little child knows its name.	小さな子どもでもその名前を知っている。
What would you like to be in the future?	将来君は何になりたいですか。
What do you want to be in the future?	将来何になりたいですか。
Please take more care in the future.	将来はもう少し注意しなさい。
I can't help thinking of the future.	将来の事を考えずにはいられない。
Put by money for the future.	将来に備えて貯蓄しておきなさい。
We must provide for future.	将来に備えねばならない。
You should think about your future.	将来について考えるのが当然です。
What would he like to be in the future?	将来、彼は何になりたいですか。
What are you going to be in the future?	将来、何になるつもりですか。
What do you want to be in the future?	将来、何になりたいの？
The business is in the red.	商売は赤字だ。
Masaru doesn't care for this color.	勝君はこの色が好きではない。
It is important to help each other.	助け合うことは大切である。
Please don't take the documents out of this room.	書類はこの部屋から持ち出さないでください。
Apply in writing.	書面でお申し込み下さい。
Books and friends should be few but good.	書物と友人は数が少なくよいものをもつべきだ。
Books must follow sciences, and not sciences books.	書籍が学問に従うべく、学問が書籍に従うべからず。
I need something to write with.	書くものが欲しいな。
Let's go out before it gets hot.	暑くならないうちに出かけよう。
It's too hot.	暑くて仕方ない。
I had my first period when I was 13 years old.	初潮は13歳の時でした。
This is the first time I heard about it.	初耳ですね。
The first step is the hardest.	初めの一歩が唯一の難関。
I have important business to take care of in my office.	処理しなければならない大切な仕事が会社にあります。
Let's write in turns.	順番に書きましょう。
Try to read as many books as possible.	出来るだけ沢山の本を読むようにしなさい。
It is really time for us to go.	出発する時間だ。
Those present were all against the plan.	出席者は全員その計画に反対だった。
Those present were, for the most part, students.	出席した人はたいてい学生だった。
Would you please let me know the delivery time?	出荷時をご連絡ください。
Could you let him out?	出してやってくれませんか。
Let me out!	出してくれ。
Could you let it out?	出していただけますか。
I play an important part.	重要な役を演じる。
An important post was given Tom.	重要な地位がトムに与えられました。
What is important is not how many books you read, but what books you read.	重要なのは、何冊本を読むかでなく、どんな本を読むかである。
Ten to one he will be chosen.	十中八九彼が選ばれるだろう。
I must bring my address book up to date.	住所録を新しいものに書き直さなければならない。
Where will we meet?	集合場所はどこですか？
The meeting broke up at seven.	集会は７時に解散した。
You should receive them by the end of the week.	今週末までには届くはずです。
You must try hard to the end.	終わりまで一生懸命に努力しなければならない。
Fall is when we can study best.	秋は私たちが一番勉強できるときです。
Fall is when we can study best.	秋は私たちがいちばんよく勉強できる時です。
In fall they go back to school.	秋になると彼らは学校へもどる。
Try to live within your means.	収入相応の暮らしをしなさい。
You should live within your means.	収入の範囲内で暮らすべきだ。
You should try to live within your means.	収入に応じた生活をするように。
Don't talk to others during the class.	授業中はほかのの人に話しかけてはいけません。
You must not talk to each other in class.	授業中におしゃべりをしてはいけない。
Please let me know when you receive them.	受け取ったらご連絡下さい。
Let me do this.	手伝ってやる。
Let me give you a hand.	手伝いましょう。
Learn a trade.	手職を身につける。
Let's do this as a first step.	手初めにこれをやってみましょう。
Let me hear from you.	手紙を下さい。
Have you had an answer?	手紙の返事はもらいましたか。
Don't let go.	手を離すなよ。
Don't put out your hand.	手を出してはいけません。
Put your hands up!	手をあげろ！
Those who bring something with them are welcome.	手ぶらで来ない者は歓迎される。
Books for young people sell well these days.	若者を対象にした本が近頃良く売れる。
The young should make room for the old.	若者は老人に席を譲るべきだ。
A young man came for the new product.	若者が新製品を引き取りにきた。
If only I was younger.	若かったらよかったのに。
There is no returning to our younger days.	若い日に戻ることはできない。
When I was young, I tried to read as many books as I could.	若い時は、私はできるだけ多くの本を読もうとした。
You had better read a lot of books while you are young.	若い時に本をたくさん読んだほうがいい。
Try to read as many books as you can when young.	若い時にできるだけたくさんの本を読むようにしなさい。
I had to work hard when I was young.	若い頃は懸命に働けなければならなかった。
You should make the most of your time while you are young.	若い間は自分の時間をできるだけ有効に使わなければならない。
You're young.	若いなあ。
I could run much faster when I was young.	若いころは今よりずっと早く走ることができた。
Young as he is, he has much experience.	若いが彼は経験豊富です。
Being young, he can work all day long.	若いから彼は一日中働ける。
You should work hard while you are young.	若いうちは苦労すべきだ。
Build up your body while young.	若いうちに体を鍛えなさい。
Read as many books as you can while you are young.	若いうちにできるだけ本を読みなさい。
While you're young, you should read a lot.	若いうちにたくさんの本を読むべきだ。
You must study hard while young.	若いうちに、一生懸命勉強しなければならない。
Move your car, please.	車を動かしてください。
I traded in my car for a new one.	車を下取りに出して新車を買った。
Would you move your car, please?	車をどかしてくれませんか。
Few people have two cars.	車を２台もつ人はほとんどいない。
A few people have two cars.	車を２台もつ人が２、３人いる。
Our car broke down on our way there.	車はそこへ行く途中で故障してしまった。
Our car broke down on our way there.	車はそこに行く途中で故障した。
You should always keep your car in good order.	車はいつも整備しておきなさい。
Let's go by car.	車で行こう。
The car broke down.	車が壊れていた。
Society could not care less.	社会はぜんぜん気にしない。
Changes in society come from individuals.	社会における変化は個人から生じる。
Let's take a picture.	写真を撮ろう。
Please show me your picture.	写真をどうぞ見せて下さい。
Do you know this man in the picture?	写真のこの男の人を知っていますか。
Both teams are well matched. The game will be an interesting one.	実力が伯仲したチーム同士の対戦なので面白い試合になりそうだ。
In fact, I did not know it.	実際私はそれを知らなかった。
In fact, he loves her.	実際は彼は彼女を愛している。
I really will have to study.	実際に勉強しなければいけないでしょう。
In fact, I was there.	実際に私はその場にいたのです。
Easier said than done.	実行するより口で言うほうが容易だ。
The fact is that he is my close friend.	実は彼は私の親友なのだ。
The fact is I do not love her.	実は私は彼女を愛してはいないのです。
The fact is that I haven't read the book yet.	実は私はまだその本を読んでいないのです。
The fact is I didn't go to school today.	実は今日は学校に行きませんでした。
The fact is that I have no money with me.	実はお金の持ちあわせがないのです。
In fact, he has never been to New York.	実は、彼はニューヨークには行った事がない。
I was in fact thirty-one at the time.	実のところ、当時私は３１歳であった。
I was in fact thirty-one at the time.	実のところ、当時は私は３１歳であった。
I would like to address two questions.	質問を二つしたいと思います。
May I ask you a question?	質問をしてもいいですか。
Ask your question.	質問をどうぞ。
Put the question in writing.	質問は書面にして下さい。
Will you put your questions in written form?	質問は書いていただけませんか。
Do you have any questions?	質問はおありですか。
I would like to address two questions.	質問は２つしたいと思います。
Must I answer all the questions?	質問の全てに答えなければなりませんか。
Answer the question.	質問に答えなさい。
May I ask a question?	質問してもよろしいですか。
May I ask you a question?	質問してもいいですか。
May I ask you a question?	質問していい？
If you have a question, please ask me.	質問があれば私に聞いてください。
May I ask a question?	質問があるのですが。
I have a question.	質問があります。
Please ask me any time you have a question.	質問があったらいつでも聞いてください。
The rights of the individual are important in a free society.	自由社会においては個人の権利は重要である。
You shouldn't let people use you like that.	自分をそんなふうに人々に利用させておくべきではない。
Live and let live.	自分も生き、他人も生かせ。
Let me pay my share.	自分の分は払います。
Put your room in order.	自分の部屋を整頓しなさい。
Put your name on all your belongings.	自分の持ち物には全て名前をつけなさい。
Don't compare your children with others.	自分の子を他人の子と比較するな。
I really love my work.	自分の仕事にやりがいを感じています。
It won't do you any good to talk up your own work like that.	自分の作品を自画自賛してどうするの。
You can do it however you like.	自分の好きなようにやってよろしい。
You can read a lot more than you think you can.	自分で読めると思っているよりも実際はずっと多くの本が読めるものです。
I feel as if I were another person.	自分ではないような気がする。
I feel like another person.	自分が別人になった感じだ。
You always try to get what you want.	自分勝手な奴だな。
Please move your car out of here.	自動車をここから動かしてください。
The car is running fast.	自動車が速く走っている。
You've told me something.	耳寄りな話だ。
Jiro has not come back from New York yet.	次郎はまだニューヨークから帰っていない。
One event followed another.	次々に事件が起きた。
My turn comes next.	次は私の番です。
It's your turn next.	次は君の番だ。
When should I come again?	次はいつ来ればいいのでしょうか。
You'll find our house at the end of the next street.	次の通りのつきあたりに私達の家があります。
What time is the next performance?	次の上演時間は何時からですか。
Let me play the next game.	次の試合を私にさせて下さい。
We will have lived here for a year next March.	次の三月で私たちはここに１年間住んでいることになるでしょう。
I will be seeing her again next Friday.	次の金曜日にもう一度彼女に会うでしょう。
The next meeting will be on the tenth of June.	次の会合は６月１０日です。
The next meeting will take place in a few days.	次の会議は数日中に開かれる。
We'll note it in the following way.	次のように記載します。
I'll ask you these questions.	次のようなことをあなたに質問したい。
What to do next is our question.	次に何をするかが私たちの問題である。
What to do next is the question.	次に何をすべきかが問題である。
What we should do next is the question.	次に何をしたらよいかが問題だ。
Next, we will talk to Ms. Pam Roland.	次に、パム・ローランドさんにお話をうかがってみましょう。
It's not easy to keep up with the times.	時代の流れについていくのは容易ではない。
I watch TV off and on.	私は時々テレビを見る。
We will set our watch by Japan Time.	時計を日本標準時に合わせよう。
I asked him if he wanted a watch.	時計が欲しいのですかと私は彼に言った。
My watch has run down.	時計が止まってしまった。
My watch ran down and I didn't know the time.	時計が止まって、時間がわからなくなった。
My watch is broken, so I want a new one.	時計が故障してしまったので、新品が欲しい。
I found my watch broken.	時計が壊れているのに気がついた。
It's not too much to ask you to come to class on time.	時間通りに授業に出ることを君に求めるのはいきすぎではない。
Only a few people showed up on time.	時間どおりに現れたのは２、３人しかいなかった。
Time is short, we must act NOW.	時間がありません。いますぐ行動しなければなりません。
The owner sold the building for what he wanted.	持ち主はそのビルを希望どおりの値で売った。
Put on me to the office.	事務所の方につないでください。
There are some children around the office.	事務所のまわりに何人かの子供たちがいます。
The event came about like this.	事件は、こんなふうに起きた。
Don't talk to others during the class.	事業中はほかの人に話し掛けてはいけません。
Have you heard about the result of the game?	試合の結果について聞きましたか。
I watched TV during my breaks.	試合の間にテレビを見た。
Let's have a go at it.	試しにやってみよう。
We saw her enter the park.	私達は彼女が公園に入るのを見た。
We presented a watch to him.	私達は彼に時計を贈呈した。
We asked him to come again.	私達は彼にもう一度来てくれるように頼んだ。
We came to a turn in the road.	私達は道が曲がったところに来た。
We closed the discussion.	私達は討議を終えた。
We used to go to the movies on Saturday evening.	私達は土曜の夜はいつも映画に行ったものです。
We were all present at her wedding.	私達は全員彼女の結婚式に出席していました。
We are against war.	私達は戦争に反対だ。
We want to know the facts.	私達は真実が知りたいんだ。
We boarded the ship.	私達は乗船した。
We must provide for the future.	私達は将来に備えなければならない。
We love our children.	私達は自分の子供たちを愛しています。
We call on her now and again.	私達は時たま彼女を訪ねる。
We called on him last night.	私達は昨夜彼をたずねた。
We had a party last night.	私達は昨夜パーティーをした。
We took turns driving.	私達は交替で運転した。
We had a good time in the open air.	私達は戸外で楽しく過ごした。
We can call English an international language.	私達は英語を国際語と呼ぶことができます。
We study English, and that subject is important today.	私達は英語を学ぶが、それは今日では重要な科目だ。
Should we get up earlier?	私達はもっと早く起きるべきだろう。
We played a lot of games at the party.	私達はパーティーでいろいろなゲームをした。
We met him on the way there.	私達はそこへ行く途中で彼に会った。
We met him on the way there.	私達はそこにいく途中で彼に会った。
We are to meet at Yurakucho at seven.	私達は７時に有楽町で会うことになっている。
We are to meet at seven.	私達は７時に会うことになっている。
We talked over our problems.	私達は、自らの問題について話し合った。
There are a lot of stars larger than our own Sun.	私達の太陽より大きな星はたくさんある。
Our holiday plans are still up in the air.	私達の休暇の計画はまだ決まっていない。
Let's ask some questions.	私達にいくつか質問させてください。
Wouldn't you like to come with us, too?	私達と一緒にいらっしゃいませんか。
It is becoming important for us to know how to use a computer.	私達がコンピューターの使い方を知る事は重要になってきている。
It is very important for us to know each other.	私達がお互いに知り合うことはとても大切だ。
We're going to the movies. Are you game?	私達、映画に行くのだけど。いっしょに行く気ありますか。
Don't let me down.	私を落胆させないでくれ。
Let me in, please.	私を中に入れてください。
I have a lot of friends to help me.	私を助けてくれる友人はたくさんいる。
Let me go!	私に行かせて。
Don't let me down.	私をがっかりさせないでくれ。
You and I are both students at this school.	私も貴方も二人ともこの学校の学生です。
I love music, too.	私も音楽が大好きです。
I like English, too.	私も英語が好きです。
He added that I should come to the party, too.	私もパーティーに来るべきだ、と彼はつけ加えた。
I've heard a lot about that, too.	私もそのことについて多くの事を聞いています。
I get off there, too.	私もそこで降ります。
I think so, too.	私もそう思う。
I want to have a part-time job, too.	私もアルバイトしたいなあ。
I am seventeen years old, too.	私も１７歳です。
I majored in history.	私は歴史を専攻した。
I'm interested in history.	私は歴史に興味がある。
I'm interested in history.	私は歴史に関心がある。
I'm interested in history.	私は歴史に関心を持っています。
I work for a travel agency.	私は旅行代理店で働いています。
I meant to have come.	私は来るつもりだったのですが。
I have two children to support.	私は養わなければならない子供が２人いる。
I didn't meet any of my friends.	私は友達のだれにも会わなかった。
I met a friend.	私は友達に会った。
I have a few friends.	友達なら少しいるよ。
I became a director.	私は役員になった。
I was watching TV at night.	私は夜にテレビを見ていた。
I like light colors.	私は明るい色が好きです。
I didn't turn off the light.	私は明かりを消さなかった。
I heard my name called.	私は名前が呼ばれるのを聞いた。
I was forced to sign my name.	私は無理矢理署名させられた。
I bought a camera free of tax.	私は無税でカメラを買った。
I'm the youngest in the family.	私は末っ子です。
I go home early every day.	私は毎日早く家へ帰る。
I don't really look at it that way.	私は本当はそのように考えていない。
I meant what I said.	私は本気でそういったのだ。
I put the book down and turned on the light.	私は本を置いて明かりをつけました。
I will follow the law.	私は法律にたずさわろう。
When I heard it, I was dumbfounded.	私は呆気にとられた。
I am a Hyogo University student.	私は兵庫大学の学生です。
I've written a lot of stories.	私は物語をたくさん書いた。
I don't like traveling by air.	私は飛行機の旅が好きではない。
I was moved by her love for other people.	私は彼女の他の人々に対する愛に感動した。
I had to take care of her baby.	私は彼女の赤ん坊の世話をしなければならなかった。
I called her office, but no one answered.	私は彼女の事務所へ電話してみましたが、誰もでませんでした。
I heard her to the end.	私は彼女の言い分を最後まで聞いてやった。
I followed her into the room.	私は彼女に付いて行き、その部屋に入った。
I ran into her in the street.	私は彼女に町で偶然出くわした。
I am going to let her do as she likes.	私は彼女に好きなようにさせるつもりだ。
I want to talk to her.	私は彼女と話したい。
I have to talk with her about the new plan.	私は彼女とその新しい計画について話し合わなければならない。
I saw her enter the room.	私は彼女が部屋に入るのを見た。
I didn't notice her going out of the room.	私は彼女が部屋から出て行くのに気がつかなかった。
I have known her since she was a baby.	私は彼女が赤ん坊のころから知っています。
I have known her since she was a child.	私は彼女が子供のころから知っています。
I couldn't figure out what she was talking about.	私は彼女が何のことを話しているのかわからなかった。
I saw her enter the room.	私は彼女がその部屋に入るのを見た。
I have never heard her say 'No'.	私は彼女が「いいえ」というのを聞いたことがない。
I have never called on him.	私は彼を訪ねたことは一度もない。
He shall not come here again.	私は彼を２度とここへ来させない。
I like their pictures.	私は彼らの絵が好きです。
I told them to study harder.	私は彼らにもっと勉強するように告げた。
I saw them enter the bank.	私は彼らがその銀行に入るのを見た。
I charged them too much money for their room.	私は彼らがあの部屋に泊まるのに、お金を請求しすぎた。
I am shorter than he.	私は彼より背が低い。
I'm younger than he is.	私は彼より若いんですよ。
I am two years younger than he.	私は彼より2歳若い。
I asked him if he would go too.	私は彼も来るかとたずねた。
I don't like the way he talks.	私は彼の話しぶりが好きではない。
I do not like the way he talks.	私は彼の口のききかたが嫌いだ。
I followed him.	私は彼の後ろに付いて行った。
I can't figure out what he is saying.	私は彼の言っている言葉がよく分からない。
I could not make out what he meant.	私は彼の言いたいことがわからなかった。
I gave him a few books.	私は彼に本を数冊与えた。
I met him on the street.	私は彼に通りで会った。
I haven't met him in person, but I know of him.	私は彼に直接会ったことはありません。でも、彼のことは知っています。
I answered for him.	私は彼に代わって応えた。
I asked him a question.	私は彼に質問を尋ねた。
I asked a question of him.	私は彼に質問をした。
I bought him a magazine.	彼に雑誌を買ってあげた。
I must study hard in order to keep up with him.	私は彼に後れを取らないように一生懸命勉強せねばならない。
I have something that I want to say to him.	私は彼に言いたいことがある。
I have met him before.	私は彼に会ったことがある。
I couldn't put up with him.	私は彼には我慢がなりませんでした。
I am no match for him.	私は彼にはかなわない。
I asked him not to drive so fast.	私は彼にそんなにスピードを出さないでくれと頼みました。
I couldn't make him understand it.	私は彼にそれを理解させることができなかった。
I asked him to come at eight, but he turned up at nine.	私は彼に８時に来てくれと言ったが、彼は９時に現れた。
I would like to talk to him face to face.	私は彼と面と向かって話したい。
I parted from him on the street.	私は彼と通りで別れた。
I have to talk with him about the new plan.	私は彼とその新しい計画について話し合わなければならない。
I am to meet him there.	私は彼とそこで会うことになっている。
I am to meet him at six.	私は彼と６時に会うことになっている。
I saw him enter the room.	私は彼が部屋に入るのを見た。
I have known him since he was a baby.	私は彼が赤ちゃんの時から知っている。
I know the house where he was born.	私は彼が生まれた家を知っている。
I've never seen him really get down to work.	私は彼が真面目に仕事に取り掛かるのを今までみたことがない。
I didn't notice him go out.	私は彼が出て行く事に気がつきませんでした。
I was banking on him to help me.	私は彼が私を助けてくれるものと当てにしていた。
I was banking on him to help me.	私は彼が私を助けてくれるものだと当てこんでいた。
I can't understand what he wants me to do.	私は彼が私に何をするよう望んでいるのか理解できない。
I can't understand what he is thinking about.	私は彼が考えていることが理解できない。
I can figure out what he is trying to say.	私は彼が言おうとしていることが分かる。
I think he is the greatest artist of the time.	私は彼が現代最高の芸術家だと思う。
I saw him enter the house.	彼が家に入るのを見た。
I couldn't figure out what he meant.	私は彼が何を言っているのか理解出来なかった。
I couldn't figure out what he was talking about.	私は彼が何について話しているのか分からなかった。
I learned a lot from him.	私は彼からたくさんのことを学んだ。
I may be too old.	私は年をとりすぎたかもしれない。
I'm not always free on Sundays.	私は日曜日は必ずしも暇というわけではない。
I was forced to work on Sunday.	私は日曜日に働かされた。
I am never at home on Sundays.	私は日曜日に家にいることはありませんよ。
I'm never at home on Sundays.	私は日曜日にはいつも家にいない。
I am not always at home on Sundays.	私は日曜日にいつも家にいるわけではない。
I'm not always at home on Sundays.	私は日曜日にいつも家にいるとは限らない。
I am always at home on Sundays.	私は日曜日にいつも家にいる。
I am not always free on Sundays.	私は日曜日いつも暇であるとは限らない。
I am interested in Japanese history.	私は日本史に興味がある。
I am interested in Japanese history.	私は日本の歴史に興味がある。
I saw a movie for the first time in two years.	私は二年ぶりに映画を見た。
I will never do it again.	私は二度とそれをしないつもりです。
I feel good in a special way.	私は特別気持ちがいい。
I work in a special unit.	私は特殊部隊に勤務する。
I bought a book about animals.	動物についての本を買ったよ。
I am reading a book about animals.	私は動物に関する本を読んでいる。
I was born and brought up in Tokyo.	私は東京生まれの東京育ちです。
I have a few friends in Tokyo.	私は東京に数人の友人がいる。
I was born and brought up in Tokyo.	私は東京で生まれ育った。
I really like city life.	私は都会の生活が本当に好きだ。
I met Tom on the way.	私は途中でトムに会った。
I was brought up in the country.	私は田舎で育てられた。
I'm used to working all night.	私は徹夜で働くのに慣れている。
I work hard in the garden.	私は庭で熱心に働く。
I met her on the street.	私は通りで彼女と会った。
I met Fred on the street.	私は通りでフレッドに会った。
I haven't heard from her for a long time.	私は長い間彼女から便りをもらっていません。
I think of her day and night.	私は昼も夜も彼女のことを考えている。
I saw the figure of a man.	私は男の姿を見た。
I found the key for which I had been looking.	私は探していた鍵を見つけた。
I was born in Osaka, but was brought up in Tokyo.	私は大阪生まれですが、東京で育ちました。
I was born in Osaka.	私は大阪の生まれです。
I was born in Osaka, but brought up in Tokyo.	私は大坂生まれですが、東京で育ちました。
I was born in Osaka.	私は大阪生まれです。
I majored in European history at university.	私は大学ではヨーロッパ史を専攻しました。
I'm majoring in American history at university.	私は大学でアメリカの歴史を専攻しています。
I came to know many university students.	私は多くの大学生と知り合うようになった。
I had to study hard to keep up with the other students.	私は他の生徒に遅れないように一生懸命に勉強しなければならなかった。
I tried to run fast.	私は速く走ろうとした。
I read a most interesting book in my library.	私は蔵書のうち、とてもおもしろい本を読んだ。
I read the most interesting book in my library.	私は蔵書のうち、いちばんおもしろい本を読んだ。
I'm not used to getting up early.	早起きには慣れてないんだ。
I'm used to getting up early.	私は早起きするのになれている。
I'm not used to getting up early.	私は早起きすることになれていない。
I had to get up early.	私は早く起きなければならなかった。
I do not get up early.	私は起きるのが遅い。
I got up early.	私は早く起きた。
I didn't want to get up early.	私は早くおきたくありませんでした。
I met him the day before.	私は前日彼にあった。
I met Jane the other day.	私は先日ジェーンに会った。
I met him this day last week, that is, the 25th of June.	私は先週の今日、すなわち、６月２５日に彼に会った。
I worked hard last month.	私は先月一生懸命働きました。
I have a new red car.	私は赤い新車を持っている。
I like blue best of all colors.	私は青色が一番好きです。
I'm not a student.	私は生徒ではありません。
I'll never see him again as long as I live.	私は生きている間は決して再び彼とは会わない。
I am interested in old cities in the world.	私は世界の古い都市に興味を持っています。
I'll be visiting Japan again in a few years.	私は数年したら再び日本を訪れることになるでしょう。
On my way to the library I met my friend.	私は図書館へ行く途中で友達に会いました。
I want to better understand what the meaning of life is.	私は人生の意味とは何かをもっとよく理解したい。
I'm against people driving big cars.	私は人が大きな車を乗り回すのに反対だ。
I don't care too much for hot food.	私は辛い食物はあまり好きではない。
I am a new student.	私は新入生です。
I am really pleased with my new car.	私は新車がとても気に入っている。
I built a new house.	私は新しい家を建てた。
I want to buy a new camera.	私は新しいカメラを買いたい。
I got a new camera.	私は新しいカメラを手に入れた。
I was born and brought up in Matsuyama.	私は松山に生まれて育った。
I have a few books.	私は少し本を持っています。
I have few books.	私は少ししか本を持っていません。
I don't know what is in store for me in the future.	私は将来自分に何が用意されているか知らない。
I thought about the future.	私は将来の事を考えた。
I work for a trading company.	私は商社で働いています。
I heard a call for help.	私は助けを求める呼び声を聞いた。
I'm in charge of the book department.	私は書籍売り場を担当している。
I met him for the first time.	私は初めて彼にあった。
I ran as fast as I could.	私は出来るだけ速く走った。
I put up with her as long as I could.	私は出来る限り、彼女に我慢した。
I'm going to Paris in the fall.	私は秋にパリへ行く予定です。
I had a hard time making both ends meet.	私は収支を合わすのに苦労しました。
I don't have any good reference book at hand.	私は手もとによい参考書を持っていない。
I was young, and I wanted to live.	私は若かった、そして私は生きたかった。
I didn't feel like buying a car.	私は車を買う気がしない。
I turned right.	私は車のハンドルを右に切った。
I want to see the director of the company.	私は社長に会いたいのです。
I'm very interested in social studies.	私は社会科にはたいへん興味をもっています。
I am interested in taking pictures.	私は写真を撮る事に興味がある。
I heard my name called.	私は自分の名前を呼ばれるのを聞いた。
I heard my name called.	私は自分の名前が呼ばれるのを聞いた。
I could hear my name called.	私は自分の名前が呼ばれるのが聞こえた。
I want to have a talk with him about my future.	私は自分の将来について彼と話したい。
I thought over my future.	私は自分の将来についてじっくり考えた。
I did it against my will.	私は自分の意志に反してそれをした。
I'm interested in creating my own web pages.	私は自分のホームページを作ることが趣味です。
I like to think I know what I'm talking about.	私は自分が何をしゃべっているのかわかっているつもりです。
I read books and magazines to keep up with the times.	私は時代に遅れないようにするため本や雑誌を読む。
I meet her at school now and then.	私は時折学校で彼女に会う。
I meet him from time to time.	私は時々彼にあいます。
I meet him at the club from time to time.	私は時々クラブで彼に会う。
I bought a watch.	私は時計を買いました。
I found my watch broken.	私は時計が壊れているのに気付いた。
I meet him at school now and then.	私は時おり学校で彼に会う。
I made the fact known to all my friends.	私は事実を友達全員に知らせた。
I know it for a fact.	私は事実としてそれを知っている。
I heard my name called.	自分の名前を呼ばれるのが聞こえた。
I think with my head.	私は私の頭で考える。
I had my picture taken.	私は私の写真をとってもらいました。
I'm looking for my camera.	私は私のカメラを探しています。
I have to think of my children.	私は子供達のことを考えなければならない。
I loved reading when I was a child.	私は子供のころ読書が大好きだった。
I bought the book which the children need.	私は子供たちに必要な本を買った。
I don't have any children.	私は子供がいません。
I still have a lot of work to do.	私は仕事をたいぶためてしまった。
I continued working.	私は仕事をし続けた。
I work hard and play hard.	私は仕事も遊びも一生懸命やる人です。
I am reading a magazine.	私は雑誌を読んでいます。
I watched TV last night.	昨夜はテレビを見てました。
I watched TV at six last night.	私は昨日の夜の６時にテレビを見ました。
I'm old and not too well.	私は歳を取って体の具合が良くない。
I couldn't understand him at first.	私は最初に彼の言うことがわからなかった。
I saw him again.	私は再び彼に会った。
I never turn my back on a friend in need.	私は困っている友達を決して見捨てようとはしない。
I am going to watch TV this evening.	私は今晩テレビを見るつもりです。
I mean to be there this evening.	私は今晩そこへ行くつもりです。
I don't feel like working today.	私は今日働く気がしない。
I bought many books today so I put them in order.	私は今日、たくさん本を買ったので、それらを整頓した。
I am on holiday this week.	私は今週はお休みです。
I am on holiday this week.	私は今週お休みです。
I don't feel like going out right now.	私は今は外へ出たくない。
I am learning her name still, too.	私は今でも彼女の名前を覚えている。
I am not now in a position to help you.	私は今あなたを助けられる境遇ではない。
I have never been to the U.S.	私は合衆国に行ったことがない。
I'm a high school student.	私は高校生です。
I have never been to Hiroshima.	私は広島へ行ったことがない。
I met Ken at the park.	私は公園でケンに会いました。
I'll follow.	私は後からついていきます。
I traded in my old car for a new one.	私は古い車を下取りに出して新車を買った。
I, for one, don't like pictures like this.	私は個人的にこういう絵が好きではない。
I am content with my current position.	私は現在の地位に満足している。
Never did I tell her that I loved her.	私は決して彼女に彼女が好きだとは言っていない。
I never try to go to there.	私は決してそこへ行こうとしない。
I'll never let you down.	私は決してあなた失望させません。
I'll never let you down.	私は決してあなたを失望させません。
I never give up.	私は決してあきらめません。
I want to make you work harder.	私は君をもっと一生懸命働かせたいと思います。
I didn't want to bring you in.	私は君をまき込みたくなかった。
I'm much younger than you.	私は君よりもずっと若い。
I know the person you are talking about.	私は君の言っている人を知っている。
I have never been to Kyushu.	私は九州へ行ったことが無い。
I'm going to the bank.	私は銀行に行きます。
I have to go to the bank.	銀行に行かなければいけないんです。
I opened my account with the bank.	私は銀行に口座を開いた。
I work for a bank.	私は銀行で働いています。
I worked for a bank.	私は銀行で働いていました。
It was brought home to me how important education is.	私は教育の重要性を痛感した。
It was brought home to me how important education is.	私は教育がいかに重要であるかを痛感しました。
I was born in Kyoto.	私は京都で生まれた。
I heard about it from another source last year.	私は去年、それを別の筋から聞いた。
I am running short of memory.	私は記憶力が不足している。
I am running short of memory.	私は記憶が不足している。
I received a welcome.	私は歓迎をうけた。
I received a good job offer.	私は割のいい仕事の申し入れを受けた。
I kept company with him since we were students.	私は学生の時から、彼と親しくつき合っている。
I am a student.	私は学生です。
I am a student, but he isn't.	私は学生だが彼はちがう。
I met him on my way to school.	私は学校へいく途中彼に会った。
On my way home from school I met her.	私は学校から帰宅の途中彼女に会った。
I met him on my way from school.	私は学校から帰る途中で彼に会った。
I met Tony on my way home from school.	私は学校から家に帰る途中にトニー君に出会った。
I met him on my way home from school.	私は学校からの帰り道で彼に会った。
I did say that, but I didn't mean it.	私は確かにそう言ったが、そのつもりではなかった。
I never go out without buying something.	私は外出すると必ず何かを買ってしまう。
I was not present at that meeting.	私は会議には出席しなかった。
I worked hard in order to support my family.	私は家族を養うために懸命に働いた。
I took a picture of my family.	私は家族の写真を撮った。
I felt something move in the house.	私は家の中で何かが動くのを感じた。
I met one of my friends on my way home.	私は家に帰る途中で私の友人の一人に会った。
I met her on my way home.	私は家に帰る途中、彼女に会いました。
I have met him many times.	私は何度も彼に会ったことがある。
I tried again and again.	私は何度もやってみた。
I tried the problem again and again.	私は何度もその問題に挑戦した。
I want to see her by any means.	私は何とかして彼女に会いたい。
I can hear something.	私は何か聞こえます。
I felt something moving on my back.	私は何かが背中で動いているのを感じた。
I talked about music.	私は音楽について話した。
I am interested in music.	私は音楽に興味があります。
I am very interested in music.	私は音楽にたいへん興味をもっている。
I am in the music club.	私は音楽クラブに入っています。
I was born in Yokohama.	私は横浜で生まれました。
I played an important part in the garden party.	私は園遊会で大切な役目を果たした。
I bought an English book, but the book was hard to understand.	私は英語の本を買ったが、その本はわかりにくかった。
I have a few English books.	私は英語の本を少し持っている。
I have few English books.	私は英語の本をほとんど持っていない。
I am interested in English.	私は英語に興味があります。
I don't understand English.	私は英語がわかりません。
I haven't heard from him for a long time.	私は長いこと彼から便りをもらっていません。
I feel like going to the movies.	私は映画を見に行きたい気がする。
I love movies.	私は映画が大好きです。
I don't care for moving pictures.	私は映画が好きでない。
I am contented with my lot.	私は運命に満足している。
I just moved.	私は引っ越してきたばかりです。
I haven't heard of him since then.	私はそれ以来彼の消息は聞いていない。
I have never been to Kushiro.	私は一度も釧路に行ったことがありません。
I have never been to Europe.	私は一度もヨーロッパへ行ったことがありません。
I have never been to America.	私は一度もアメリカに行ったことがありません。
I turned off the TV because I had seen the movie before.	私は一度その映画を見たことがありましたのでテレビを消しました。
I am studying very hard.	私は一生懸命勉強している。
I am an only child.	私は一人っ子です。
I hear Mr Inoue has put up at that hotel.	私は井上氏がそのホテルに泊まったと聞いた。
I like all films that Juzo Itami directs.	私は伊丹十三監督の全ての映画が好きです。
I have met him before.	私は以前彼に会ったことがある。
I have seen the picture before.	私は以前にその絵を見たことがある。
I am a student at London University.	私はロンドン大学の学生です。
I met her in London for the first time.	私はロンドンで初めて彼女に会った。
I turned off the radio.	私はラジオを消した。
I heard it on the radio.	私はラジオでそれを聞いた。
I heard the news on the radio.	私はラジオでそのニュースを聞いた。
I turned on the lights.	私はライトをつけた。
I've got too much to do.	私はやるべきことを山積みにしている。
I was forced to go.	私はやむなく行った。
I will have to study harder.	私はもっと勉強しなければならないだろう。
I won't see her again.	もう彼女には会わないよ。
I will never see him.	私はもう彼に会わないだろう。
I am no longer a child.	私はもう子供ではありません。
I can't put up with this any longer.	私はもう我慢できない。
Each time I see Mary, I learn something new and important from her.	私はメアリーに会うたびに、彼女から何か新しくて重要なことを学ぶ。
I have just been to the Midori Bank.	私はみどり銀行に行ってきたところなんです。
I don't know yet.	私はまだ分かりません。
I have not heard from her yet.	私はまだ彼女からのたよりがない。
Now that I am well again, I want to study space science in college.	私はまた元気になったのだから、大学では宇宙科学を勉強したい。
I have still to hear that story.	私はまだそのはなしは聞いてない。
I can't feel at home in a hotel.	私はホテルではくつろげない。
I can't feel at home in a hotel.	私はホテルでくつろいだ気になれない。
I have never gone to Florida.	私はフロリダへは行ったことがありません。
I am going to major in French.	私はフランス語を専攻するつもりです。
I am very interested in French.	フランス語にはとても興味があります。
I love French films.	私はフランス映画が大好きです。
I found the building.	私はビルを見つけた。
I can run as fast as Bill.	私はビルと同じくらい速く走れます。
I am good friends with Bill.	私はビルと仲良しです。
I'm going to Hawaii by ship.	私はハワイへ船で行きます。
I very much like going to parties and meeting people.	私はパーティーに行って人に会うのがとても好きだ。
I will see to it that you meet her at the party.	私はパーティーで彼女に会えるように取り計らいます。
I have something or other to tell him.	私はなにやら彼に話さなければならないことがある。
I would not part with that picture for all the world.	私はどんなことがあってもその絵を手放すことはしません。
Above all, I take care of my health.	私はとりわけ健康に注意している。
I am talking with Tom.	私はトムと話しています。
I am never free on Sundays.	私はどの日曜日も暇でない。
I asked Tony a question.	私はトニー君に質問した。
I'd like to talk with Tony.	トニー君と話をしたいのですが。
I am having a very hard time.	私はとても困っているのです。
I don't know which to choose.	私はどちらを選ぶべきかわからない。
I'm easy.	私はどうでも構わない。
I really don't want to go.	私はどうしても行きたくない。
For the life of me I can't understand what you say.	私はどうしても君の言う事が理解できない。
I don't have any time to watch TV.	私はテレビを見る時間がありません。
I like watching TV.	私はテレビを見るのが好きだ。
I'd like to watch TV.	私はテレビを見たい。
I like to watch TV.	私はテレビが好きだ。
I will try as hard as I can.	私はできるだけ一生懸命やっているつもりだ。
I worked as hard as possible.	私はできるかぎり熱心に働いた。
At last, I found out the answer to the question.	私はついにその問題の答えを出した。
I met him just as he was coming out of school.	私はちょうど学校から出てくるところで彼にあった。
I was chosen as a member of the team.	私はチームの一員に撰ばれた。
I have a lot of pictures.	私はたくさん写真を持っています。
I will bring back a lot of food.	私はたくさんの食物を持って帰ろう。
I wanted to get a lot of money.	私はたくさんのお金を手に入れたかった。
I have a lot of cameras.	私はたくさんカメラを持っている。
I have never heard of him since then.	私はそれ以来彼のうわさを聞いたことがない。
I felt better to hear that.	私はそれを聞いてほっとした。
Never did I think of it.	私はそれを思っても見なかった。
That sounds good to me.	私はそれでもかまいませんよ。
That story made me think over the future of Tokyo.	私はその話を聞いて東京の将来について考えさせられた。
I found the question very easy.	私はその問がたいへんやさしいことを発見した。
I had two copies of the book.	私はその本を二冊もっていた。
I found the book very interesting.	私はその本を大変面白いと思いました。
I read the book over and over again.	私はその本を何度も読んだ。
I want to buy a copy of the book, but it is out of print.	私はその本を１冊買いたいが、その本は絶版になっている。
I found the book easy.	私はその本が易しいということがわかった。
I found the book interesting.	私はその本が面白いとわかった。
I found the book easy.	私はその本が簡単だとわかった。
I found the book easy.	私はその本が易しいことが読んで分かった。
I found the book easy.	私はその本がやさしいとわかった。
I found the book easy.	私はその本がやさしいという事がわかった。
I liked the book so much I ordered ten copies for friends.	私はその本がとても好きだったので友人のために１０冊注文した。
I found the book interesting.	私はその本がおもしろいことにきづいた。
I found the story interesting.	私はその物語をおもしろいと思った。
I am not in the least interested in the story.	私はその物語には全然興味がない。
I tried to call on my memories of that day.	私はその日の記憶を呼び覚まそうとした。
I know the name of this animal.	私はその動物の名前を知っている。
I asked many persons about the store, but no one had heard of it.	私はその店のことを多くの人に尋ねたが、聞いたことがある人はだれもいなかった。
I met the man, who showed me the way.	私はその男に会った。すると彼は私に道を教えてくれた。
I saw the man enter the room.	私はその男が部屋へ入るのをみた。
I met him on the previous day.	私はその前日彼にあった。
I like that young man.	私はその若者が好きだ。
I looked at the picture.	私はその写真を見ました。
I thought the questions were easy.	簡単な質問だと思った。
I have not heard from her since then.	私はその時以来、彼女から便りをもらっていません。
I had met her many times before then.	私はその時以前に何度も彼女に会ったことがあった。
I had never seen her before that time.	私はその時までに彼女に会ったことがありませんでした。
I was watching TV then.	私はその時、テレビを見ていました。
I haven't known the fact up to now.	私はその事実を今まで知らなかった。
I joined the study tour.	私はその視察旅行に加わった。
I found the work very interesting.	その仕事はとてもおもしろいことがわかった。
I did not study both of the languages.	私はその言語両方とも勉強したわけではなかった。
I looked for the key.	私はその鍵を探した。
I will answer for the result.	私はその結果に責任を負うつもりだ。
I put the plan into practice.	私はその計画を実行に移した。
I don't know all of the students.	私はその学生たち全員を知っているわけではない。
I applied for a position in the office.	私はその会社に職を求めた。
I was moved by the music.	私はその音楽に感動しました。
I want to see the movie.	私はその映画を見たい。
I saw the movie on video.	私はその映画をビデオで見た。
I have seen the film before.	私はその映画を以前に見たことがある。
I saw the movie five times.	私はその映画を５回見た。
I couldn't figure out how to do it.	私はそのやり方がわからなかった。
I met a Smith at the party.	私はそのパーティーで、スミス家の人に会った。
I have heard of it before.	私はそのことについて以前に聞いたことがある。
I want to enter the club.	私はそのクラブに入会したい。
I have a lot of work to do.	私はするべき仕事がたくさんあります。
I couldn't answer all the questions.	私はすべての質問に答えられたわけではない。
I could answer all the questions.	私はすべての質問に答えられた。
I want to buy the same watch as Jack has.	私はジャックが持っているのと同じような時計を買いたい。
I have a lot of work to do.	私はしなければならない仕事がたくさんあります。
I visited the house in which Shakespeare was born.	私はシェイクスピアが生まれた家を訪れた。
I have a large body of information in my computer database.	私はコンピューターのデータベースに大量の情報を持っています。
I am interested in computers.	コンピューターに興味があるんだよ。
I found the broken camera.	私はこわれたカメラを見つけました。
I am very interested in these stories.	私はこれらの話に非常に興味があります。
I will study English hard from now on.	私はこれからは英語を一生懸命勉強します。
I am interested in this story.	私はこの話が面白い。
I read this book again and again.	この本は何度も読みました。
I think this book is easy.	私はこの本はやさしいと思う。
I am interested in this book.	私はこの本が面白い。
I want to let this room to a student.	私はこの部屋を学生に貸したい。
I can't understand the meaning of this word.	私はこの単語の意味がわからない。
I put this question to him.	私はこの質問を彼にした。
I found it easy to answer this question.	私はこの質問に答えるのはやさしいとわかった。
I bought this watch at the store.	私はこの時計をあの店で買った。
I really have to do this work today.	私はこの仕事を今日どうしてもしなければならない。
I don't know what this word means.	私はこの言葉が何を意味するのか知りません。
I am against this project.	私はこの計画に反対です。
I am a student of this school.	私はこの学校の生徒です。
I compared this picture with that picture.	私はこの絵とあの絵を比較した。
I can never see this movie without being moved.	私はこの映画を見ると必ず感動する。
I was moved by this movie.	私はこの映画に感動した。
I would like to get a camera like this.	私はこのようなカメラを買いたいと思います。
I can't understand this at all.	私はこのことを少しも理解できません。
I don't like this camera.	私はこのカメラは気に入りません。
I saw a man with a child.	私はこどもを連れた人に会いました。
I have a few friends here.	私はここに友達が数人いる。
I can run faster than Ken.	私はケンよりも速く走ることが出来ます。
I gave my vote to Ken.	私はケンに投票した。
I am older than any other student in my class is.	私はクラスの中で最年長である。
I am not used to hard work.	私はきつい仕事には慣れていない。
I told him to come the following day.	私はかれに明日来なさいと言った。
I will apply for help to him.	私はかれに助けを求めよう。
I pointed my camera at her.	私はカメラを彼女に向けた。
I have two cameras.	私はカメラを２つ持っている。
I'm short of money.	私はお金不足だ。
I'm short of money.	私はお金を使い果たした。
I am short of money.	私はお金に困っている。
I am short of money.	私はお金が不足している。
I am running short of money.	私はお金が足りなくなってきた。
I did the work against my will.	私はいやいやその仕事をした。
I always get up at six.	私はいつも六時に起きます。
I have always kept my word.	私はいつも約束を守った。
I always have to give in to him.	私はいつも彼に服従しなければならない。
I don't always get up early.	私はいつも早く起きるわけではない。
I always get up early.	私はいつも早く起きる。
I was always good at English.	私はいつも英語が得意でした。
I always get up at six.	私はいつも６時に起きる。
I have never been to England.	私はイギリスへ行ったことがありません。
I asked Ann if she were a student.	私はアンに、君は学生ですかと尋ねた。
I had a man build me a house.	私はある人に家を建ててもらった。
I need all money possible.	私はありとあらゆるお金を必要としている。
I ran as fast as I could.	私はありったけの力を出して走った。
I am an American student.	私はアメリカ人の学生です。
I love American movies.	私はアメリカ映画が大好きだ。
I have never been to the States.	私はアメリカへ行ったことがありません。
I have never gone to America.	私はアメリカにいったことがない。
I was born in America.	私はアメリカで生まれた。
I know some students in that school.	私はあの学校の生徒を何人か知ってます。
I meant to have called on you.	私はあなたを訪問するつもりだったができなかった。
I am shorter than you.	私はあなたよりも背が低い。
I'm three years younger than you.	私はあなたより３歳若い。
I can't run as fast as you.	私はあなたほどに速くは走れません。
I met your friend.	私はあなたの友達と会った。
I'm on your side.	私はあなたの味方です。
I can not answer your question.	私はあなたの質問に答えることができない。
Can I watch your next game?	私はあなたの次の試合を見る事が出来ますか。
I don't know both of your children.	私はあなたの子供を２人とも知っているわけではない。
I do not understand you.	私はあなたの言っていることがわからない。
I don't understand what you are saying.	私はあなたのおっしゃることが分かりません。
I have something to ask of you.	私はあなたに頼みたいことがいくつかあります。
I'm about to tell you the answer.	私はあなたに答えを教えてあげようとしているところです。
I want you to come back early.	私はあなたに早く帰って来てもらいたい。
I have some pictures to show you.	私はあなたに見せる写真がある。
I never meant to have you pay the bill.	私はあなたに勘定を持ってもらうつもりはなかった。
I will show you the picture.	私はあなたに絵を見せましょう。
Let me give you an example.	私はあなたに一例を示しましょう。
I want to talk to you.	私はあなたと話がしたいなぁ。
I bought the same camera as you have.	あなたが持っているのと同じカメラを買った。
I have received no reply from you yet.	私はあなたからまだ返事をもらっていません。
I will see to it that you meet her at the party.	私はあなたがパーティーで彼女に会えるように取り計らいます。
I've never heard you talk like that.	私はあなたがそんなふうに話すのを聞いたことがない。
I watched X-files the movie.	私はＸ―ファイルザムービーを見ました。
I was in an IAA meeting.	私はＩＡＡのミーティングに行った。
I had to choose between A and B.	私はＡかＢのどちらかを選ばなくてはならない。
I'll meet them at six.	私は６時に彼らに会うつもりだ。
I was meeting Bob at six.	私は６時にボブに会う予定だった。
I am in charge of the third-year class.	私は３年生を受け持っている。
I can run the fastest of the three.	私は３人の中で一番速く走ることができます。
I have turned 20.	私は２０歳になったところです。
I was in New York for a few days.	私は２、３日ニューヨークにいた。
I put off writing for over a month.	私は１ヶ月以上手紙を書くのを伸ばしていた。
I was born in 1979.	私は１９７９年に生まれた。
I was born in Osaka in 1977.	私は１９７７年に大阪で生まれた。
I was born in Osaka on March 5, 1977.	私は１９７７年３月５日に大阪で生まれた。
I was born on the twenty-second of June in 1974.	私は１９７４年の６月２２日に生まれました。
I was born on June 4, 1974.	私は１９７４年６月４日に生まれた。
I was born on October 10, 1972.	私は１９７２年１０月１０日に生まれました。
I was born in Tokyo in 1968.	私は１９６８年東京で生まれた。
I was born on January 2 in 1968.	私は１９６８年の１月２日に生まれた。
I was born on March 22, 1962.	私は１９６２年３月２２日生まれです。
I was born in 1960.	私は１９６０年生まれだ。
I was born on April 3, 1950.	私は１９５０年４月３日に生まれた。
I was born in Tokyo on the eighth of January in 1950.	私は１９５０年１月８日に東京で生まれました。
I was born on the 22 of November 1948.	私は１９４８年１１月２２日に生まれました。
I was born in Hiroshima in 1945.	私は１９４５年に広島で生まれました。
I was born on the 31st of May in 1940.	私は１９４０年５月３１日に生まれた。
I work for a travel agency.	私は、旅行会社に勤めています。
Never have I seen her before.	私は彼女に会ったことはない。
I let him go.	私は、彼を行かせた。
I had him take my picture.	私は、彼に写真を撮ってもらった。
I had lived in Osaka for eighteen years when I moved to Tokyo.	私は、東京へ移り住むまで、１８年間ずっと大阪に住んでいた。
I'm used to getting up early.	私は早起きになれている。
I am a student.	私は学校に通っています。
I am human.	私は、人間です。
I had my picture taken.	私は、自分の写真を撮ってもらった。
I am on holiday this week.	私は、今週休みです。
I ran as fast as possible.	私はできるだけ速く走った。
I found the new magazine very interesting.	私は、その新しい雑誌が大層面白いとわかった。
I was born in Kyoto in 1980.	私は１９８０年に京都で生まれた。
I became a member of the club in 1980.	私は１９８０年にそのクラブの会員になった。
My watch runs too fast.	私の腕時計は少し進む。
Hear me out, please.	私の話を最後まできちんと聞いてください。
Please take care of my baby while I am out.	私の留守中赤ちゃんの面倒を見て下さい。
My friends aren't young.	私の友達は若くはありません。
My friend said he had bought a new watch.	私の友達は、新しい時計を買った、と言った。
Few of my friends have two cars.	私の友達で車を２台持っているものはほとんどいない。
My problems are very similar to yours.	私の問題はあなたの問題によく似ている。
My name is Robert, so they call me Bob for short.	私の名前はロバートなので、皆は略してボブと呼びます。
I heard my name called.	私の名前が呼ばれるのが聞こえました。
I was called into the office first, my name being at the head of the list.	私の名前がリストの一番上にあったため私が最初にオフィスに入るように呼ばれた。
My real address is as follows.	私の本当の住所は下記の通りです。
My room faces east.	私の部屋は東向きです。
My room faces the garden.	私の部屋は庭に面している。
My room looks out on the street.	私の部屋は通りに面している。
My room is just above.	私の部屋はちょうどこの上です。
My room is just below.	私の部屋はこの真下です。
There is a radio in my room.	私の部屋にラジオがある。
I have a magazine in my room.	私の部屋には雑誌がある。
My answer will be all right.	私の答えで良いと思う。
I have only a small garden.	私の庭には狭い庭しかない。
Our city has no water service yet.	私の町にはまだ水道が無い。
My old car brought me $100.	私の中古車は１００ドルで売れた。
He has never come on time that I know of.	私の知っている限りでは彼は時間どおりに来たことがない。
Will you go to the meeting in my place?	私の代わりにその会に行ってくれませんか。
You are welcome to any book in my library.	私の蔵書の中のどんな本でも自由に使っていいですよ。
History is my major.	私の専攻は歴史です。
You're welcome to any book in my library.	私の図書は自由にお使い下さい。
My new book is not yet in print.	私の新しい本はまだ出版されていない。
My new address is as follows.	私の新しい住所は、次の通りです。
You are welcome to any book in my library.	私の書斎の本は自由に使ってください。
You are welcome to any book in my library.	私の書斎のどの本でも自由にお使い下さい。
Don't let go of my hand.	私の手を離してはいけません。
My car broke down on the way.	私の車は途中で故障した。
Answer me.	私の質問に答えなさい。
Please answer my question.	私の質問に答えて下さい。
My watch isn't running right.	私の時計は正確に動いていない。
My watch keeps very good time.	私の時計は時間がたいへん正確である。
My watch is broken.	私の時計は狂っている。
My watch is running all right.	私の時計はきちんと動いている。
My watch is different from yours.	私の時計はあなたのと違う。
It is just nine by my watch.	私の時計では今ちょうど九時です。
My time has not yet come.	私の時はまだ来ていません。
My business has at last gotten on the right track.	私の事業もようやく軌道に乗りました。
My children really like animals.	私の子どもたちは動物が大好きです。
My job is taking care of the baby.	私の仕事は赤ん坊の世話をする事です。
My work is not complete yet.	私の仕事はまだ未完成です。
My job is taking care of the baby.	私の仕事はその赤ん坊の世話をすることです。
Let me say what I think.	私の考えを言わせて下さい。
Please follow me.	私の後に付いてきて下さい。
You see what I mean?	私の言っている意味が分かりますよね。
The time will come when you will understand what I mean.	私の言おうとすることがお前にもわかるときが来るだろう。
I mean it.	本気で言ってるんです。
Do you see what I mean?	私の言う意味が分かりますか。
Please answer me.	私の言うことに答えてください。
Can you hear me?	私の言うことが聞こえますか。
Hear what I have to say.	私の言い訳を聞いてくれ。
Do you know what I mean?	私の言いたいことが分かりますか。
What will you give me at my wedding?	私の結婚祝に何くれる？
Are you against my plan?	私の計画に反対ですか。
My holiday plan has fallen through.	私の休日の計画はだめになった。
Charge it to my account.	私の勘定につけておいてください。
My house faces to the south.	私の家は南向きです。
My house is on the south bank of the Thames.	私の家はテムズ川の南岸にある。
My house is a little way from the street.	私の家はその通りから少し入ったところだ。
I have only a small garden.	私の家には狭い庭しかない。
My radio has broken down again.	私のラジオはまた故障した。
You're welcome to any book in my library.	私のところの図書は自由にお使い下さい。
My watch doesn't keep good time.	私のとけいは時間が正確ではありません。
My class is made up of forty students.	私のクラスには４０人の生徒がいます。
My camera is the same as your camera.	私のカメラは君のと同じだ。
My camera is a Nikon.	私のカメラはニコンです。
My camera is different from yours.	私のカメラはあなたのとは違う。
My camera is much better than yours.	私のカメラはあなたのカメラよりずっといい。
Charge this to my account.	私のカードにつけておいてくれ。
I can figure out what he is trying to say.	私のいわんとしていることは理解できる。
The building was still there in my time.	私のいたころはまだその建物はありました。
My e-mail address has been changed as follows.	私のｅ―ｍａｉｌアドレスは下記に変わりました。
I'm going to have a baby.	私に赤ちゃんができるんですよ。
Give me a few.	私に少しください。
Follow me.	私についてきて。
Let me help you.	私に手伝わせてください。
She asked me to bring them.	私に持ってってくれって頼んだの。
Let me help you with your work.	私に仕事を手伝わせて下さい。
Let me go!	私に行かせてください。
Don't answer me back.	私に口答えするな。
Please let me know.	私に教えてください。
As for me, I have no question.	私に関して言えば、何の質問もありません。
Don't talk to me!	私に何も話しかけないで！
Let me have a try.	私にやらせてみてくれ。
Will you let me at it?	私にやらせてくれない？
Please let me know about it.	私にもそれを知らせて下さい。
I have no friend to talk with.	私には話をする友達がいない。
I understand her, but on the other hand I don't think she's right.	私には彼女の気持ちもわかるが、また一面では彼女が正しいとも思わない。
I couldn't understand what he was getting at.	私には彼が何をほのめかしているのかわからなかった。
I've no friend to talk to about my problems.	私には悩みを相談できる人がいないのです。
I have a lot of questions to answer.	私には答えなければならない質問がたくさんある。
I have a few friends to talk for a long time on the phone with.	私には長電話をする友達が２、３人いる。
I hear from him every now and then.	私には時々彼からの便りがある。
Let me go my own way.	私には私の道を行かせて下さい。
I have a lot of work to do.	私には仕事がたくさんある。
I have no face to turn to.	私には合わせる顔がない。
I didn't understand the meaning of the last line but one.	私には下から２行目の意味がわからなかった。
I need the following items.	私には以下の品物が必要である。
I have a lot of work to do.	私にはするべき仕事がたくさんある。
I don't know what that word means, but I'll try to find out.	私にはあの単語がどんな意味かわからないが、考えてみよう。
Follow me and I will show you the way.	私について来なさい、道を教えます。
Let me take a look.	私にちょっと見せて下さい。
Let me have a look at it, will you?	私にちょっとみせてくださいよ。
Don't ask me so many questions. Use your head.	私にそんなにたくさん質問するな。自分の頭を使え。
Let me have a try at it.	私にそれをやらせてみてください。
Please let me try it again.	私にそれをもう一度させてください。
Let me do it.	私にそれをさせてください。
Please let me try the game.	私にそのゲームをさせてください。
Please answer this question for me.	私の代わりにこの問題を解いてください。
I have much in common with him.	私と彼は共通することが多い。
Both he and I were members of that club.	私と同様に彼もクラブのメンバーだった。
You are no younger than I am.	私と同様にあなたも若くない。
Please join me in welcoming Dr Smith to our team.	私と一緒に、スミス博士を我がチームに歓迎してください。
It is five years since we moved here.	私どもが当地に引っ越してから５年になる。
For my part, I don't like this picture.	私としては、この絵が嫌いです。
You and I have something in common.	私と、あなたには共通点がある。
If I were you, I'd put the money in a bank.	私だったら、そんなお金は銀行に預けるよ。
Let us go, please.	私たちを行かせてください。
If you can put up with us, put us up.	私たちを我慢できるなら泊めて下さい。
We must have something to fall back on.	私たちは頼りになるものを何か持たなければならない。
We will have lived in Kyoto for eight years next March.	私たちは来年の３月で８年間京都に住んだことになります。
We shall do this free of charge.	私たちは無料でこれをします。
We use a lot of water every day.	私たちは毎日多くの水を使用する。
We watch TV every day.	私たちは毎日テレビを見ます。
We use a lot of water every day.	私たちは毎日たくさん水を使います。
We were just about to enter the room.	私たちは部屋に入ろうとしていた。
We are traveling to France by air.	私たちは飛行機でフランスに向かっています。
We saw her enter the room.	私たちは彼女が部屋にはいるのをみた。
We love her, and she loves us, too.	私たちは彼女が好きですが、彼女のほうも私たちが好きです。
We chose a good present for each of their children.	私たちは彼らの子供一人一人に立派な土産を選びました。
We showed him some pictures of London.	私たちは彼にロンドンの写真を見せた。
We were never to see her again.	私たちは二度と彼女にあえない運命だった。
We go to the South of France for a change of air.	私たちは南フランスへ転地療養に行く。
We were born on the same day.	私たちは同じ日に生まれた。
We are going to have a party on Saturday night.	私たちは土曜日の晩にパーティーを開くつもりです。
We talked over the phone.	私たちは電話で話をした。
We haven't met for ages.	私たちは長い間会っていない。
Every one of us is more or less interested in art.	私たちは誰でも、多かれ少なかれ芸術に興味を持っている。
We took turns driving on the way to Osaka.	私たちは大阪まで交替で運転した。
We took care of our children by turns.	私たちは代わる代わる子供たちの面倒を見た。
We asked many persons about the new store, but no one had heard of it.	私たちは多くの人に新しい店について尋ねたが、そのうわさを聞いた者は誰もいなかった。
I take it that we are to come early.	私たちは早く来なければならないと思う。
We were all present at her wedding.	私たちは全員彼女の結婚式に出席しました。
We were all present at her wedding.	私たちは全員彼女の結婚式に出ていました。
We have seen three wars.	私たちは戦争を３回経験した。
We must pay the tax.	私たちは税金を納めなければならない。
We are thinking of moving back home.	私たちは生まれ故郷に引っ越そうかと考えています。
We have the right to vote when we come of age.	私たちは成年に達すると選挙権を手にする。
We have come to know what is going on in the world faster and faster.	私たちは世界の情勢をますます速く知るようになった。
We're saving up to build a new house.	私たちは新しい家を建てるために貯金をしている。
Each of us read the book in turn.	私たちは順番にその本を読んだ。
We have to get as much information as possible.	私たちは出来るだけたくさんの情報を集めなければいけません。
We want to put our money to good use.	私たちは私たちのお金を有効に活用したい。
We have known each other since we were children.	私たちは子供のころからお互いに知り合いです。
We had a good time last night.	私たちは昨夜楽しい時を過ごした。
We are to meet him at seven this evening.	私たちは今夜７時に彼に会うことになっている。
We are high school students.	私たちは高校生です。
We found it hard to change the plan.	私たちは計画を変更するのは難しいと分かった。
We found it hard to change the plan.	私たちは計画を変更するのは難しいと思った。
We found it hard to change the plan.	私たちは計画を変更することはむずかしいと分かった。
We are making plans for the holidays.	私たちは休暇の計画を立てています。
We made a check of the student' records.	私たちは学生の成績の照合をした。
We are students.	私たちは学生です。
We were all present at the meeting.	私たちは皆会に出席していた。
All of us talk in English.	私たちは皆英語で話す。
All of us want to live as long as possible.	私たちは皆できるだけ長く生きたいと思います。
We had to put off the meeting.	私たちは会合を延期しなければならなかった。
We must have something to live for.	私たちは何か生きていく目標をもたねばならない。
We must have something to live for.	私たちは何か生きがいを持たなければならない。
We learned that English is an international language.	私たちは英語が国際語であることを知った。
We are going to the movies. Come with us.	私たちは映画に行くんですよ。一緒においでなさい。
We're going to the movies.	私たちは映画に行くところです。
We must work hard.	私たちは一生懸命働かなければならない。
We had always been close.	私たちは一緒にいた。
We want the committee to work out this problem.	私たちは委員会がこの問題を解決するよう望んでいます。
We have to turn in our reports by the end of this month.	私たちはレポートを今月末までに提出しなければならない。
We turned on the radio.	私たちはラジオをつけた。
We used to talk about our future.	私たちはよく将来のことについて話し合ったものだ。
We will be seeing you again before long.	私たちはやがてまたあなたにお目にかかるでしょう。
We tried it again, but couldn't do it.	私たちはもう一度それをやってみたが、できなかった。
We were all present at the meeting.	私たちはみな会議に出席していた。
We're going to come again.	私たちはまた来るつもりです。
We had words again last night.	私たちはまた昨夜また口論をした。
We were forced to work hard.	私たちはひどく働かなくてはならない。
We live within easy access of Heathrow.	私たちはヒースロー空港にすぐ行ける所に住んでいる。
We studied the road map of the country around Paris.	私たちはパリ周辺地方の道路地図を調べた。
We are watching TV.	私たちはテレビを見ています。
We found the key at last.	私たちはついに鍵を見つけた。
We had a long discussion as to what to do about it.	私たちはそれをどうしたらよいかについて長い議論をした。
We haven't heard from her since then.	私たちはその時以来、彼女から便りをもらっていない。
We took part in the discussion.	私たちはその議論に参加しました。
We were looking at the picture.	私たちはその絵をながめていた。
We met him on the way there.	私たちはそこへ行く途中で彼に出会った。
We met him on the way there.	私たちはそこに行く途中に彼にであった。
We have a lot of work to do.	私たちはするべき仕事がたくさんある。
We talked for some time.	私たちはしばらくの間話をした。
We learned at school that Shakespeare was born in 1564.	私たちはシェイクスピアは１５６４年に生まれたということを学校で学んだ。
We have supplied those families with food.	私たちはこれまでそれらの家族に食べ物をあげてきました。
We must read this book again and again.	私たちはこの本を何度も何度も読まなければなりません。
We are the students of this school.	私たちはこの学校の生徒です。
We could understand each other.	私たちはお互い理解し合えた。
We should try to understand one another.	私たちはお互いを理解してみるべきだ。
We are short of money.	私たちはお金が足らない。
We always looked down on him.	私たちはいつも彼を軽蔑した。
We used to meet on our way to school.	私たちはいつも学校へ行く途中で待ち合わせた。
We'll always be friends.	私たちはいつまでも友達同士でいましょう。
We'll welcome you at any time.	私たちはいつでもあなたを歓迎します。
We were welcomed at every turn.	私たちはいたるところで歓迎された。
We were made to copy some English words.	私たちはいくつかの英単語を書き写させられました。
We have too many classes.	私たちはあまりにも多くの授業がある。
We were to have met there at seven.	私たちは７時にそこで会うことになっていたのですが。
We are to meet at six.	私たちは６時に集まることになっています。
We have to pay taxes by March 15.	私たちは３月１５日までに税金を払わなければならない。