Wrong.	違うんだ。
Trust me!	任せて！
Search me.	さあね。
See below.	下を見ろ。
I wrote it.	私が書いた
I'm fine.	私は元気です。
I trust you.	任せるよ。
Nor can I.	私もできない。
Forget it.	気にしないで。
Please come.	来て下さい。
He is happy.	彼は幸せだ。
I wonder who.	誰かしら。
Time flies.	時早く過ぎる。
Nor am I.	私もそうなのです。
I am happy.	私は幸福です。
I feel cold.	寒気がする。
How fast!	何て速いんだろう。
He grew old.	彼は年老いた。
I trust you.	信じているよ。
Plants grow.	植物が生える。
I feel happy.	私は幸せだ。
Don't worry.	心配しないで。
I'll be fine.	大丈夫です。
X was wrong.	Xがいけなかった
It proves X.	それがXを証する
I feel fine.	僕はいい気分だ。
He grew old.	彼は年を取った。
Years passed.	年月が経った。
Fine. And you?	うん、君は？
Don't be a dog.	卑屈な奴。
Get the dream.	夢をつかめ！！
She is happy.	彼女は幸せです。
Forget him.	彼の事は忘れなさい。
I will join it!	出席します。
Time presses.	時間が押してる。
I'm fine too.	私も元気ですよ。
I felt cold.	私は寒いと感じた。
I forgot it.	私はそれを忘れた。
I bought it.	私はそれを買った。
I like dogs.	私は犬が好きです。
Check it out!	君も見てごらん！
Without a doubt!	疑い無く！
I hear music.	音楽が聞こえる。
Happy New Year!	よいお年を。
All are happy.	みんな幸せだ。
I wonder why.	なぜなんだろう。
I'm worn out.	つかれ果てたよ。
This is a dog.	これは犬です。
Ken is happy.	ケンは幸福です。
Ken is happy.	ケンは幸せです。
You are wrong.	お前が悪いよ。
That is mine.	あれが私のです。
Check, please.	勘定書を頼むよ。
Are you ready?	用意はいいかい。
Close your eyes.	目を閉じて。
I'm patient.	僕は我慢強いたちだ。
He seems kind.	彼は親切そうだ。
Get on a horse.	馬に乗せてよ。
Don't worry.	心配しなくていいよ。
Please get in.	乗ってください。
Help me, please.	助けてくれ。
Time flies.	時は飛ぶように過ぎる。
I am ready.	私は覚悟ができている。
I saw a dog.	私は一匹の犬を見た。
We are happy.	私たちは幸福です。
Are you happy?	君は幸せですか。
Am I wrong?	俺は間違っているのか。
It saved me.	おかげで助かったよ。
I feel happy.	私は幸せに感じる。
Call the police!	警察を呼んで！
Open your eyes.	目を開けなさい。
Open your eyes.	目を開きなさい。
Their eyes met.	目と目が合った。
Dreams came true.	夢は叶った。
I'm so happy.	僕はとてもうれしい。
Listen to this!	聞いて、聞いて！
I have a cold.	風邪をひきました。
It's just a cold.	風邪ですね。
She is beautiful.	美人だなあ。
She felt blue.	彼女は憂鬱だった。
She has brains.	彼女は頭がよい。
They are happy.	彼らは幸せです。
He writes books.	彼は作家です。
He has a dog.	彼は犬を飼っている。
Cross the street.	通りを渡れ。
Time flies.	時のたつのは早いものだ。
I have a dog.	私は犬を飼っている。
My dog is white.	私の犬は白い。
We got ready.	私たちは用意をした。
I was wrong.	私が間違っていました。
Please don't die!	死なないで。
How time flies!	光陰矢のごとし。
What a surprise!	何という驚き。
Check, please.	お勘定して下さい。
I can only wait.	待つしかない。
He is determined.	彼が意を決する
Stand up, please.	立って下さい。
Close your eyes.	目を閉じなさい。
Open your eyes.	目を開けてみろよ。
Don't trust him.	彼を信用するな。
He was ruled out.	彼は問題外だ。
He can run fast.	彼は速く走れる。
He was patient.	彼は辛抱強かった。
He's beyond help.	彼は救い難い。
He killed him.	彼はその男を殺した。
The waves are high.	波が高い。
There is no doubt.	絶対確実だ。
Check, please.	清算をお願いします。
Do it yourself.	自分でやりなさい。
We buy CDs.	私たちは、ＣＤを買います。
It's cold today.	今日は寒いです。
I'm doing fine.	元気でやってるよ。
No pain, no gains.	苦は楽の種。
You look green.	顔色がよくないよ。
How is everyone?	皆さんはお元気？
Please back me up!	応援してね！
It's very cold.	ひどく冷えるなあ。
Speak clearly.	はっきり話しなさい。
What a surprise!	なんとゆう驚き。
That's the spirit.	その調子だ。
I like the dog.	その犬が好きです。
Grow up, Joe.	ジョー、大人になれよ。
I broke a glass.	グラスを割った。
Please be seated.	お座り下さい。
Nothing special.	いや特にないわ。
This is my dog.	あれは私の犬です。
You were mine.	あなたは私の物です。
What was wrong?	何が悪かったんだろう
I regard it as X.	Xだと私が見做す
I'm worried about X.	Xが心配だ
Close your eyes.	目を閉じてごらん。
Dreams come true.	夢はかないます。
How's your sister?	妹さんは元気？
May I join you?	僕も一緒にしていい？
I have a cold.	僕は風邪を引いている。
She avoids me.	彼女は私を避けている。
She looks happy.	彼女は幸せそうだ。
He was ruled out.	彼は除外された。
He got me wrong.	彼は私を誤解した。
He has a cold.	彼は風邪をひいている。
He died suddenly.	突然彼は死んだ。
I feel just fine.	特別いい気分だ。
Answer the phone.	電話にでなさい。
The earth is round.	地球は丸い。
How you've grown!	大きくなったね。
I'll wait for you.	待ってあげる。
Get ready quickly.	早く用意して。
Over my dead body.	絶対にダメだ。
Hold on, please.	少々お待ち下さい。
I keep a dog.	私は犬を一匹飼ってます。
I'm very happy.	私はとても幸福です。
I have a dream.	私には夢があります。
It's fine today.	今日は天気が良い。
Attention please!	御知らせします。
The dog is dead.	犬は死んでいるよ。
What a surprise!	驚いたなあ・・・。
Please make sure.	確かめてくれよ。
The sea is down.	海が静かになった。
Give me some skin!	握手しようぜ！
I'm dead to love.	愛情を感じない。
Lynn runs fast.	リンは走るのが速い。
All were happy.	みんなが喜んでいた。
Tony was happy.	トニーは幸せでした。
Its color is red.	それの色は赤い。
This is a picture.	これは絵です。
This dog is big.	この犬、大きいよ。
For here, please.	ここで食べます。
I have a cold.	かぜを引いているんだ。
Watch yourself.	お行儀が悪いですよ。
That dog is big.	あのイヌは大きい。
We enjoy talking.	話を楽しんでいる。
No pain, no gain.	労なくして益なし。
The food is cold.	料理が冷えてます。
Happy New Year!	明けましておめでとう。
How is your cold?	風邪の具合はどう？
The wind has fallen.	風が凪いだ。
They seem happy.	彼らは幸せそうです。
He is a work horse.	彼は働き者だ。
My brain is full.	頭の中がいっぱい。
Keep early hours.	早寝早起きをする。
Some water, please.	水をください。
The floor gave way.	床が崩壊した。
Please take one.	自由にお持ち下さい。
Please help me.	私を手伝ってください。
Send me there.	私をそこにやって下さい。
I bought a book.	私は本を買いました。
I wrote a letter.	私は手紙を書いた。
I have a dog.	私は１匹の犬を飼っている。
My dogs are white.	私の犬達は白い。
I booked a seat.	座席を予約しました。
It is fine today.	今日はいい天気だ。
Save your breath.	言わなくていいよ。
Keep the dog out.	犬を中に入れるな。
No dogs allowed.	犬の連れ込みを禁ず。
Ken's dog is white.	健の犬は白い。
Check, please.	勘定書を持ってきてくれ。
Go to your posts.	各自の部署に就け。
I listen to music.	音楽を聴きます。
Do you like music?	音楽が好きなの？
Apply within.	応募の方はお入りください。
Please try one.	一度食べてみて下さい。
How happy I am!	わたしはとても楽しい。
Order, please.	みなさん、どうか静粛に。
I'm feeling fit.	ぼくはすごく元気だ。
Tom can run fast.	トムは速く走れる。
How complex?	どのぐらい複雑なのだろうか。
I feel very cold.	とても寒いですね。
Which is mine?	どちらが私のものですか。
Please come in.	どうぞ、お入り下さい。
The dog is white.	その犬は白いです。
May you be happy!	ご多幸を祈ります。
Help yourself.	ご自由にお取りください。
This doesn't fit.	これは合いません。
That car is mine.	あの車は私のです。
SOS, please help!	ＳＯＳ助けてくれ。
I wonder about X.	Xの方がどうかと思う
He takes pictures.	彼が写真を撮影する
That's the spirit.	良し、その意気で。
We keep late hours.	夜更かしをする。
The wind died away.	風がおさまった。
How many samples?	標本はいくつですか。
She is cold to me.	彼女は私に冷淡だ。
She became happy.	彼女は幸福になった。
She looks happy.	彼女は幸せに見えます。
You can trust him.	彼を信用していい。
He waits on her.	彼は彼女に仕えている。
He has a good brain.	彼は頭がいい。
He can be trusted.	彼は信用できます。
He wrote a letter.	彼は手紙を書いた。
He took a picture.	彼は写真を撮った。
He pressured me.	彼は私に圧力をかけた。
He was laid off.	彼は一時解雇にされた。
He wore glasses.	彼は眼鏡をかけていた。
He slept an hour.	彼は１時間ねむった。
He can be trusted.	彼なら間違いない。
Make way, please.	道を空けてください。
I hear the phone.	電話が鳴っています。
Please look for it.	探してください。
Please explain it.	説明してください。
I have to dress up.	正装しなければ。
I'm more than happy.	十分に幸せだ。
Next person, please.	次の方どうぞ。
Please look at me.	私を見てください。
I have a daughter.	私には娘がいます。
I bought a book.	私は一冊の本を買った。
I can but wait.	私はただ待つだけの事だ。
Where is my seat?	私の席はどこですか。
We like music.	私たちは、音楽が好きです。
I wish I was dead.	死んでしまいたい！
It is fine today.	今日は良い天気です。
It's very cold now.	今はとても寒い。
I'm very happy now.	今とても幸せだ。
Don't get me wrong.	誤解しないでよ。
Fall from reality.	現実から逃げ出す。
Ken looks happy.	健は楽しそうに見える。
You do me wrong.	君は私を誤解している。
I'm feeling fine now.	気分がよい。
I don't exist to you.	眼中にない。
Enjoy yourself!	楽しんでいってください。
Look at the picture.	絵を見なさい。
What did you buy?	何を買ったのですか。
Do you like music?	音楽は好きですか。
Take the right road.	右の道を行け。
May I join you?	一緒に行っていいですか。
Betty killed him.	べティは彼を殺した。
How cold it is!	なんて寒いことでしょう。
Tom is a good sort.	トムはいい人だ。
Please have a try.	どうぞやってみて。
Hold on, please.	ちょっとお待ち下さい。
It isn't mine.	それは私のではありません。
The dog was dead.	その犬は死んでいた。
Please hold on.	そのままでお待ち下さい。
Single, please.	シングルにしてください。
Everything is fine.	これで結構です。
This car is mine.	この車はわたしのだ。
Here is your dog.	ここに君の犬がいる。
A dog was running.	いぬが走っていた。
Ten days passed by.	１０日間たった。
He set a goal.	彼がひとつ、目標を掲げました
Everyone avoided X.	Xを皆が避けました
Please come again.	またお越しください。
Mind your manners.	礼儀正しくしなさい。
I am round shouldered.	僕は猫背だ。
How's your cold?	風邪の具合はどうですか。
I have a bad cold.	風邪がひどいのです。
It's a beautiful day.	美しい日です。
I wonder who she is.	彼女は誰かしら。
She is dark-skinned.	彼女は色が黒い。
She looks happy.	彼女は幸せそうに見える。
She is wrong.	彼女のいうことは間違っている。
He was very happy.	彼は大変幸せだった。
He enjoys good health.	彼は健康だ。
He is hard to please.	彼は気難しい。
He runs very fast.	彼はとても速く走る。
Keep off the flies.	蝿をたからせるな。
Please let me know.	知らせてください。
Anyone can do it.	誰にでもそれは出来る。
I get out of breath.	息切れがします。
Happy New Year!	新年おめでとうございます。
Let's take a picture.	写真を撮ろう。
Respect yourself.	自分を大切にしなさい。
Don't pass me over.	私を無視しないで。
I bought a new car.	私は新車を買った。
I bought a watch.	私は時計を買いました。
I see with my eyes.	私は私の目で見る。
That's fine with me.	私は結構ですよ。
I bought that car.	私はその車を買った。
I bought that car.	私はあの車を買った。
I slept nine hours.	私は9時間眠った。
I like the cold.	私は、冷たいものが好き。
Get me my glasses.	私のめがねを取って。
He cut me dead.	私に全く知らんふりをした。
I wish myself dead.	死にたいくらいだ。
Don't get me wrong.	誤解しないでくれ。
May you be happy.	御多幸をお祈りします。
You broke the rule.	君は規則を破った。
Is the bank open?	銀行は開いていますか。
You are beautiful.	あなたたちは美しい。
Don't take chances.	危ない事はするな。
I do feel the cold.	寒さが身にしみる。
Make yourself at home.	楽にしてね。
Kings have long arms.	王の腕は長い。
Please get dressed.	着替えてください。
Please come again.	また来てくださいね。
Another day passed.	また１日が過ぎた。
I'm kind of happy.	ま、ちょっと幸せだ。
I'm about ready.	ぼくは大体用意ができた。
Happy Halloween!	ハローウィンおめでとう。
Tom changed color.	トムは顔色を変えた。
Who is this, please?	どちら様ですか。
Don't run so fast.	そんなに速く走るな。
Can you prove it?	それを証明できますか？
It's free of charge.	それは無料です。
It was ages ago.	それは何年も昔のことだ。
I was happy then.	そのときは幸せでした。
Jane looks happy.	ジェーンは楽しそうだ。
This book is mine.	この本は私の本です。
This book is mine.	この本は私の物です。
I love this picture.	この写真大好き。
This is my daughter.	こちらは娘です。
Please let us know.	お知らせください。
I'll kill him.	あいつの息の根を止めてやる。
We are gaining a day.	１日遅れます。
I must buy one.	１台買わなければならない。
Please study here.	ここで勉強しなさい。
X is on page 14.	Xが１４ページに御座います
I really like music.	本当に音楽が好きだ
X protects my earth.	Xが僕の地球を守る
He gets one ready.	彼がそれを１本用意する
He is worn with age.	老齢で弱っている。
A promise is a promise.	約束は約束。
Is something wrong?	問題でも起きたのか。
The dream came true.	夢は本当になった。
I am getting a cold.	風邪引いたみたい。
I have a head cold.	鼻風邪をひきました。
She gained her end.	彼女は目的を達した。
She held her breath.	彼女は息を殺した。
She has a round face.	彼女は丸顔です。
She's an eye-opener.	彼女はすごい美人！
He lacks common sense.	彼は非常識だ。
He made her happy.	彼は彼女を幸福にした。
He made her happy.	彼は彼女を幸せにした。
He bought a new car.	彼は新車を買った。
He has two dogs.	彼は犬を２匹飼っています。
He lacks experience.	彼は経験不足だね。
He has a good memory.	彼は記憶が良い。
He was all wrong.	彼は完全に間違っていた。
He saw he was wrong.	彼は過ちを悟った。
He is beyond hope.	彼はもう見込みがない。
How fast he runs!	彼はなんと速く走るんだ。
He was very happy.	彼はとても幸せだった。
He runs very fast.	彼はたいそう速く走る。
He is always happy.	彼はいつも幸せです。
Please call him up.	彼に電話して下さい。
He gave me a cold.	彼にかぜをうつされた。
Let's cross the street.	道を渡ろう。
Don't move, please.	動かないでください。
They'll kill me.	奴等に殺されてしまいます。
Join us, won't you?	仲間に入りませんか。
Who wrote a letter?	誰が手紙を書いたの。
I'm gaining weight.	体重が増えています。
Take one's temperature.	体温を計る。
Take a deep breath.	息を深く吸いなさい。
Move along, please.	前に進んでください。
Move along, please.	前に行ってください。
A green light is on.	青信号が出ている。
I'll buy a new one.	新しいものを買おう。
Apply in writing.	書面でお申し込み下さい。
In fact, I am happy.	実際幸せなのです。
How time flies!	時間はなんて早く過ぎるんだ。
We see with our eyes.	私達は目で見る。
I love music, too.	私も音楽が大好きです。
I have a cold.	私は風邪をひいているんですよ。
I made her happy.	私は彼女を幸福にしよう。
I will buy a car.	私は車を買うつもりです。
I don't like dogs.	私は犬は好きではない。
I'm learning music.	私は音楽を習います。
My father grew old.	私の父は年を取った。
Please let me know.	私に教えてください。
We study music.	私たちは、音楽を勉強します。
No pain, no gain.	骨折りなければ利益なし。
Are you ready to go?	行く用意はいいか。
I'll make you happy.	君を幸せにします。
Will you join us?	君も仲間に入りませんか。
Do you love music?	君は音楽が好きですか。
Aren't you happy?	君はうれしくないのかい？
Aren't you happy?	君はうれしくないですか。
Are seats available?	空席はありますか。
No pain, no gain.	苦労無しには儲けも無い。
Don't worry about it!	気にすんなって。
Are you enjoying it?	楽しんでいますか。
I did write to him.	確かに書きましたよ。
The sea is very wide.	海はとても広い。
No music, no life.	音楽がない人生は無い。
The temperature falls.	温度が下がる。
No need to worry.	悪いところはありません。
Once more, please.	もう１度お願いします。
Boys! Now listen.	みんな。さあ聞きなさい。
Come and join us.	ふるってご参加ください。
I had a bad cold.	ひどい風邪をひいたんだ。
I bought a Picasso.	ピカソの絵を買った。
What a big dog!	なんて大きな犬なんでしょう。
Tom has no manners.	トムは礼儀知らずだ。
Any seat will do.	どの席でもかまいません。
Please don't bother.	どうぞお構いなく。
Please, tell me.	どうぞ、私に話して下さい。
Please let me in.	どうか中に入れて下さい。
Please step back.	どうか下がってください。
Don't walk so fast.	そんなに速く歩くな。
That is surprising.	それは驚くべき事だ。
It's beyond me.	それはとても私には出来ない。
The ship is at sea.	その船は航海中です。
Look at the picture.	その絵を見なさい。
Jane looks happy.	ジェーンは幸福そうです。
Carry this for me.	これを運んでください。
This isn't mine.	これは私のではありません。
Kate has a cold.	ケイトは風邪をひいている。
Kate keeps a dog.	ケイトは犬を飼っている。
You make me happy.	きみは僕を幸せにする。
Charge it, please.	カードでお願いします。
Emi looks happy.	エミは幸せそうに見えます。
I'm getting happy.	いい気分になってきた。
Those dogs are big.	あの犬たちは大きい。
You run very fast.	あなたは大変速く走る。
They passed out.	あいつら酔い潰れちゃった。
$8.50, please.	８ドル５０セントいただきます。
Forty years passed.	４０年が過ぎ去った。
He left an hour ago.	１時間前に出たよ。
Please have a seat.	どうぞおかけ下さい。
I won't tell anyone.	誰にも言わないよ。
I feel wind on my skin.	風を肌に感じる
I use natural oil.	天然のオイルを使用します
He will save the world.	彼が地球を救う
My eyes are watering.	涙が出てきますよ。
My strength is all gone.	力が尽きた。
The food is cold.	料理が冷えてしまっている。
Oil is running short.	油が切れてきたぞ。
Keep your eyes open.	目を開けておくのよ。
All the seats are booked.	満席です。
I wrote this book.	僕がこの本を書いたんだ。
The wind has died down.	風が静まった。
She has fine manners.	彼女は礼儀正しい。
She has blue eyes.	彼女は青い目をしている。
She has a picture.	彼女は写真を持っている。
She is in the wrong.	彼女は間違っている。
She wore glasses.	彼女はめがねをかけていた。
I doubt her words.	彼女の言う事は疑わしい。
He flew to Paris.	彼は飛行機でパリへ飛んだ。
He took a deep breath.	彼は深呼吸した。
He left a while ago.	彼は少し前に去った。
He is a man of ability.	彼は手腕家だ。
He has a cold now.	彼は今かぜをひいている。
He has a good memory.	彼は記憶力がよい。
He bought a Honda.	彼はホンダの車を買った。
He left immediately.	彼はすぐに出発した。
I have three dogs.	私は犬を３匹飼っている。
My hair has grown out.	髪が伸びてきた。
A horse runs quickly.	馬は走るのが早い。
The waves are rising.	波が立ちはじめた。
Look in the phone book.	電話帳をみて。
Let's make a phone call.	電話しよう。
Can I call directly?	直接電話できますか。
Everyone loves him.	誰もが彼を愛している。
Anyone can do it.	誰にだってそれはできます。
Stand on the scales.	体重計に乗りなさい。
Don't put on weight.	太ってはいけません。
The ship was at sea.	船は航海中であった。
Go back to your seat.	席にもどりなさい。
Water reflects light.	水は光を反射する。
I am all but ready.	準備はほぼできている。
I'll call my husband.	主人を呼びますよ。
Go tell him yourself.	自分で話してこい。
Let me in, please.	私を中に入れてください。
I really enjoyed it.	私は本当に楽しんだ。
I met him by chance.	私は彼に偶然会った。
I worry about him.	私は彼が気がかりなのよ。
I have gained weight.	私は体重が増えた。
I can't take the heat.	私は暑さに弱い。
I carried on my work.	私は仕事を続けた。
I have a cold now.	私は今風邪をひいている。
I'll join you later.	私は後から行きます。
I work for a bank.	私は銀行で働いています。
I'm checking out.	私はチェックアウトします。
I made John happy.	私はジョンを幸福にした。
I waited for a time.	私はしばらく待った。
My dream comes true.	私の夢はかないます。
Please follow me.	私の後に付いてきて下さい。
Speak well of the dead.	死者はほめよ。
There's no wind today.	今日は風がない。
It is very cold today.	今日は大変寒い。
Please put in this way.	口添えしてね。
I have bad breath.	私は口臭がひどいのです。
It's a beautiful job.	見事な作品ですね。
Keep away from the dog.	犬に近寄るな。
He works for a bank.	銀行で働いています。
I start in surprise.	驚いてぎょっとする。
Don't you feel cold?	寒さを感じませんか。
Don't worry about me.	俺の心配をするな。
It was fine all day.	一日中上天気だった。
I finally got a job.	やっと就職できたぞ！
Of course I'll wait.	もちろん待ちますよ。
I can't wait any more.	もう待てないよ。
Everyone loves Mac.	みんなマックが好きだ。
Everyone thinks so.	みんなそう思うだろう。
Listen, all of you.	みなさん、聞きなさい。
I need a police car.	パトカーが必要です。
Please come in.	どうぞなかへおとおりください。
Please don't bother.	どうぞおかまいなく。
You do me wrong.	それは私に対する誤解ですよ。
It fell to pieces.	それはばらばらになった。
The car is very fast.	その車は大変速い。
The car is ready.	その車は整備が済んでいる。
Those books are mine.	その本は私のです。
It will be ready soon.	すぐに出来ます。
These dogs are big.	これらのイヌは大きい。
This house is mine.	この家は私のものです。
Where on earth was I?	ここは何処だろう。
It is very cold here.	ここはとても寒い。
Take care of yourself.	お体をお大事に。
I can wait for you.	お前のこと待ってるよ。
Please take your seat.	お掛けください。
When did you buy it?	いつそれを買ったの。
It took half an hour.	３０分で着いたよ。
Let me buy you a drink.	１杯おごろう。
I felt very happy.	私はとても幸福に感じた。
I forgot to ask him.	彼に聞くのを忘れた。
Ages 68 and below.	年齢が６８歳以下の者とする
I bought one of them.	それを１つ買いました
This day finally came.	ついにこの日が来た
Everyone enjoyed X.	Xをみんなが楽しみました
He kept on filming.	彼がずっとカメラを回した
The food is cold.	料理が冷めてしまっています。
Have everything ready.	万事用意しておけ。
Everything is ready.	万事準備ができました。
I can run as fast.	僕も同じくらい速く走れる。
I'm being patient.	僕は今我慢しているんだよ。
I want to buy another.	別なのを買いたい。
The wind grew stronger.	風が強くなった。
The wind has died down.	風がやみました。
Is she your sister?	彼女はあなたの妹ですか。
I can't forget her.	彼女の事が思い切れない。
They must be happy.	彼らは幸せにちがいない。
He wrote the report.	彼は報告書を作文した。
He fell off the horse.	彼は馬から落ちた。
He crossed the street.	彼は道路を渡った。
He was out of breath.	彼は息切れしていた。
He can run so fast!	彼は走るのがとても早い。
He kept early hours.	彼は早寝早起きをした。
He signed the check.	彼は小切手に署名した。
He applied for a job.	彼は仕事に応募した。
He's now on the phone.	彼は今電話中です。
Does he have a dog?	彼は犬を飼っていますか。
He works at a bank.	彼は銀行で働いています。
He was hard to please.	彼は気難しかった。
He is an all-round man.	彼は何でも屋だ。
He died one year ago.	彼は一年前に死んだ。
He has a good memory.	彼はもの覚えがよい。
He can no longer wait.	彼はもう待てない。
He is dead drunk.	彼はひどくよっぱらっている。
How fast he runs!	彼はなんて速く走るんだろう。
Tell him to wait.	彼に待つように言って下さい。
Carry your head high.	背筋を伸ばしなさい。
I'm talking on the phone.	電話中です。
May I use the phone?	電話を拝借できますか。
I'll make a phone call.	電話をかけよう。
How does it fit you?	着心地はいかがですか。
I didn't meet anyone.	誰にも会わなかった。
I wonder who has come.	誰が来たのかしら。
Save your strength.	体力を蓄えておきなさい。
Many cars passed by.	多くの車が通り過ぎた。
I think it will be fine.	晴れると思う。
Do write to me soon!	是非すぐ手紙を下さい。
Don't worry about that.	心配いりません。
Let sleeping dogs lie.	寝た子を起こすな。
Let's write in turns.	順番に書きましょう。
Aren't you ready?	準備はまだ出来ていませんか。
The letter was written.	手紙は書かれた。
Try it out yourself.	自分で使ってみなさい。
I'm killing time.	時間をつぶしているだけです。
All of us are happy.	私達はみんな幸せです。
I have trust in him.	私は彼を信頼している。
I ran a race with him.	私は彼と競走した。
I had a race with him.	私は彼と競争した。
I waited and waited.	私は待ちに待ちました。
I tried to run fast.	私は速く走ろうとした。
I was in good spirits.	私は上機嫌だった。
I met him by chance.	私は偶然彼に出会った。
Let us go, please.	私たちを行かせてください。
I do a lot of worrying.	私、心配性です。
I'm applying for a job.	仕事に応募する。
Manners make the man.	行儀作法が人を作る。
Turn back, please.	後ろ向きになってください。
Go back to your seat.	君の席に戻りなさい。
Please stay close by.	近くにいてください。
Don't worry about it.	気にしないでいいよ。
The sea is not clear.	海がはっきりしない。
I'll buy you a drink.	一杯おごりましょう。
Everyone likes her.	みんなは彼女が好きです。
Please keep in touch.	またお便りください。
My film has run out.	フィルムがなくなった。
How beautiful it is!	なんと美しいんだろう。
What a fine day it is!	なんて晴れた日だ。
Nancy likes music.	ナンシーは音楽が好きです。
What's wrong with me?	どこが悪いのですか。
Let me pass, please.	どうぞ通してください。
Please step inside.	どうぞ中へお入り下さい。
It's no use on earth.	てんで役にたたない。
Check in, please.	チェックインをお願いします。
Can I check in now?	チェックインできますか。
That would be fine.	それで結構だと思います。
The dog began to run.	その犬は走り始めた。
I had a fine old time.	すごく面白かった。
This is Mary's dog.	これはメアリーの犬です。
Am I on the right road?	この道でいいの？
Is this seat taken?	この席は空いていますか？
Look at this picture.	この絵を見て下さい。
Look at the picture.	この絵をごらんなさい。
Carlos turned round.	カルロスは振り返った。
Just water, please.	お水だけでけっこうです。
The dog followed me.	いぬが後についてきた。
How old is that dog?	あの犬はいくつですか。
Look at that picture.	あの絵を見てごらん。
Are your eyes bad?	あなたは目が悪いのですか。
Do you like music?	あなたは音楽が好きですか。
Do it yourself.	あなたが自分でそれをやりなさい。
It's a proven fact.	これは証明済みの事実だ。
I had my eyes checked.	目の検査を受けた。
I don't trust anyone.	私は誰も信用しない。
Am I on the wrong road?	道間違えたかな？
Everyone experiences it.	誰もが経験をする
I am in charge of it.	わたくしが管理をします
It's much faster to buy.	買う方が断然早い
It's only limited to X.	それはXに限ります
Can we talk in private?	話があるんだけど。
Keep in touch, please.	連絡してくださいね。
Check back next week.	来週またご来店下さい。
He had one daughter.	彼には娘が１人いました。
My sister has a job.	妹は仕事を持っています。
I like dogs very much.	僕は犬が大好きです。
I will make you happy.	僕は君を幸せにする。
I'm wrong, am I not?	僕は間違っていますよね？
I'll cover for you.	僕が証人になってあげるよ。
Wait in line, please.	並んでお待ちください。
She kept her eyes off.	彼女は目をそらした。
She made him happy.	彼女は彼を幸せにしました。
She looks very happy.	彼女は大変嬉しそうだ。
She is my elder sister.	彼女は私の姉です。
She looks happy.	彼女は嬉しそうな顔をしています。
She understands music.	彼女は音楽がわかる。
She's Tom's sister.	彼女はトムのお姉さんです。
She's very beautiful.	彼女はたいした美人だ。
You can't trust him.	彼を信用しちゃいけない。
They are all dead.	彼らは皆死んでしまっていた。
He had a kind manner.	彼は親切な態度だった。
He seems a kind man.	彼は親切な人のようです。
He was in good spirits.	彼は上機嫌だった。
He wrote me a letter.	彼は私に手紙を書いた。
He cut me dead.	彼は私に会っても知らんふりをした。
He seems to be happy.	彼は幸福であるようだ。
He lived a happy life.	彼は幸せに暮らした。
He will join us later.	彼はあとから来るよ。
It seems that he's fine.	彼は元気らしい。
He is hard to please.	彼は気難しい人である。
He crossed over the sea.	彼は海を渡った。
How fast he runs!	彼はなんて速く走るのでしょう。
How fast he runs!	彼はなんて早く走るんでしょう。
He drives very fast.	彼はとても速く運転する。
He seems quite happy.	彼はとても幸福そうだ。
He has two daughters.	彼には2人の娘がいる。
He loves dogs above all.	特に犬が好きだ。
Let's join hand in hand.	提携しましょう。
What does it contain?	中に何が入ってますか。
Did anyone call me up?	誰からか電話あった？
Who wrote this book?	誰がこの本を書いたのか。
It has become very cold.	大変寒くなった。
Take care of yourself.	体に気を付けなさい。
He is probably dead.	多分彼は死んだのだろう。
Truth is time's daughter.	真理は時の娘。
Let sleeping dogs lie.	触らぬ神に祟りなし。
Make yourself at home.	勝手に何でも使って。
The wound won't close.	傷がふさがりません。
The heat told on him.	暑さが彼にはこたえた。
Do I need an operation?	手術が必要ですか。
We are husband and wife.	私達は夫婦です。
Please call me Joe.	私をジョーと呼んで下さい。
I like light colors.	私は明るい色が好きです。
I ran out of breath.	私は息を切らせて走った。
I lead a happy life.	私は幸福な生活を送った。
I am far from happy.	私は幸福どころではない。
I bought an old car.	私は古い車を買いました。
I like dogs very much.	犬がとても好きです。
I'm going to the bank.	私は銀行に行きます。
I might be wrong.	私は間違っているかもしれない。
I have a bad cold.	私はひどい風邪を引いている。
I stressed the point.	私はその点を強調した。
I have a big dog.	私はおおきい犬を飼っています。
Please answer me.	私の言うことに答えてください。
Where are my glasses?	私の眼鏡はどこですか。
Bring me my glasses.	私のめがねを持ってきて。
Please give me a call.	私に電話して下さい。
I have two daughters.	私には娘が２人います。
Leave me alone, please.	私にかまわないで。
Do you have any sisters?	姉妹がいますか。
Is this seat taken?	このイスはあいていますか。
Don't phone her now.	今彼女には電話しないで。
The wind is cold today.	今日は風が冷たい。
It is very cold today.	今日はとても寒いね。
Please take this seat.	腰を掛けてください。
Are you ready to go?	行く用意ができているか。
I'm fine. How about you?	元気だよ、君は？
Ken has a white dog.	健は白い犬を飼っている。
You wrote this book?	君がこの本を書いたって？
I met her by chance.	偶然、彼女にあったんだ。
I met her by chance.	偶然、彼女と会ったんだ。
Please go to the bank.	銀行に行って下さい。
Please turn over.	逆さまに向きを変えてください。
Send me the account.	鑑定書を送ってください。
It's a beautiful day!	わあ、いい天気だなー。
They all looked happy.	みな幸福そうだった。
I'll gain weight again!	また太ってしまう！
I'm not ready yet.	まだ準備ができていないんだ。
I sort of like him.	まあ、嫌いでもありません。
Please make the bed.	ベッドを直してください。
Brian looks blue.	ブライアンは憂鬱そうに見える。
Beyond was the sea.	はるか向こうに海があった。
I'll phone you later.	のちほどお電話します。
How beautiful it is!	なんて美しいのでしょう。
What a fine view!	なんて素晴らしい景色でしょう。
Everything is ready.	なにもかも準備ができた。
Tom runs very fast.	トムはとても速く走ります。
It was very beautiful.	とてもキレイでした。
Please turn it on.	どうぞそれをつけてください。
Please think about it.	どうぞお考え下さい。
Please take a seat.	どうぞ、おすわりください。
Please close the door.	ドアを閉めて下さい。
Please open the door.	ドアを開けてください。
Please give me a hand.	ちょっと手を貸して。
Give it to me, please.	それを私にください。
Those books are mine.	そっちの本は私のです。
Please read that book.	その本を読みなさい。
The path is broken.	その道はでこぼこしている。
The property is mine.	その財産は私のものだ。
Where is the bank?	その銀行はどこにありますか。
The picture is on now.	その映画は上映中だ。
Don't worry about that.	そのことで悩むな。
It's all laid on.	すっかりお膳立てができている。
Please go right away.	すぐに行ってください。
John is easy to please.	ジョンは気がいい。
Are you ready to order?	ご注文はよろしい。
This rose is beautiful.	この薔薇は美しい。
Is this seat taken?	この席はふさがってますか。
Where's this seat?	この席はどのあたりでしょう？
Please wait here.	ここで待っていていてください。
Make yourself at home.	お楽にしてください。
Don't worry about it.	いいよ、気にしなくて。
Ann has no sister.	アンには一人も姉妹がいない。
Is that a picture of me?	あれは僕の写真？
Let's check it later.	あとでチェックしよう。
Don't worry about it.	どうぞ気になさらずに。
She works in a bank.	彼女は銀行に勤めている。
He is sure to check.	彼が必ずチェックを入れます
He was wearing glasses.	彼は眼鏡をかけていた
He suddenly looked up.	彼がふと、上を見上げた
Let's all join forces.	みんなの力を結集しよう
"Trust me," he said.	「信用して」と彼は言った。
Our house, our rules.	うちはうち、そとはそと。
Please don't be cold!	邪険にしないで下さいよ！
Do it by yourself.	自分でもそれをやってみなさい。
Open your eyes, please.	目を開けてください。
Your eyes are lying.	目がうそをついていますよ。
Let sleeping dogs lie.	眠れる獅子は起こすな。
I will make you happy.	僕が君を幸せにするよ。
Wait for a second chance.	別の機会を待て。
Please show me another.	別のを見せて下さい。
Please change my room?	部屋を替えてください。
She is my dream girl.	彼女は僕の理想の人です。
She took a deep breath.	彼女は深呼吸をした。
She makes me happy.	彼女は私を幸せにしてくれる。
She sent me a letter.	彼女は私に手紙をくれた。
She almost passed out.	彼女は気絶寸前だった。
She has a round face.	彼女は丸い顔をしている。
How beautiful she is!	彼女は何てきれいなんだ。
She is dead to love.	彼女は愛情のかけらもない。
She's very beautiful.	彼女はとても美しい人だ。
She looks very happy.	彼女はとても幸せそうだ。
Her voice carries well.	彼女の声はよく通る。
He is hard to please.	彼を喜ばせるのは難しい。
Keep a close eye on him.	彼をよく見張れよ。
They study industry.	彼らは、産業を勉強します。
I wonder if he will come.	彼は来るかしら。
He kept an eye on them.	彼は彼らを見張った。
He looks like a horse.	彼は馬のように見える。
He came to suddenly.	彼は突然意識を取り戻した。
He can read and write.	彼は読み書きができる。
He is ready to work.	彼は働く用意ができている。
I wonder if he's at home.	彼は在宅かしら。
He's at church right now.	彼は今礼拝中だ。
He is far from happy.	彼は決して幸せではない。
He's in military service.	彼は軍隊にいる。
He is wearing glasses.	彼は眼鏡をかけている。
He has an eye for art.	彼は絵を見る目がある。
He is playing music.	彼は音楽を演奏しています。
He is given to music.	彼は音楽にふけっている。
He is all but dead.	彼はほとんど死んだも同然だ。
He feels very happy.	彼はとても幸せな気分です。
He is strong as a horse.	彼はとても頑健だ。
He is subject to colds.	彼はすぐ風邪をひく。
He talks too fast.	彼はあまり速くしゃべりすぎる。
Reading has its rules.	読書にはルールがある。
You mind if I join you?	同席してもいいかな。
You are wanted on the phone.	電話です。
I met him in the street.	通りで彼に会った。
Who are you waiting for?	誰を待っているの？
I'd like a window seat.	窓側の席がいいです。
Please close the window.	窓を閉めて下さい。
Please open the window.	窓を開けてください。
War suddenly broke out.	戦争が突然始まった。
Never play on the road.	絶対に道路で遊ぶな。
I hope it will be fine.	晴れるといいですね。
A glass of water, please.	水を一杯下さい。
I'll give you a check-up.	診察しましょう。
Let sleeping dogs lie.	寝ている子は起こすな。
The chances are even.	勝負の見込みは五分五分。
Let me see your wound.	傷口を見せてください。
I can't stand this heat.	暑くてたまらない。
Fall has flown by.	秋はあっという間に過ぎ去った。
I'd like to check in.	手続きをしたいのですが。
Move your car, please.	車を動かしてください。
Go back to your seat.	自分の席にもどりなさい。
Look at the next page.	次のページを見なさい。
How time flies!	時間はなんて早く過ぎて行くのだろう。
Give me a piece of paper.	紙を一枚下さい。
We enjoy reading books.	私達は読書を楽しむ。
We are in good condition.	私達は健康です。
I saw a sleeping dog.	私は眠っている犬を見た。
I do not have a sister.	私には妹がいません。
I had a dream about him.	私は彼の夢を見た。
I waved him back.	私は彼に戻るように手で合図した。
I don't mind waiting.	私は待つのはかまわない。
I was a little surprised.	私は少し驚いた。
I'm writing a letter.	私は手紙を書いています。
I am as happy as can be.	私は最高に幸せだ。
I'll join you later.	私は後で君たちに合流する。
I made my dog lie down.	私は犬を寝転ばした。
I'm happy to see you.	私は君に会えてうれしい。
I worked for a bank.	私は銀行で働いていました。
I talked about music.	私は音楽について話した。
I got a good seat.	私はよい席をとることができた。
My town is by the sea.	私の街は海の側にある。
We see with our eyes.	私たちは目でものを見る。
We lack nothing.	私たちは何ひとつ不自由していない。
I am ready for death.	死ぬ覚悟ができています。
Carry on with your work.	仕事を続けなさい。
I have the blues today.	今日は憂鬱な気分だ。
The waves are high today.	今日は波が高い。
There is no wind today.	今日は全く風がない。
The total is one hundred.	合計は１００だ。
I have high blood pressure.	高血圧です。
It seems out of order.	故障しているようです。
Don't bring the dog in.	犬を中へ連れ込むな。
Ken's dog is very big.	健の犬はとても大きい。
Please call the police.	警察を呼んで下さい。
The police keep order.	警察は秩序を保ちます。
Carry on with your plan.	計画を続けなさい。
You can bank on that.	君はそれを当てにできる。
Your answer is wrong.	君の答えは間違っている。
May I use your phone?	君の電話を借りていいか。
Your voice carries well.	君の声はよく通る。
There was a strong wind.	強風が吹いていた。
The sea was running high.	海は荒れていた。
Could I have the check?	会計をお願いします。
I sort of understand.	何となくはわかりました。
What's worrying you?	何が君を苦しめているのだ？
Can I buy you a drink?	一杯ごちそうしようか。
I ran as fast as I could.	一生懸命走った。
Please do that again.	もう一度やってください。
We got dead drunk.	ベロベロに酔っぱらっちゃった。
Please turn the page.	ページをめくって下さい。
Who wrote Hamlet?	ハムレットは誰が書いたのですか。
What a big dog it is!	なんて大きい犬でしょう。
Why do we have dreams?	なぜ僕らは夢を見るの？
Every seat was full.	どの席もいっぱいであった。
Which dog is yours?	どの犬があなたのものですか。
Who is calling, please?	どちら様でしょうか。
Please turn on the TV.	テレビを付けて下さい。
Please turn off the TV.	テレビを消しなさい。
Just a moment, please.	ちょっと待って下さい。
Everyone is ready.	だれもみんな用意ができている。
The dream has come true.	その夢は実現した。
The boy became happy.	その少年は幸せになった。
Put that in writing.	その事を書面にして下さい。
Please close the door.	その戸を閉めて下さい。
Please open the door.	その戸を開けてください。
Do write to me soon!	ぜひすぐに手紙をください。
It will soon grow dark.	すぐ暗くなるだろう。
Add up these figures.	この数字を合計しなさい。
I am in charge of this.	これは、私の担当だ。
Just don't forget this.	これだけは忘れるな。
This decision is final.	この決定は最終的だ。
Is this seat taken?	この椅子ふさがっていますか。
Kelly eats like a horse.	ケリーは大食漢だ。
He is dead drunk.	ぐでんぐでんに酔っぱらっている。
Make yourself at home.	くつろいでいて下さい。
It's a little cold today.	今日は少し寒い。
Don't touch the glass.	ガラスに手をふれるな。
Your dog is very big.	お宅の犬は大きいですね。
Would you like to wait?	お待ちになりますか。
What size do you wear?	お召しもののサイズは？
Where are your manners?	お行儀はどうしたの？
Who on earth are you?	いったい全体、君は誰か。
Those books are mine.	あっちの本は私の本です。
I wonder who they are.	あの人たちは誰だろう。
Keep away from the dog.	あの犬には近づくな。
You are very beautiful.	あなたは大変美しい。
You have a good memory.	あなたは記憶がよい。
How fast you run!	あなたは何と速く走るのでしょう。
How fast you walk!	あなたは何と速く歩くのだろう。
Check your order.	あなたのオーダーをチェックしろ。
It's on the eighth floor.	８階にあります。
What a memory you have.	君すごい記憶力だね。
Everyone is of one mind.	全員が心を１つにする
So, what should I write?	さて何を書きましょう
He bought a watch/clock.	彼が時計を買いました
X can be clearly seen.	Xが目にはっきりと見える
He drew a picture of X.	彼がXを絵に描きました
My daughter called me.	娘から電話が掛かってきた
Close your eyes, please.	目を閉じてください。
It's like a dream come true.	夢みたいだ。
Let sleeping dogs lie.	眠っている子を起こすな。
Please visit there today.	本日ご覧ください。
I grew up in the country.	僕は田舎で育った。
I can wait no longer.	僕はもうこれ以上待てない。
I have many abilities.	僕には多くの才能がある。
Don't forget to call me.	忘れずに電話してね。
I need some writing paper.	便箋をください。
Please show me another.	別の物を見せて下さい。
He is on another phone.	別の電話に出ています。
She took me by surprise.	彼女は僕を驚かせた。
She seems to be happy.	彼女は幸福そうに見える。
She lived a happy life.	彼女は幸せに暮らした。
She lacks common sense.	彼女はものを知らない。
Her dream has come true.	彼女の夢は実現した。
Her hair grew back.	彼女の髪は元の長さまで伸びた。
Her voice doesn't carry.	彼女の声は通らない。
I took a picture of her.	彼女の写真をとった。
Her sister looks young.	彼女の姉は若く見える。
They stopped the music.	彼らは、音楽を止めた。
He likes green the best.	彼は緑が一番好きだ。
You have made a promise.	あなたは約束をした。
He doesn't have a sister.	彼は妹がいません。
He is a common sort of man.	彼は品がない。
He bought her a dog.	彼は彼女に犬を買ってやった。
He drew a deep breath.	彼は息を深くすいこんだ。
He was killed in the war.	彼は戦死しました。
He was dressed in blue.	彼は青い服を着ていた。
He fell down on the floor.	彼は床に倒れた。
He has no religious mind.	彼は宗教心がない。
He put the phone down.	彼は受話器を下に置いた。
He left three days ago.	彼は三日前に出発した。
I wonder if he's at home.	彼は在宅だろうか。
He lived a happy life.	彼は幸福な生活を送った。
He lived a happy life.	彼は幸せな生涯を送った。
He may not be happy.	彼は幸せでないかもしれない。
He is not what he seems.	彼は見かけとは違う。
He lacks decisiveness.	彼は決断力に欠けている。
He carried out the plan.	彼は計画を実行した。
He is hard to please.	彼の機嫌を取るのは難しい。
He is drawing a picture.	彼は絵をかいている。
He faced toward the sea.	彼は海の方を向いた。
He was more than a king.	彼は王様以上だった。
He sometimes sleeps in.	彼はときどき寝坊する。
He is far from happy.	彼はちっとも幸福ではない。
He came down the road.	彼はその道をやってきた。
He drove the dog away.	彼はその犬を追い払った。
He seems to think so.	彼はそう考えているらしい。
No doubt he will come.	彼はきっと来るでしょう。
My back is killing me.	背中が痛くて死にそうだ。
Carry your head high.	背筋を伸ばして歩きなさい。
Get down from your horse.	馬から降りなさい。
I slept only two hours.	二時間しか寝なかった。
I'm talking on the phone.	電話中なんですよ。
The phones aren't working.	電話は不通なの。
I have low blood pressure.	低血圧なんです。
We walked along the street.	通りを歩いた。
Naoko can run fast.	直子さんは速く走る事が出来る。
A long day has passed on.	長い一日が過ぎた。
Do you have any in blue?	青色のはありますか。
People running round.	人々があちこち働いている。
The food is getting cold.	食べ物が冷めます。
I got on the wrong line.	乗りまちがえました。
Look down at the floor.	床を見下ろしてごらん。
Blood ran from the wound.	傷口から血がでた。
Do you have any sisters?	女の兄弟がいますか。
Are you ready to go?	出かける支度は出来ましたか。
Go back to your seat.	自分のシートに戻りなさい。
Must we dress up?	私達は正装しなければなりませんか。
We have two daughters.	私達には娘が二人います。
I will make her happy.	私は彼女を幸せにします。
I like their pictures.	私は彼らの絵が好きです。
I gave my cold to him.	私は彼に風邪をうつした。
I had him write it.	私は彼にそれを書いてもらった。
I go to church by car.	私は車で教会へ行きます。
I am all but ready.	私はほとんど用意が出来ている。
My watch runs too fast.	私の腕時計は少し進む。
My dream has come true.	私の夢は本当になった。
My room is just below.	私の部屋はこの真下です。
Please listen to me.	私の言う事を聞いてください。
Please see my people.	私の家族に会ってください。
Please come to my house.	私の家に来て下さい。
I have another sister.	私にはもう一人姉がいる。
It's really cold today.	今日は本当に寒いなぁ。
It is very fine today.	今日はとてもよい天気だ。
It's very cold today.	今日はたいそう冷えますね。
I feel cold this morning.	今朝は寒く感じる。
My back is killing me.	腰がひどく痛むんですよ。
I think you worry too much.	考え過ぎだよ。
You should face reality.	現実を直視すべきだ。
The police released him.	警察は彼を釈放した。
My brother likes music.	兄は音楽が好きである。
No gain without pains.	苦労なくしてもうけなし。
Did you enjoy yourself?	楽しく過ごせましたか？
I want to see the streets.	街を見に行こう。
A horse passed my house.	家の前を馬が通った。
I wonder what happened.	何が起こったんだろう。
What is the temperature?	温度はいくらですか。
Long live the king!	王様が長く生きられますように。
Let me buy you a drink.	一杯おごらせて下さい。
I met her an hour ago.	一時間前に彼女に会った。
Write on every other line.	一行おきに書け。
I am pleased with myself.	わたしは得意です。
Let sleeping dogs lie.	やぶを突いて蛇をだすな。
Why not? I'd be happy to.	もちろん、喜んで。
I almost forgot it.	もう少しで忘れるところだった。
May I add a point?	もう１点付け加えてもいいですか。
We can seat you soon.	まもなくご案内いたします。
Look forward, please.	まっすぐ前を見てください。
Betty killed her mother.	ベティは母を殺した。
What a big dog that is!	なんと大きな犬だろう。
What a beautiful town!	なんてキレイな町なんだ！
Tom is a friend of mine.	トムは私の友人です。
Tony can run fast.	トニー君は速く走ることが出来る。
What seats do you want?	どこの席がいいですか？
How can we kill time?	どうやって時間をつぶそう？
Stand back, please.	どうぞ後ろに下がってください。
Make yourself at home.	どうぞ気楽にして下さい。
Help yourself, please.	どうぞお上がりください。
Please get into the car.	どうぞお乗り下さい。
You are wrong, however.	だが君は間違っている。
Don't worry about that.	そんなの気にしないで。
Don't speak so fast.	そんなに速くしゃべらないで。
Get it ready at once.	それをすぐに準備しなさい。
It's against the rules.	それはルール違反です。
The drug acted quickly.	その薬はすぐにきいた。
The dog's name is Ken.	その犬の名前はケンです。
Can you see the picture?	その絵が見えますか。
Don't worry about that.	そのことは心配するな。
Seiko has no sisters.	セイコには姉妹がいません。
I'm feeling stressed.	ストレスがたまってきたよ。
Wait here for a while.	しばらくここで待ってて。
These books are mine.	これらの本は私のものです。
Are these your horses?	これはあなたの馬ですか。
This dog minds well.	この犬はよくいうことを聞く。
I can't stand this cold.	この寒さには参った。
Everything here is mine.	ここまでは私のです。
Ken must run fast.	ケンは速く走らなければいけない。
Carlos waited a moment.	カルロスは少し待った。
A girl phoned me.	ある女の子から電話がかかってきた。
That black one is mine.	あの黒いのは私のです。
Can you run fast?	あなたは速く走ることが出来ますか。
Take care of yourselves!	いつまでも元気でね！
The time will finally come.	時代がついに来る
He searched for the price.	彼が価格を検索する
I'm sure he will kill me.	彼がきっと、私を殺す
Everyone bears X in mind.	Xを全員が心掛けます
The rooms all face the sea.	全室が海に面する
I was really surprised.	私はさすがにビックリした
X rules the world again.	Xが再び世界を支配する
Do you have any in green?	緑色のはありますか。
Where is the post office?	郵便局はどこですか。
The tree breaks the wind.	木で風の力が和らぐ。
I saw my sister there.	妹がそこにいるのが見えた。
Charge it to my room.	部屋につけておいてください。
Father enjoyed a long life.	父は長命だった。
Need we wait for her?	彼女を待つ必要がありますか。
She was well-dressed.	彼女は立派な服装をしていた。
She is down with a cold.	彼女は風邪で寝ている。
She's of the Caucasian race.	彼女は白人だ。
She began to gain weight.	彼女は太りはじめた。
She was dressed in red.	彼女は赤い服を着ていた。
She wore a red dress.	彼女は赤いドレスを着ていた。
She looked me in the eye.	彼女は私の目を見た。
She died for lack of air.	彼女は酸欠で死んだ。
She lived a happy life.	彼女は幸福な生活をした。
It seems that she's happy.	彼女は幸せらしい。
She looks very happy.	彼女はとても幸せに見えます。
She gave a ready answer.	彼女はすらすら答えた。
Her manner was cold.	彼女の態度はよそよそしかった。
Their dreams came true.	彼らの夢が現実になった。
They have two daughters.	彼らには娘が二人いる。
He promised me to come.	彼は来ると約束しました。
He came down with a cold.	彼は風邪にかかった。
He bought out a business.	彼は店を買い取った。
Life passed him by.	彼は人生の楽しみを知らなかった。
He has bought a new car.	彼は新しい車を買った。
He has no eye for women.	彼は女を見る目がない。
He is no friend of mine.	彼は私の味方ではない。
He is as good as dead.	彼は死んだのも同様である。
He is as good as dead.	彼は死んだのも同然である。
He is said to be dead.	彼は死んだと言われている。
He has learnt manners.	彼は行儀を身に付けている。
He started in surprise.	彼は驚いて飛び上がった。
He has a good memory.	彼はよい記憶力をもっている。
He is all but dead.	彼はほとんど死んだもとうぜんだ。
He is a man of spirit.	彼はなかなか骨っぽい男だ。
He isn't happy at all.	彼はぜんぜん幸福ではない。
He shall go to the bank.	彼に銀行に行かせよう。
He is wrong or I am.	彼か私のどちらかが間違ってる。
It got colder day by day.	日ごとに寒くなった。
Can I check in here?	搭乗手続きはここでできますか。
May I use your phone?	電話を貸してもらえませんか。
Might I use your phone?	電話をお借りできますか。
Answer the phone, please.	電話に出てください。
Please turn on the light.	電気をつけて下さい。
Hold your breath, please.	息を止めてください。
Do you have a window seat?	窓側の席はあるか。
Open the window, please.	窓を開けてくれますか。
I'm so happy for you.	全く喜ばしいじゃないですか。
Please give me some water.	水を少しください。
Can I play some music?	少し音楽をかけていいかい？
I will pay for it by check.	小切手で支払う。
Please send for help.	助けを呼びにやってください。
I was affected by the heat.	暑さにやられた。
We closed the discussion.	私達は討議を終えた。
I made her a dress.	私は彼女にドレスを作ってあげた。
I'm waiting for him.	私は彼を待っているところです。
I met him on the street.	私は彼に通りで会った。
I was used to the heat.	私は暑さには慣れていた。
I was wrong all along.	私は初めから間違っていた。
I call on him sometimes.	私は時々彼を訪れます。
I got my eyes tested.	私は眼の検査をしてもらった。
I looked down at the sea.	私は海を見下ろした。
I do not like music.	私は音楽が好きではありません。
I like music very much.	私は音楽がとても好きだ。
I saw her a week ago.	私は一週間前彼女に出会った。
I studied for one hour.	私は一時間勉強しました。
I love French films.	私はフランス映画が大好きです。
I always keep a promise.	私はいつも約束を守る。
I saw her a week ago.	１週間前に彼女に会いました。
Turn toward me, please.	私の方を向いてください。
My mother loves music.	私の母は音楽が大好きです。
My mother is dead too.	私の母はもう死んでいます。
My house faces the sea.	私の家は海に面している。
We have two daughters.	私どもには娘が２人います。
We live on the earth.	私たちは地球上に住んでいる。
We are brother and sister.	私たちは兄弟です。
We walked for two hours.	私たちは２時間歩いた。
He wished himself dead.	死んだらいいとおもった。
Please save my place.	座席をとっておいてください。
It is very fine today.	今日はたいへん天気がよい。
It is still colder today.	今日はいっそう寒い。
You look happy today.	今日あなたは楽しそうですね。
What is the total amount?	合計でいくらですか。
I enjoyed your company.	御一緒できて楽しかった。
I have a pain in the shoulder.	肩が痛い。
Call off your dogs.	犬を呼んで連れていってください。
Never break your promise.	決して約束を破るな。
I'll never forget you.	決してあなたを忘れません。
All but you are wrong.	君以外はみな間違っている。
You look happy today.	君は今日明るい顔をしている。
Where are your eyes?	君の目はどこについているんだ。
You are wanted on the phone.	君に電話です。
Don't leave it up to chance.	偶然に頼るな。
No gains without pains.	苦労なしのもうけはない。
No gains without pains.	苦しみなくして利益なし。
Ready money will away.	金は持っていると無くなる。
Let's pass by the church.	教会のそばを通ろう。
There is no room for doubt.	疑う余地はない。
Don't go against the rules.	規則に逆らうな。
What's the temperature?	気温はどのくらいですか。
I do not like science.	科学は好きではありません。
Above all, be patient.	何よりもまず忍耐強くあれ。
What a fine day it is!	何と良い天気なんでしょう。
Let's listen to some music.	音楽を聞こうよ。
Did you enjoy the film?	映画は楽しかったですか。
It is wrong to tell lies.	嘘をつくことは悪い。
Rumi is the first daughter.	ルミは長女です。
Meg colored the picture.	メグは絵に色を塗った。
I can't find my glasses.	メガネが見つからない。
It is me that is wrong.	まちがっているのは私だ。
We may as well wait.	ぼくたちは待つ方がよいだろう。
Please just focus it.	ピントだけあわせてください。
What a beautiful view!	なんて美しい眺めでしょう。
It's a beautiful country.	とても美しい国です。
I really enjoyed myself.	とても楽しかったです。
Please do it quickly.	どうぞ急いでやってください。
Open the door, please.	どうぞドアを開けて下さい。
Please help yourself.	どうぞご自由に御召し上がれ。
Please help yourself.	どうぞご自由にお取り下さい。
Please come this way.	どうぞこちらへおいで下さい。
Smile at me, please.	どうか私に微笑みかけておくれ。
Who wrote this book?	だれがこの本を書いたのですか。
Buy it for me, please.	それを私に買ってください。
It is beyond my power.	それは私の手におえません。
It was three days ago.	それは３日前のことだった。
Add more water to it.	それにもっと水をたしなさい。
The night was so cold.	その夜はだいぶん寒かった。
The dress becomes you.	その服は君に似合っている。
We brought off the task.	その仕事はやり遂げた。
That dog made for me.	その犬が私に向かってきてね。
Don't worry about it.	そのことについて心配するな。
Just wait for me there.	そこで待っててください。
Beautiful day, isn't it?	すばらしい天気ですね。
It will soon grow light.	すぐ明るくなるだろう。
Jane keeps early hours.	ジェーンは早寝早起きだ。
Please write this down.	これを書き留めて下さい。
Please give me this book.	この本を私に下さい。
This color becomes you.	この色はあなたに似合う。
This car is out of date.	この車は時代遅れです。
This work is beyond me.	この仕事は私の力に余る。
Are you all ready?	きみたちみんな用意はできましたか。
I'm pleased to meet you.	お目にかかれて嬉しい。
I received your letter.	お手紙を受け取りました。
What about your manners!	お行儀はどうなったの。
Shall I check the oil?	オイルをしらべましょうか。
Look at that big dog.	あの大きな犬をごらんなさい。
That boy has good brains.	あの少年は頭がいい。
Were you with anyone?	あなたは誰かと一緒でしたか。
You seem a kind man.	あなたは親切な人のようですね。
Carry on with your work.	あなたは仕事を続けて。
How fast you walk!	あなたはなんと速く歩くのでしょう。
You have four dogs.	あなたは４匹の犬を飼っています。
What are the seven seas?	７つの海って何ですか。
He seems to know us.	彼は私たちを知っているようだ。
My mother had an operation.	母が手術をしました
I am in love with my sister.	僕が妹に恋をする
He read the entire page.	彼が全てのページを読んだ
He'll make all the pages.	彼が全てのページを作る
Questions are shown below.	質問事項を以下に示す
He suddenly remembered X.	彼がXをふと思い出した
We draw a picture together.	皆で一枚の絵を描く
Their eyes will light up.	彼らが目の色を変えます
He checks the contents.	彼がその内容をチェックする
X exists in this world.	Xが、この世には存在します
Love is beyond reason.	恋愛は理性では抑えられない。
Yumi is happy, isn't she?	由美はしあわせですね。
I often get the blues.	憂うつな気分によくなります。
You must keep your promise.	約束を守りなさい。
Please tell me your name.	名前を教えてください。
It may not be a dream.	夢ではないかもしれませんよ。
Let a sleeping dog lie.	眠ってる犬は眠らせておけ。
I lead a fast way of living.	放蕩生活を送る。
Please change my room?	部屋を変えていただけますか。
Please air the room.	部屋の空気を入れ替えてください。
She achieved her purpose.	彼女は目標を達成した。
She is dressed in white.	彼女は白い服を着ている。
She likes blue dresses.	彼女は青いドレスが好きだ。
She turned her eyes away.	彼女は視線をそらした。
She waved her hand to me.	彼女は私に手を振った。
She lived a happy life.	彼女は幸福な生活を送った。
She lived a happy life.	彼女は幸せな生活を送った。
She lived a happy life.	彼女は幸せな人生を送った。
She is drawing a picture.	彼女は絵を描いている。
She looked at the picture.	彼女は絵を見ました。
She has a love of music.	彼女は音楽が大好きです。
How beautiful she is!	彼女はなんて美しいのでしょう。
She looks very happy.	彼女はとても嬉しそうに見える。
She listened to him.	彼女はその少年の話に耳を傾けた。
She wrote me back soon.	彼女はすぐに返事をくれた。
She came down with a cold.	彼女は風邪をひいた。
She achieved her purpose.	彼女は目的を達成した。
Her dream has come true.	彼女の夢が正夢となった。
I bought her a new car.	彼女に新車を買ってやった。
We have no trust in him.	彼を全然信用していない。
They started hours ago.	彼らは数時間前に出発した。
They are a good couple.	彼らは似合いのカップルだ。
They look happy today.	彼らは今日幸せそうに見える。
He is the king of the night.	彼は夜の帝王だ。
He is known to everyone.	彼は誰にも知られている。
He wanted to go to sea.	彼は船乗りになりたかった。
He has an eye for people.	彼は人を見る目がある。
He tried to kill himself.	彼は自殺しようとした。
He kept me waiting.	彼は私を待たせたままにしておいた。
He can run faster than I.	彼は私より速く走れる。
He's writing a book now.	彼は今本を書いています。
He lived a happy life.	彼は幸福な人生を送りました。
He is lacking in experience.	彼は経験不足だ。
He did nothing wrong.	彼は何も悪いことはしていない。
I wonder what he will say.	彼は何と言うかしら。
He took part in the race.	彼はレースに参加した。
How fast he can run!	彼はなんと速く走れるのでしょう。
How fast does he run?	彼はどれくらい速く走りますか。
He added up the figures.	彼はその数字を合計した。
He gave me a bad cold.	彼にひどい風邪をうつされた。
I was happy to see him.	彼と会ったのが幸いだった。
I doubt if he will come.	彼が来るかどうか疑問だ。
May you both be happy!	二人が幸せでありますように。
Hold the line, please.	電話を切らずにお待ち下さい。
Please hold the line.	電話を切らずにおいてください。
I want to make a phone call.	電話をかけたい。
It's across the street.	通りを渡って向こう側です。
And the boy grew older.	男の子は大きくなりました。
The heating doesn't work.	暖房が故障しています。
I forget who said it.	誰がそういったのか忘れている。
Who wrote this letter?	誰がこの手紙を書きましたか。
There's no point in waiting.	待ってもむだだ。
Don't worry about others.	他人の事は心配するな。
Please come to talk to me.	相談に来てください。
Soon learnt, soon forgotten.	早合点の早忘れ。
Mari and Maki are sisters.	真理と真喜は姉妹だ。
May I pay by check?	小切手でお支払いしてもよいですか。
Don't touch the wound.	傷口をさわらないでください。
Are you ready to start?	出発の用意は出来ましたか。
Will you please help me?	手伝ってもらえませんか。
Did you receive my letter?	手紙は届きましたか。
You should know yourself.	自分自身を知るべきだ。
The car is running fast.	自動車が速く走っている。
Try to control yourself.	自制するよう努めなさい。
Please come next Friday.	次の金曜に来てください。
Take the time to reflect.	時間をかけて反射しろ。
Don't worry about us.	私達の事は心配しないで下さい。
I'm waiting for my mother.	私は母を待っている。
I asked her for a date.	私は彼女をデートに誘った。
I like her dark eyes.	私は彼女の黒っぽい目が好きだ。
I conducted him out.	私は彼を案内して外へ連れ出した。
I was born 20 years ago.	私は二十年前に生まれた。
I met her on the street.	私は通りで彼女と会った。
I am ready to start.	私は出発する準備ができています。
I have low blood pressure.	私は血圧が低いです。
I met her at the church.	私は教会で彼女に会った。
I am happy to help you.	私は喜んでお手伝いします。
I doubt if it will.	私はそんな事は疑わしいと思います。
I looked at the picture.	私はその写真を見ました。
I wrote a letter to Jim.	私はジムに手紙を書いた。
My seat is near the door.	私の席はドアの近くだ。
Where are my glasses?	私のメガネはどこにありますか。
My mother is beautiful.	私のお母さんは美しいです。
I don't have any sisters.	私には、姉妹がいない。
Give me a glass of water.	私に１杯の水を下さい。
Children grow very quickly.	子供は成長が早い。
Keep the rest for yourself.	残りはとっておけ。
It's a cold day, isn't it?	今日は寒い日ですね。
It is very fine today.	今日はたいへんよい天気です。
You look happy today.	今日はあなたは楽しそうですね。
Please call me up later.	後で私に電話して下さい。
You don't have a temperature.	君は熱がない。
I rest on your promise.	君の約束を当てにしている。
May I take your picture?	君の写真を撮ってもいい？
Either you or I am wrong.	君か僕が間違っている。
I've been to the bank.	銀行へ行ってきたところです。
The discussion was heated.	議論は白熱していた。
There is no room for doubt.	疑問の余地がない。
There is no room for doubt.	疑いの余地はない。
I am ready to go with you.	喜んでおともします。
May you all be happy.	皆様がお幸せでありますように。
I saw land in the distance.	遠くに陸が見えた。
I'll get some glasses.	わたしグラスを持ってくるわ。
I can't believe my eyes.	わが目を疑っちゃうなあ。
It is finally all over.	ようやくすっかり終わった。
Please take another one.	もう一枚とってください。
Give me a second chance.	もう一度チャンスをくれ。
I can't wait any longer.	もうこれ以上待てません。
Mayuko's dream came true.	マユコの夢は実現した。
Well, just you wait and see.	まあ、見てろよ。
Everything else is fine.	ほかはすべてすばらしい。
Happy Valentine's Day.	バレンタインデーおめでとう。
How fast Tom works!	トムはなんて仕事が早いのでしょう。
Tom was all worn out.	トムはすっかり疲れきっていた。
Please open the window.	どうぞ窓を開けてください。
Run as fast as you can.	できるだけ速く走りなさい。
He finally made money.	ついに彼はお金を手に入れた。
Give me a break, please.	ちょっとかんべんしてよ。
I was waiting all alone.	ただ一人待ち続けていた。
What sort of play is it?	それはどんな芝居ですか。
Do it in this manner.	それはこういう風にやりなさい。
The man is all but dead.	その人は死んだも同然だ。
Who wrote the letter?	その手紙は誰が書いたのですか。
The police are searching.	その警察は探している。
Carry on with your plan.	その計画をつづけなさい。
All roads lead to Rome.	すべての道はローマに通ず。
Stella really is dead!	ステラは本当に死んでいます！
Get out of here immediately!	すぐに出て行け！
Susan left an hour ago.	スーザンは１時間前に出た。
Charge this to my company.	これは、会社払いだ。
Do you like this color?	この色、気に入りましたか。
Please air the zabuton.	この座布団を干して下さい。
The pain is killing me.	この苦痛には我慢できない。
You'll have to wait.	お待ちいただくことになりますが。
Take care of yourself.	お体を大切にしてくださいね。
What on Earth is this?	いったいぜんたいこれは何だ。
Please take some of them.	いくつかお取り下さい。
That girl's eyes are blue.	あの少女の目は青い。
That dog runs very fast.	あの犬はとても速く走る。
You should wait here.	あなたはここで待つほうがいい。
I doubt your good sense.	あなたの良識を疑います。
I saw him three years ago.	３年前に彼に会った。
I'll be back in two hours.	２時間後に戻ります。
Please don't get up.	どうぞおたちにならないで下さい。
Gimme something to write on.	書くものをくれ。
He came down with a cold.	彼は風邪でダウンした。
I saw X with my own eyes.	Xを私が目の当たりにする
He reads the whole series.	彼がその作品を全部読む
I will show two X below.	Xを２つ、以下に紹介します
Everyone gives money for X.	Xにはみんな金を出す
The plants grow very fast.	本当に草木の成長が早い
I'm more worried about that.	そっちの方が心配だ
He gets the child dressed.	彼がこどもに服を着せる
Don't give yourself airs.	勿体振るのはやめてくれ。
It seems very interesting.	面白いように思います。
Write your name in full.	名前を略さずに書きなさい。
Dreams sometimes come true.	夢は時としてあたる。
Let me join in the game.	僕もゲームに加えて下さい。
I felt like I was dead.	僕は生きた心地がしなかった。
She wore a white dress.	彼女は白いドレスを着ていた。
She is far from beautiful.	彼女は全く美しくない。
She takes a bad picture.	彼女は写真うつりが悪いね。
She waved her hand to us.	彼女は私達に手を振った。
She is a friend of mine.	彼女は私の友だちの１人だ。
She took care of my dog.	彼女は私の犬の世話をした。
She runs faster than I do.	彼女は私より速く走る。
She was dressed in black.	彼女は黒い服を着ていた。
She is liked by everyone.	彼女は皆に好かれている。
She is fit for the job.	彼女はその仕事に適している。
She has beautiful eyes.	彼女はきれいな目をしている。
That she is dead is certain.	彼女の死は事実だ。
Don't listen to her.	彼女の言うことを信じてはいけない。
It's hard to please him.	彼を満足させるのは難しい。
You should not trust him.	彼を信用してはいけない。
They lived a happy life.	彼らは幸せな生活を送った。
They lived a happy life.	彼らは幸せな人生を送った。
They are far from happy.	彼らは決して幸せではない。
They will buy a record.	彼らは、レコードを買います。
Their son grew bigger.	彼らの息子は大きくなりました。
I can't fit in with them.	彼らとはうまくやれない。
He promised me to come.	彼は来ると私に約束しました。
He has no sense of direction.	彼は方向音痴だ。
He carries himself regally.	彼は堂々と振る舞う。
He promised not to tell.	彼は他言しないと約束した。
He is a man to be trusted.	彼は信用できる人です。
He was not happy at all.	彼は少しも幸せでなかった。
He has written a letter.	彼は手紙を書いてしまった。
He sometimes watches TV.	彼は時々、テレビを見ます。
I wonder if he loves me.	彼は私を愛しているかしら。
He looked me in the eye.	彼は私の目をにらみつけた。
He noticed my presence.	彼は私がいることに気づいた。
He has three elder sisters.	彼は姉が３人います。
I believe that he's happy.	彼は幸福だと思います。
He is not like he seems.	彼は見かけとはだいぶ違う。
He's wanted by the police.	彼は警察のお尋ね者だ。
He runs as fast as you.	彼は君と同じくらい速く走る。
He can't write any kanji.	彼は漢字が全く書けない。
He was listening to music.	彼は音楽を聞いていた。
He ran as fast as he could.	彼は一生懸命走った。
He turned up an hour later.	彼は一時間後現れた。
He looks very worried.	彼はたいへん心配そうに見える。
He carried out the plan.	彼はその計画を成し遂げた。
He was happy for a time.	彼はしばらくは幸福だった。
He often dates Mary.	彼はしばしばメアリーとデートする。
He lives on this street.	彼はこの通りに住んでいる。
He is in fear of the dog.	彼はあの犬を恐れている。
Your skin is breaking out.	肌荒れがひどいですね。
The years pass by quickly.	年月が過ぎるのは早い。
The Japanese have dark eyes.	日本人は目が黒い。
The two roads join here.	二つの通りがここで交わる。
Move along, please!	道をふさがないで先にどんどん歩いて！
The phone is out of order.	電話が故障しています。
Don't get so carried away.	調子に乗りすぎるなよ。
I don't have a thing to wear.	着る物がないの。
Everyone speaks well of him.	誰もが彼を誉める。
Everyone knows the law.	誰もがその法律を知っている。
Has anyone asked for me?	誰か私に会いにきましたか。
Who wrote this letter?	誰がこの手紙を書いたのですか。
Who ruled this country?	誰がこの国を支配していたか。
Osamu Dazai killed himself.	太宰治は、自殺した。
Don't worry about others.	他人のことは気にするな。
The ship changed its course.	船は進路を変えた。
The ship soon came into view.	船が見えてきた。
Hold the line, please.	切らずにそのままお待ち下さい。
Risk all and gain all.	身を捨ててこそ浮かぶ瀬もあれ。
I'm going to buy a new car.	新車を買うつもりだ。
The color will not go off.	色はさめないでしょう。
The color has come out well.	色の上がりがよい。
There is no paper to write on.	書く紙がない。
Wait for your turn, please.	順番をお待ち下さい。
Will you please help me?	手伝っていただけませんか。
You shall listen to us.	私達の言うことを聞きなさい。
Please leave me alone.	私を一人にしておいてください。
I want to make her happy.	私は彼女を幸福にしたい。
I listened to her story.	私は彼女の話に耳を傾けた。
I gave my horse its head.	私は馬を好きに走らせた。
I go to church on Sunday.	私は日曜日に教会に行く。
I work in a special unit.	私は特殊部隊に勤務する。
I can't stand the heat.	私はこの暑さにたえられない。
I'm paid by the hour.	私は時間給で時間をもらっている。
I am ready to help you.	私は喜んであなたを助けよう。
I like to draw pictures.	私は絵を描くのが好きです。
I've broken my glasses.	私はめがねを壊してしまった。
I proved it to be true.	私はそれが真実だと証明した。
I want to buy the dress.	私はそのドレスを買いたい。
I like this blue dress.	私はこの青いドレスが好きだ。
My Chinese did not pass.	私の中国語は通じなかった。
Please give me some water.	私に水をくれませんか。
Please tell me the truth.	私に真実を話して下さい。
I have nothing to write.	私には書くことが何もない。
We talked over the phone.	私たちは電話で話をした。
We named the dog Pochi.	私たちは犬をポチと名づけた。
We enjoy watching TV.	私たちはテレビを見て楽しみます。
Please bring the others.	残りを持って来てください。
I didn't dream last night.	昨夜は夢を見なかった。
I enjoyed myself last night.	昨晩は楽しかった。
I didn't dream last night.	昨日は夢をみなかった。
My wife looked surprised.	妻は驚いたように見えた。
Take the road on the left.	左の道を行って下さい。
You aren't yourself today.	今日は君らしくないな。
Cold this morning, isn't it?	今朝は寒いですね。
Please contact me later.	後で私に連絡してください。
Please call me up later.	後で私に電話をして下さい。
I'd like to page someone.	呼び出しをお願いします。
You keep a dog, don't you?	犬を飼っているんだね。
The dog ran around a tree.	犬は木の周りを走った。
We are worried about you.	君のことを心配している。
Show me what you bought.	君が買った物を見せなさい。
Either you or I am wrong.	君か私のどちらかが悪い。
I'm not pressed for money.	金には困っていないよ。
She has a good memory, too.	彼女は記憶力もいい。
You have to be patient.	気長に構える必要があります。
Good morning, everyone.	皆さん、おはようございます。
We fought for everyone.	我々はみんなのために戦った。
Why are you so happy?	何をそんなに喜んでいるのですか。
Don't leave it up to chance.	運まかせにするな。
To tell a lie is wrong.	嘘をつくことは間違っている。
Where are my glasses?	わしのメガネはどこにいったんだ？
My hand's getting too cold.	もう手が冷たくって。
Read it once more, please.	もう一度読んでごらん。
It seemed rather bad.	むしろ悪くなっているようだった。
Betty drives fast.	ベティは車を運転するとスピードを出す。
Please turn over the page.	ページをめくりなさい。
Anyone can do that.	どんな人でもそれをすることができる。
Tom applied for the job.	トムはその仕事に応募した。
How long have you waited?	どのくらい待ちましたか。
Close the door, please.	どうぞドアをしめてください。
Take this seat, please.	どうぞこの席にお座り下さい。
Please take care of yourself.	どうぞお大事に。
Open the window, please.	どうか窓を開けてください。
Please don't mind me.	どうか私にかまわないでください。
Do come in, please.	どうか、ぜひお入りになってください。
There's a dog by the door.	ドアの側に犬がいます。
Give me a drink, please.	ちょっと一杯飲ませてくれ。
I'd like to check out.	チェックアウトしたいのですが。
It took just an hour.	たった１時間しかかからなかった。
I have no money to buy it.	それを買うお金がない。
Please say it by heart.	それをそらで言ってください。
It sounds like a dream.	それは夢のように思われます。
The promise still holds.	その約束はまだ生きている。
Let's wait around for her.	その辺で彼女を待とう。
The car doesn't run fast.	その車は、速く走らない。
Don't approach the dog.	その犬に近寄ってはいけない。
Don't approach the dog.	その犬に近寄ってはならない。
Don't go near the dog.	その犬に近づいてはいけません。
The house has been bought.	その家は買い取られた。
How did you like the film?	その映画はどうだった。
Then you will be happy.	するとあなたは幸せでしょう。
We'll check on it right now.	すぐに点検します。
Please come back at once.	すぐに帰ってきて下さい。
George seems a good boy.	ジョージはいい少年らしい。
Please give me your attention.	ご注目下さい。
Would you care to join me?	ご一緒にいかがですか。
I wonder whose car this is.	これは誰の車かしら。
Please buy me this book.	この本を私に買って下さい。
Let's wind up our work.	この辺で仕事を切り上げよう。
This wall feels cold.	この壁は触ると冷たい感じがする。
We ended this discussion.	この討論を終わりにした。
Is this seat taken?	この席はどなたかいらっしゃいますか。
This job is killing me.	この仕事、死ぬほどしんどい。
This film develops fast.	このフィルムは現像が早い。
Write it down here, please.	ここに書いて下さい。
Here's a fine how-do-you-do.	こいつは困ったぞ。
It is likely to be fine.	おそらく天気になるだろう。
When did you buy the watch?	いつ時計を買ったの。
I'm always under pressure.	いつも緊張しています。
It seems to be a good house.	いい家のようです。
Are those your pictures?	あれらはあなたの絵ですか。
One day he killed himself.	ある日、彼は自殺した。
How fast that horse runs!	あの馬の速くはしること！
I wonder who that girl is.	あの女の子は誰だろう。
How beautiful you are!	あなたは何と美しいのでしょう。
Carry on with your work.	あなたの仕事を続けなさい。
I enjoyed your company.	あなたと御一緒で楽しかった。
That's $7.65, please.	７ドル６５セント、お願いします。
Please come in three days.	３日後に来てください。
Let's begin at page 30.	３０ページから始めましょう。
I will be back in an hour.	１時間で戻ってきます。
I will be back in an hour.	１時間で帰ってきます。
Ann likes music very much.	アンは音楽が大好きだ。
He noticed my presence.	彼は私のいるのに気がついた。
He might not be happy.	彼は幸せではないかもしれない。
In fact, we worry about it.	こちらの方が心配をする
Let's look at the site then.	当時のサイトを見よう
I like big-sister types.	姉さんタイプの女の人が好きだ
He got the cold shoulder.	彼が全く相手にされなかった
He called the cell phone.	彼がその携帯に電話を掛けた
X was proven 10 years ago.	Xが１０年前に証明された
Please go on with your story.	話を続けて下さい。
I can't keep my eyes open.	目を開けていられません。
The light came on suddenly.	明かりがパッとついた。
I run as fast as Jim.	僕はジムと同じくらい走るのが速い。
I like this color as well.	僕はこの色もまた好きだ。
Let me buy you another one.	別のを買わせて下さい。
Being poor, he can't buy it.	貧しいので買えない。
She is gaining in weight.	彼女は目方がふえつつある。
She was subject to cold.	彼女は風邪を引きやすかった。
She is not always happy.	彼女は必ずしも幸福ではない。
She turned around suddenly.	彼女は突然振り向いた。
She came across the street.	彼女は通りを横切った。
She found a man dead.	彼女は男が死んでいるのを見つけた。
She promised me to come.	彼女は私に来ると約束したよ。
She was dressed in black.	彼女は黒衣をまとっていた。
She is loved by everyone.	彼女は皆から好かれている。
She is loved by everyone.	彼女は皆から愛されている。
She had her dress made.	彼女はドレスを作ってもらった。
She wrote me back soon.	彼女はすぐに私に返事をくれた。
She sent this book to me.	彼女はこの本を私に送った。
She always looks happy.	彼女はいつも幸せそうに見える。
She always looked happy.	彼女はいつも幸せそうだった。
She'll do it in 24 hours.	彼女は２４時間でできます。
Do you ever date her?	彼女とデートすることはありますか。
She can only trust him.	彼女が信頼できるのは彼だけだ。
They did me a great wrong.	彼らは私を不当に扱った。
They are a good couple.	彼らはお似合いのカップルです。
He will be really pleased.	彼は本当に喜ぶでしょう。
He was in bed with a cold.	彼は風邪で寝込んでいた。
He walked across the street.	彼は通りを横切った。
He looked down at the floor.	彼は床を見下ろした。
He waved me away.	彼は手を振って私にあっちにいけと合図した。
He is, indeed, a hard worker.	彼は実に勉強家だ。
He kept a seat for me.	彼は私に席を取っておいてくれた。
He sent me a present.	彼は私にプレゼントを送ってくれた。
He did me a great wrong.	彼は私にひどい仕打ちをした。
He is in high spirits today.	彼は今日は上機嫌だ。
I wonder where he is now.	彼は今どこにいるのかしら。
It seemed that he was fine.	彼は元気だったらしい。
He looked at me in surprise.	彼は驚いて私を見た。
He was blue from the cold.	彼は寒さで青ざめていた。
He was blue with cold.	彼は寒さでまっさおになっていた。
He is doing fine in school.	彼は学校の成績がいい。
He likes music very much.	彼は音楽がとても好きです。
He was seated all alone.	彼は一人ぼっちで座っていた。
He will be a good husband.	彼はよい夫になるだろう。
He is quite in the wrong.	彼はまったく間違っている。
How fast does he run?	彼はどのくらいの速さで走りますか。
They looked very happy.	彼女らはとても幸せそうだった。
He looked very happy.	彼はとてもうれしそうに見えました。
He saved a lot of money.	彼はたくさんのお金を貯めた。
Need he run so fast?	彼はそんなに速く走る必要があるのか。
The idea grew on him.	彼はその考えに取り付かれていった。
He took part in the race.	彼はそのレースに参加した。
He seems like a good person.	彼はいい人のようだ。
He run on for half an hour.	彼は３０分走り続けた。
He has written two books.	彼は２冊の本を著している。
He works eight hours a day.	彼は１日に８時間働く。
He has an eye for art.	彼は、芸術に対する鑑賞力がある。
I wonder why he is late.	彼の帰りの遅いのが気になる。
He has no eye for beautiful.	彼には審美眼がない。
He is not up to the task.	彼にはその仕事ができない。
A white ship came into view.	白い船が見えてきた。
Carry your head high.	背筋をしゃんと伸ばして歩きなさい。
The horse would not move.	馬は頑として動かなかった。
On Sunday, I go to church.	日曜には私は教会に行く。
Don't play in the street.	道路で遊んではいけません。
You are wanted on the phone.	電話がかかってるよ。
Everyone's saying it.	誰もがみんな口々にいいあっている。
It's nothing to worry about.	大したことはないよ。
Did you enjoy your visit?	滞在中は楽しかったですか。
Please be kind to others.	他人に親切にしてください。
It seems to be clearing up.	晴れてきたようですね。
Mr Hoshino is hard to please.	星野氏は気難しい。
The figures add up to 230.	数字は合計２３０となる。
The water ran over the banks.	水は堤防を越えた。
Life is full of chances.	人生は可能性でいっぱいです。
A wonder lasts but nine days.	人の噂も七十五日。
Happy New Year, Louise!	新年おめでとう、ルイーズさん！
Will you take a check?	小切手で受け取ってもらえますか。
"I forgot," she answered.	女性は「忘れた」と答えた。
The heat really gets me.	この暑さには全くまいります。
Are you ready to set off?	出発の準備はできましたか。
Name and address, please.	住所氏名を言ってください。
I enjoy taking pictures.	写真をとるのは楽しいものだ。
Did you study by yourself?	自分ひとりで勉強したの？
Sometimes I get out of line.	時々脱線するんです。
I sometimes see him on TV.	時々彼をテレビで見るよ。
I'm going out in an hour.	一時間したら行ってきます。
I am pressed for time.	時間がなくてたいへん困っている。
We carried out that plan.	私達はその計画を実行した。
We named the dog Tim.	私達は、その犬をティムと名づけた。
Please show me around.	私をあちこちに案内してください。
I'm immediately behind her.	私は彼女のすぐ後ろだ。
I met her three days ago.	彼女には３日前に会ったよ。
I looked him in the eyes.	私は彼の目をまともに見た。
I walked along the street.	私は通りにそって歩いた。
I ran as fast as I could.	私は出来るだけ速く走った。
I am writing a letter.	私は手紙を書いているところです。
I sometimes dream of home.	私は時々故郷の夢を見る。
I am interested in music.	私は音楽に興味があります。
I like English and music.	私は英語と音楽が好きです。
Either way's fine with me.	私はどちらでも結構です。
I added a room to my house.	私は１部屋建て直した。
My seat is this window seat.	私の席は窓側ですね。
Please answer my question.	私の質問に答えて下さい。
My sister is in her twenties.	私の姉は２０代だ。
My plan is to buy a car.	私の計画は車を買うことです。
Give me some water, please.	私に水を少しください。
Give me the same, please.	私にも同じものをください。
We walked along the street.	私たちは通りを歩いた。
We call our dog Pochi.	私たちの犬をポチと呼んでいます。
May I put my seat back?	座席の背を倒してもいいですか。
Keep to the left, please.	左側通行を守ってください。
Have you got a cold now?	今風邪をひいているのですか。
I wish it were fine today.	今日は天気ならいいのに。
How fine it is today.	今日はなんて天気が良いのでしょう。
It is very cold this morning.	今朝はとても寒い。
The blood was a dark color.	血はどす黒かったです。
You've given me your cold.	君は僕に風邪をうつした。
Who are you waiting for?	君は誰を待っているのですか。
Are you writing a letter?	君は手紙を書いていますか。
Money does not grow on trees.	金は木に生えない。
Please make yourself at home.	気軽にして下さい。
He was saved by a hair.	間一髪のところで彼は助かった。
It was you that were wrong.	間違っていたのは君だ。
The air felt a little cold.	外気は少し冷たかった。
With kind regards to you all.	皆さんによろしく。
The fire started immediately.	火がすぐに付いた。
What did you buy it for?	何のためにそれを買ったのか。
Music moves the feelings.	音楽は気持ちを動かします。
The music made the show.	音楽でそのショーは当たった。
I saw a town in the distance.	遠方に街が見えた。
It is wrong to tell a lie.	嘘を付くのは悪いことだ。
Take the road on the right.	右の道を行って下さい。
We've run short of oil.	われわれは石油が不足している。
How about another round?	もうちょっと飲んでいかない？
Don't avoid my question.	僕の質問を避けてはいけない。
He laid himself on the bed.	ベッドに身を横たえた。
Please pass me the butter.	バターを取ってください。
Why are you so happy?	なぜそんなにうれしがっているのか。
Please come dressed up.	ドレスアップしてきてください。
Tom has grown in strength.	トムは体力がついてきた。
Please remain standing.	どうか立ったままでいて下さい。
Please turn on the TV.	テレビのスイッチを入れて下さい。
Walk as fast as possible.	できるだけ速く歩きなさい。
Enjoy life while you may.	できるうちに人生を楽しめ。
Please help me with this.	ちょっと手伝ってください。
Hold your horses, young man.	ちょっと待って、君。
It was a chance meeting.	それは偶然の出会いであった。
Is that your carry-on?	それが機内持ち込みの荷物ですか。
Hand me that book, please.	その本を渡してください。
The ship gained on us.	その船は私たちの船に迫ってきた。
That car is quite up to date.	その車は最新式だ。
Don't worry about the work.	その仕事を心配するな。
I'm dead against the plan.	その計画には絶対反対だ。
Twenty years already passed.	すでに２０年経った。
I will write you back soon.	すぐに返事を書きます。
Please write back soon.	すぐに返事を書いてくださいね。
Write to him right away.	すぐに彼に手紙を書きなさい。
Jim runs as fast as Ron.	ジムはロンと同じ速さで走る。
Jane was dressed as a man.	ジェーンは男装していた。
Are you being waited on?	ご用をお伺いしておりますか。
May I have your order, please?	ご注文をどうぞ。
Please sign your name here.	ご署名をお願いします。
Write your address, please.	ご住所をお書き下さい。
Could you take this, please?	これをお願いします。
This size doesn't fit me.	これはサイズが合いません。
This dream will come true.	この夢は実現するだろう。
This rule does not apply.	この規則は当てはまらない。
How much is this dress?	このワンピースはいくらですか。
Please let me off here.	このあたりで降ろしてください。
Write your address here.	ここに住所を書いてください。
Stay here and wait for him.	ここで彼を待ちなさい。
Don't worry, be happy!	くよくよしないで、楽しく行こう！
Carl looked very happy.	カールはとても嬉しそうだった。
You trust people too much.	お前は人を信じすぎだよ。
Can I have some water, please?	お水をください。
What's your daughter's name?	お嬢さんのお名前は？
I'm trying to save money.	お金を貯めようとしている。
May you both be happy!	おふたりが幸せでありますように。
Please make yourself at home.	おくつろぎ下さい。
He is too ready to speak.	あの男はおしゃべりすぎる。
That big one is also mine.	あの大きいのも私のです。
That blue one is also mine.	あの青いのも私のです。
He is directly above me.	あの人が私の直属の上司です。
How fast that dog runs!	あの犬は何と速く走るのだろう。
You don't like music.	あなたは音楽が好きではありません。
How long did you wait?	あなたはどのくらい待ちましたか。
May I use your phone?	あなたの電話を使ってもいいですか。
I received your letter.	あなたの手紙を受け取りました。
I'll never forget you.	あなたのことは決して忘れません。
It is still as cold as ever.	相変わらずまだ寒い。
It's even very cold in May.	５月でさえとても寒い。
That's a beautiful dress.	とてもすてきな洋服ですね。
She came down with a cold.	彼女は風邪でダウンした。
Sorting will be done by hand.	人が選別業務をします
Someone has said clearly ～.	〜と誰かがはっきり言った
My skin is in good condition.	とても肌の調子が良い
X doesn't carry much weight.	Xにはあまり意味が無い
I really wonder about X.	私がXをつくづく疑問に感じます
I did not feel very cold.	私はあまり寒さを感じなかった
X received a lot of support.	Xが多くの支持を集めた
My husband finally came home.	ようやく旦那が帰った
He looks for the full picture.	彼が全貌を探ります
He always forgets the time.	彼がついつい時間を忘れる
Everyone held the thought.	誰もが、想いを胸にいだいた
He has five dogs at home.	彼が家で犬を５匹飼っています
Everyone asks me if it's X.	Xかとみんなが私に尋ねる
What color is good for me?	自分にはどんな色が似合うか
Give him my best regards.	あの方にくれぐれもよろしく。
I see the point of the argument.	論点がわかる。
Bring me some cold water.	冷たい水を持ってきて下さい。
You needn't worry too much.	余り心配しなくていいよ。
I didn't enjoy it very much.	余り楽しくなかったな。
Name and address, please.	名前と住所を言ってください。
Let sleeping dogs lie.	眠っている犬はそのままにしておけ。
My hair has grown too long.	僕の髪は長くなり過ぎた。
Don't forget to add me in.	忘れずに仲間に入れてくれ。
Don't forget to add me in.	忘れずに私を入れてくれよ。
Please go on with your study.	勉強を続けて下さい。
Look at the picture on the wall.	壁の絵を見て。
Everything has its limit.	物には限界というものがある。
Read "Gone With The Wind".	「風と共に去りぬ」を読む。
How much is the room charge?	部屋代はいくらですか？
Is there anyone in the room?	部屋には誰かいますか。
My father drinks no spirits.	父は蒸留酒は飲まない。
My father works for a bank.	父は銀行に勤めています。
Mt. Fuji is very beautiful.	富士山はとてもきれいだ。
Poor as he is, he is happy.	貧乏だけれど彼は幸福だ。
Want is the mother of industry.	貧困は勤勉の母。
She is in a green dress.	彼女は緑色のドレスを着ている。
She was down on her husband.	彼女は夫を嫌っていた。
She has a beautiful voice.	彼女は美しい声をしている。
She has large blue eyes.	彼女は大きな青い目をしている。
She is dressed in her best.	彼女は晴れ着を着ている。
She is a good friend of mine.	彼女は私の親友です。
She writes with her left hand.	彼女は左手で書く。
I don't think she is happy.	彼女は幸せでないと思う。
She wore a simple dress.	彼女は簡素なドレスを着ていた。
She was listening to music.	彼女は音楽を聞いていた。
She is interested in music.	彼女は音楽に興味がある。
She kept her eyes closed.	彼女は目を閉じたままでいた。
She is known to everyone.	彼女はみんなに知られている。
She chose the red dress.	彼女はその赤いドレスを選んだ。
She carried out the plan.	彼女はその計画を成し遂げた。
She will grow on John.	彼女はジョンの心をとらえるだろう。
I like her sister very much.	彼女の妹はとても好き。
I can't take my eyes off her.	彼女に見とれちゃう。
They may yet be happy.	彼らもいつか幸福になる日もあろう。
They supplied money to him.	彼らは彼にお金を与えた。
They searched for the girl.	彼らはその少女を捜した。
He is a boy with many dreams.	彼は夢多き少年です。
He walked along the street.	彼は通りを歩いて行った。
He is a promising young man.	彼は前途有望な青年だ。
He has learned to be patient.	彼は辛抱強くなった。
He made a small dog house.	彼は小さな犬小屋を作った。
He was affected by the heat.	彼は暑さに当てられた。
He writes me once a week.	彼は週に１回手紙をくれます。
He was run over and killed.	彼は車に轢かれて死んだ。
He seated himself next to me.	彼は私の隣に座った。
He wrote me a long letter.	彼は私に長い手紙をくれた。
He was dressed in black.	彼は黒ずくめの服装をしていた。
He has no manners at all.	彼は行儀作法を全く知らない。
He made a positive answer.	彼は肯定的な答えを出した。
He was by no means happy.	彼は決して幸福ではなかった。
He is interested in music.	彼は音楽に興味があります。
He watched from a distance.	彼は遠くから眺めていた。
He seems to have told a lie.	彼は嘘をついたらしい。
He turned up an hour later.	彼は一時間遅れて現れた。
He is quite young in spirit.	彼はまったく気が若い。
He grew larger and larger.	彼はだんだん大きくなった。
He wanted to buy the book.	彼はその本を買いたかった。
He may wait no longer.	彼はこれ以上待てないかもしれない。
He is free from money worry.	彼はお金の心配がない。
He seems to be lying.	彼はうそをついているように思われる。
He is rather hard to please.	彼はいささか気難しい。
He turned up an hour later.	彼は１時間遅れで現れた。
Please wait on him first.	彼に先に食事を出して下さい。
I saw him cross the street.	彼が道路を渡るのを見た。
Ability alone is not enough.	能力がすべてではない。
Heat is a form of energy.	熱はエネルギーの一種である。
Japan is a beautiful country.	日本は美しい国です。
Japan is full of surprises!	日本は驚きでいっぱいだ。
No wonder you are so happy.	道理で、君が喜ぶわけだ。
Let me buy you a new one.	同じのを買わせてちょうだい。
Keep the change, please.	釣り銭は取っておいてください。
Don't run across the street.	通りを走って横切るな。
I waited for her a long time.	長い間彼女をまった。
The man came to a dead stop.	男はぴたりと止まった。
Take a deep breath, please.	息を深く吸ってください。
Take a breath and hold it.	息を吸って、止めて下さい。
You should keep early hours.	早寝早起きをすべきだ。
You should keep early hours.	早寝早起きをしなさい。
The red dress became her.	赤いドレスは彼女に似合った。
Please do so by all means.	是非ともそうしてください。
It will be a nine-day's wonder.	人の噂も７５日。
I'll be with you in spirit.	心はあなたと共に居ます。
I'd like to pay by check.	小切手で支払いたいのですが。
Please speak in a low voice.	小声で話してください。
Are you ready to go out?	出かける準備はできていますか。
It was about the tenth hour.	時は１０時ごろだった。
We have to wait for him.	私達は彼を待たねばなりません。
I don't like her manner.	私は彼女の態度が気にくわない。
I waited for her to speak.	私は彼女が話すのを待った。
I want to surprise him.	私は彼をあっと言わせてやりたい。
I waved my hand to them.	私は彼らに向かって手を振った。
I trusted him with the money.	私は彼に金を預けた。
I had a chance to see him.	私は彼と会う機会があった。
I saw him cross the road.	私は彼が道路を渡るのを見た。
I met Fred on the street.	私は通りでフレッドに会った。
I held my breath and waited.	私は息を殺して待った。
I work for an oil company.	私は石油会社に勤めている。
Will you please help me?	私を手伝っていただけませんか。
I am writing a letter.	私は今手紙を書いているところです。
I am writing a letter now.	私は今手紙を書いています。
I was too happy to sleep.	私は幸福すぎて眠れなかった。
I saw an old friend of mine.	私は古い友人に会った。
I always had my eye on you.	私は君に目をつけていた。
I always keep my promises.	私は嘘をついたことがない。
That's just fine with me.	私はそれで一向に構いません。
I was moved by the music.	私はその音楽に感動しました。
I visited Kyoto long ago.	私はずっと前に京都に行った。
I'll never forget you.	私はいつまでもあなたを忘れません。
I ran as fast as possible.	私はできるだけ速く走った。
My temperature is 38 degrees.	私は熱が３８度ある。
Please take me to my seat.	私の席に案内してください。
Listen to me, will you?	私の言うことを聞いてくださいね。
Please note my words.	私のことばを注意して聞いてください。
Please show me this book.	私にこの本を見せてください。
We bought a round table.	私たちは丸いテーブルを買った。
In my eyes, he is wrong.	私から見れば彼が間違っている。
I feel so happy today.	私、今日はとっても幸せな気分なの。
Is death the only release?	死のみが唯一の解放なのか。
Please answer the phone.	済みません、電話に出て下さい。
There isn't much wind today.	今日は風があまりない。
There is little wind today.	今日はほとんど風がない。
London must be cold now.	今頃ロンドンは寒いに違いない。
She said that she was happy.	幸せだと彼女は言った。
Please stand face to face.	向かい合って立って下さい。
Give me your attention, please.	御注目ください。
The dog came running to me.	犬は私の方に走ってきた。
A dog can see in the dark.	犬は暗い所でも目が見える。
Don't worry about the results.	結果は気にするな。
You have no sense of direction.	君は方向音痴だ。
You didn't have to dress.	君は正装する必要は無かった。
Write your address here.	君の住所をここにお書きなさい。
I would like your picture.	君の写真が欲しいのですが。
What's become of your dog?	君の犬はどうなりましたか。
Open your book to page nine.	九ページを開きなさい。
Your daughter's on drugs.	貴殿の娘さんは麻薬漬けです。
May I have the check, please?	勘定をお願いします。
Each is good in its degree.	皆それぞれ取り柄がある。
The meeting lasted two hours.	会合は２時間続いた。
We learn to read and write.	我々は読み書きをならう。
Please do something about it.	何とかしてください。
I saw a house in the distance.	遠くの家が見えた。
What hours is it open?	営業時間は何時から何時までですか？
Help yourself to a drink.	飲み物を自由にお取り下さい。
Where is the nearest bank?	一番近い銀行はどこですか。
A day has twenty-four hours.	一日は二十四時間ある。
What on earth is the problem?	一体全体問題は何か。
Will you join me for a drink?	一緒に飲みませんか。
Latin is a dead language.	ラテン語は死んだ言語である。
Please say it once more.	もう一度おっしゃってください。
It's the dead of the night.	もうすっかり真夜中です。
Mayuko came directly home.	マユコはまっすぐ帰宅した。
Please let me speak first.	まず私に話させてください。
May I speak to Mike, please?	マイクをお願いします。
Mike is one of our brains.	マイクはブレーンの一人だ。
Please show me another one.	ほかのを見せてください。
I wonder which way to go.	どちらへ行けばよいのだろう。
He was put to death finally.	とうとう彼は殺された。
It seems to have worn out.	とうとうガタがきたようだ。
Please leave me alone.	どうか、私をほっておいてください。
So I can make music.	だから音楽を作り出すことができるのだ。
Can it really be mine?	それは本当に僕のものなんだろうか。
That applies to him too.	それは彼についても当てはまる。
How long ago was that?	それはどのくらい前のことでしたか。
I passed on the job to him.	その仕事を彼にゆずった。
The dog was out of breath.	その犬は息を切らしていた。
This dog is almost human.	その犬はまるで人間みたいだ。
Put the money in the bank.	その金を銀行に預けなさい。
The argument will not hold.	その議論は成りたたない。
How much were the glasses?	その眼鏡はいくらだったの。
I will write to him at once.	すぐ彼に手紙を書こう。
Jane looks very happy.	ジェーンはとても幸福そうに見える。
Jane looks very happy.	ジェーンはとても幸せそうにみえる。
Here, please have a seat.	さあ、どうぞお掛けください。
Are you ready to order now?	ご注文はお決まりですか？
Beyond this I know nothing.	これ以外は何も知らない。
All these books are mine.	これらの本は全部私の物です。
Check these papers over.	これらの書類に目を通してくれ。
This problem is beyond me.	この問題は私には解らない。
Hold fast to this tree.	この木にしっかりつかまりなさい。
Does your dress become me?	この服は私に似合いますか。
Let's keep an eye on this.	この事を注意して見守ろう。
The dog is as good as dead.	この犬は死んだも同然だ。
The glass is full of water.	コップは水でいっぱいだ。
The glass broke to pieces.	コップがこなごなに割れた。
Let's take a picture here.	ここで写真をとりましょう。
Kelly's voice carries well.	ケリーの声は、よく通る。
How far is it to the green?	グリーンまでどれくらい？
I'm very happy to know you.	お目にかかれて幸いです。
I'm pleased to see you.	お目にかかれてうれしく存じます。
May I use your phone?	お電話をお借りしてもよろしいですか。
You gave me the wrong change.	おつりが違いますよ。
Wait until further notice.	おって通知があるまで待て。
Our dog has gone away.	うちの犬がどこかへ行ってしまった。
Vienna is a beautiful city.	ウィーンは美しい都市だ。
I'm always under stress.	いつもストレスを感じています。
He seems like quite a find.	いい人みたいじゃないか。
Open your eyes to reality.	いい加減に現実をみつめろ。
Alice didn't see the dog.	アリスはその犬を見なかった。
Don't work yourself too hard.	あまり無理するなよ。
How old that dog is!	あの犬はなんて年をとっているのだろう。
How old is that church?	あの教会はどのくらい古いですか。
You will write a letter.	あなたは手紙を書くつもりです。
I'm happy to see you.	あなたにお目にかかれてうれしいです。
Add 5 to 3 and you have 8.	３に５を加えると８になる。
It'll pass in a few days.	２、３日もすればよくなるよ。
I was feeling blue all day.	１日中憂鬱な気分だった。
We will leave in an hour.	１時間後に出発するつもりだ。
I'll be back in an hour.	１時間経過すれば戻ってきます。
I will call you in an hour.	１時間したら電話します。
I have few pictures on hand.	手元にほとんど写真が無い
Return to the top of the page.	ページのＴＯＰに戻る
Return to the top of the page.	ページのトップへ戻る
He immediately bought a CD.	彼が早速１枚のＣＤを買った
The party finally started.	いよいよパーティーが始まった
As much as 100 years passed.	１００年に及ぶ年月を経た
The leaves have begun to color.	葉が色付き始めた。
Don't go back on your promise.	約束を破らないでよ。
The leaves fell to the earth.	木の葉が地上に落ちた。
I go to church every Sunday.	毎日日曜教会へ行きます。
I feel good in a special way.	僕は特別気持ちがいい。
I am not in the least happy.	僕は少しも幸せじゃない。
I started last in the race.	僕はスタートで一番遅れた。
I feel the cold very much.	僕には寒さがひどくこたえる。
There isn't anyone in the room.	部屋に誰もいない。
She kept her eyes closed.	彼女は目を閉じたままであった。
She writes me every week.	彼女は毎週私に手紙を書きます。
She is in bed with a cold.	彼女は風邪を引いて寝ている。
She said she had a cold.	彼女は風邪を引いていると言った。
She is wearing a long face.	彼女は浮かぬ顔をしている。
She wore a beautiful dress.	彼女は美しいドレスを着た。
She applied to him for help.	彼女は彼に助けを求めた。
She is in low spirits today.	彼女は今日、元気がない。
She is as beautiful as ever.	彼女は相変わらず美しい。
She tried on a new dress.	彼女は新しいドレスを試着した。
She writes a very good hand.	彼女は字がすごくうまい。
She has her heart in music.	彼女は音楽に集中している。
She likes music very much.	彼女は音楽がとても好きです。
She's in the least worried.	彼女はとても気にしていた。
Where did she buy a book?	彼女はどこで本を買いましたか。
She dressed herself quickly.	彼女はすばやく服を着た。
She is even more beautiful.	彼女はさらにもっと美しい。
She wore a green dress.	彼女はグリーンのドレスを着ていた。
She is certain to be surprised.	彼女はきっと驚く。
There was fear in her eyes.	彼女の目には恐怖があった。
I felt her eyes on my back.	彼女の視線を背中に感じた。
Her house is very modern.	彼女の家はたいへん現代的です。
She's going to be in charge.	彼女が責任者になる人だ。
Have him wait a moment.	彼をちょっと待たせておいて下さい。
Please let him come at once.	彼をすぐこさせて下さい。
They waited for their teacher.	彼らは先生を待った。
They named the dog Shiro.	彼らはその犬にシロと名付けた。
Poor as he is, he is happy.	彼は貧しいけれども幸福だ。
He is a man of great ability.	彼は非常に有能である。
He bought a dress for her.	彼は彼女に服を買ってやった。
He took office two years ago.	彼は二年前に就任した。
He was crossing the street.	彼は道路を渡りつつあった。
He's writing a long letter.	彼は長い手紙を書いている。
He's leading a dog's life.	彼は生活がみじめなんですよ。
He has been writing a letter.	彼は手紙を書き続ける。
He is just killing time.	彼は時間稼ぎをしているだけだよ。
He wrote me a love letter.	彼は私にラブレターをくれた。
He found me a good seat.	彼は私にいい席をみつけてくれた。
I wonder where he is now.	彼は今どこに居るのか知らない。
He is respected by everyone.	彼は皆に尊敬されている。
He gave three wrong answers.	彼は答えを三つ間違えた。
I wonder where he has gone.	彼はどこへ行ったのかしら。
He ran as fast as he could.	彼はできるだけ速く走った。
He wrote a lot of stories.	彼はたくさんの物語を書いた。
He applied for the position.	彼はその地位を志願した。
He made a fine job of it.	彼はその仕事をりっぱにやった。
He is far from being happy.	彼はぜんぜんうれしくない。
He can't run very fast.	彼はあまり速く走ることができない。
He couldn't run very fast.	彼はあまり速く走れなかった。
He turned up an hour later.	彼は１時間後にやって来た。
He enjoyed those visits.	彼は、家に行くのが楽しみでした。
He seems to have been happy.	彼は幸福であったようだ。
What he did is not wrong.	彼のしたことは間違っていない。
I wrote a long letter to him.	彼に長い手紙を書いた。
He has two beautiful boys.	彼には立派な息子が２人いる。
I dream of seeing him there.	彼とここで会うのが夢だ。
He is in charge of the class.	彼がその学級の担任だ。
We saw a white ship far away.	白い船が遠くに見えた。
The door opens to the road.	入り口は道路に面している。
Keep out of the way, please.	道を開けておいて下さい。
Protect yourself at all points.	頭隠して尻隠さず。
We will continue the discussion.	討論を継続する。
Might I use your phone?	電話をお借りしてもよいでしょうか。
As it is fine, I'll go out.	天気がいいので出かけよう。
Hold onto your husband.	旦那様をしっかり捕まえていなさい。
Who is the person in charge?	担当の方はどなたですか。
Our water supply is very short.	大変な水不足です。
Please take care of yourself.	体を大切にして下さい。
Many promises had been made.	多くの約束もされていた。
The ship touched at Yokohama.	船は横浜に立ち寄った。
The teacher had a bad cold.	先生がひどい風邪をひいた。
I'd like to change my seat.	席を替えてほしいのですが。
May I have a glass of water?	水を一杯いただけますか。
I'd like a glass of water.	水をいっぱいほしいんだけど。
Life is indeed a good thing.	人生とは実にいいものだ。
Man has the ability to talk.	人間には話す能力がある。
Food has been in short supply.	食糧が不足している。
Do you have anything to write?	書く事がありますか。
Wait until your turn comes.	順番が来るまで待ちなさい。
Enjoy yourself to the fullest.	十分に楽しみなさい。
Please contact me by letter.	手紙で連絡してください。
Put the question in writing.	質問は書面にして下さい。
I sometimes go out for a walk.	時々散歩にでかける。
We all have passed the test.	私達全員が試験に通った。
I believe in the life beyond.	私は来世があると思う。
I'm coming down with a cold.	私は風邪にかかりそうだ。
I waited for him for an hour.	私は彼を1時間待った。
I enjoyed talking with him.	私は彼と話すのを楽しんだ。
I feel good in a special way.	私は特別気持ちがいい。
I walked across the street.	私は通りを歩いて横切った。
I have a big black dog.	私は大きくて黒い犬を飼っています。
I couldn't believe my eyes.	私は自分の目をうたがった。
I had my picture taken.	私は私の写真をとってもらいました。
I read fifty pages further.	私は更に５０ページ読んだ。
I found the book by chance.	私は偶然その本を見つけた。
I'd be happy to help you.	私は喜んであなたを手伝います。
I can read without glasses.	私は眼鏡なしで読書できる。
I like listening to music.	私は音楽を聴くのが好きです。
I am listening to the music.	私は音楽を聴いています。
I regarded Tom as a friend.	私はトムを味方とみなした。
I generally walk to school.	私は大抵歩いて通学します。
The sound took me by surprise.	私はその音に驚いた。
I visited Paris long ago.	私はずっと以前にパリに訪れた。
I want to stress this point.	私はこの点を力説したい。
I had my picture taken.	私は、自分の写真を撮ってもらった。
Listen to what I have to say.	私の話を聞いて下さい。
Hear me out, please.	私の話を最後まできちんと聞いてください。
My daughter is but a child.	私の娘は、ほんの子供です。
My father works for a bank.	私の父は銀行に勤めている。
My brother has a good memory.	私の弟は記憶力がよい。
Charge it to my account.	私の勘定につけておいてください。
All are happy in my family.	私の家族のものは皆幸福だ。
Bring me a glass of water.	私に水を１杯持って来てくれ。
Please write a letter to me.	私に手紙を書いて下さい。
Please tell me your name.	私に君の名前を教えてください。
We are keeping a big dog.	私たちは大きな犬を飼っている。
We bought the man's house.	私たちはその男の家を買った。
I have a touch of a cold today.	今日は風邪気味だ。
It's simply too cold today.	今日は寒くてしょうがない。
You aren't yourself today.	今日はいつもの君らしくない。
This time my goal is Paris.	今回私の目的地はパリです。
Buy any dress you like.	好きなドレスをどれでも買いなさい。
I can't wait for you.	君を待っていなければならないのだから。
You should keep your promise.	君は約束を守るべきだ。
You are not at all wrong.	君は必ずしも間違ってはいない。
You must control yourself.	君は自制しなければならない。
Please go on with your story.	君の話を続けて下さい。
What's become of your dog?	君の犬はどうなったのだろう。
Let's carry on the discussion.	議論を続けましょう。
Please think nothing of it.	気になさらないでください。
The CD on the table is mine.	机の上のＣＤは私のです。
We'd like separate checks.	勘定書は別々にお願いします。
I met a dog on my way home.	家に帰る途中で犬に会った。
I saw a light in the distance.	遠くに灯火が見えた。
Take your chance, and do it.	運試しだ、やってごらん。
Where's the nearest church?	一番近い教会はどこですか。
Would you join me in a drink?	一杯付き合いませんか。
A man appeared at the site.	一人の男がその場に現れた。
Try to avoid bad company.	悪友を避けるように努めなさい。
Everyone calls him Jeff.	みんなは彼をジェフと呼んでいる。
Are you ready to eat?	みなさんは食べる用意ができていますか。
I don't want to feel blue.	ブルーな気分になりたくない。
You look very good in blue.	ブルーがよく似合いますね。
Hiromi wears a new dress.	ヒロミは新しい洋服を着ている。
I'd like to buy a Picasso.	ピカソの絵を買いたいものだ。
What a fast horse that is!	なんて速い馬なんだ、あれは！
I may indeed be wrong.	なるほど私が間違ってるかもしれない。
Tom walked across the street.	トムは通りを横切った。
Tom held a seat for me.	トムは私の席を取っておいてくれた。
How fast Tom speaks!	トムはなんてしゃべるのが速いのでしょう。
It's a very becoming dress.	とてもよく似合う服ですよ。
I seem to have a temperature.	どうも熱があるらしい。
Pass down the car, please.	どうぞ中ほどへお進み下さい。
Help yourself, please.	どうぞご自由に召しあがってください。
How can I forget those days?	どうしても忘れられない。
Turn on the light, please.	どうか明かりをつけて下さい。
Turn off the light, please.	どうか電灯を消して下さい。
Could you please help me?	ちょっとお願いしたいのですが。
No one can separate them.	だれも彼らの仲を引き裂けない。
You probably just have a cold.	ただの風邪でしょう。
It's for a friend of mine.	それは友達に上げるものです。
It's the same for everyone.	それは誰にだって同じ事だ。
You must do it yourself.	それは自分でしなくてはいけない。
It is not to be wondered at.	それは驚くに当たらない。
It grew larger and larger.	それはだんだん大きくなった。
Are you making a pass at me?	それ、私を口説いてるの？
The old man is hard to please.	その老人は気難しい。
The street is full of cars.	その通りは車でいっぱいだ。
I am pleased with the result.	その結果に喜んでいる。
The plan is under discussion.	その計画は討議中です。
The picture is true to life.	その絵は本物そっくりだ。
The picture is true to life.	その絵は実物そっくりだ。
How does the film end?	その映画の結末はどうなっていますか。
Will you please go there?	そこへ行っていただけませんか。
Please answer the phone.	すみませんが電話に出てください。
I will write to you soon.	すぐに君に手紙を書きましょう。
Did you plan it yourself?	ご自分で設計なさったのですか。
These pictures are beautiful.	これらの写真は美しい。
These glasses are beautiful.	これらのコップは美しい。
This is your only chance.	これは君には唯一の機会である。
This surprised many people.	これには多くの人が驚いた。
This room will soon heat up.	この部屋はすぐに暖まる。
This road leads you there.	この道を行くとそこへ出ます。
You can't go along this road.	この道は通れませんよ。
This car is in good condition.	この車は調子がいい。
This task took three hours.	この仕事は三時間かかった。
How old is this church?	この教会はどれくらい古いんですか。
This school has no heating.	この学校は暖房設備がない。
This dress is YOU.	このワンピースは、君の雰囲気にぴったりだね。
Please do it this way.	このようにして、それをやって下さい。
Please develop this film.	このフィルムを現像して下さい。
Let's go along this street.	このとおりを行きましょう。
Put yourself in my position.	こっちの身にもなってよ。
I will grow many trees here.	ここにたくさん植えよう。
Ken likes music very much.	ケンは音楽がとても好きです。
Green doesn't go with red.	グリーンは赤と調和されない。
May I have your name, please?	お名前をお願いします。
May I have a glass of water?	お水を１杯もらえますか。
I am pleased at your coming.	お出で下さってうれしい。
Please leave some money.	お金をいくらか残しておきなさい。
May I have the check, please?	お勘定をお願いします。
Our son was killed in action.	うちの息子は戦死した。
When did you see the film?	いつその映画を見たのですか。
It's a beautiful day, isn't it?	いいお天気ですね。
Those are my sister's books.	あれらは私の妹の本です。
What a big ship that is!	あれはなんて大きい船なんだろう。
That small one is also mine.	あの小さいのも私のです。
You told me so yourself.	あなた自身にそう言ったのですよ。
Did you get over the cold?	あなたは風邪が治りましたか。
Are you writing a letter?	あなたは手紙を書いていますか。
Come and write your name.	あなたの名前を書きに来なさい。
What's become of your dog?	あなたの犬はどうしましたか。
Your order is ready.	あなたのご注文なさった商品が届きました。
Please explain it to me later.	あとで教えて下さい。
Add 5 and 2, and you get 7.	５と２を加えると７になる。
Write in less than 50 words.	５０語以内で書きなさい。
It is easy to add 5 to 10.	５＋１０の足し算はやさしい。
It's rather cold for April.	４月にしては、寒い方です。
Two hours is too long to wait.	２時間も待てないよ。
Give me $1.00 back, please.	１ドルお釣りをくださいな。
She has a bad head cold.	彼女はヒドイ鼻かぜをひいている。
My brother has a good memory.	弟は記憶力がいいです。
I grew up eating Japanese food.	私は和食で育った。
There is a natural limit to X.	Xには自ずと限界が有る
He doesn't listen to anyone.	彼が全然人の話しを聞かない
He finally got that book.	彼がやっとその本を手に入れました
X will save children's lives.	Xが子どもの命を守ります
It takes measures immediately.	それが直ちに措置を取る
Everyone worked together for X.	Xに皆が力を合わせた
I can't keep my eyes off her.	彼女からもう目が離せない
My doubts have been cleared up.	疑問が氷解しました！
Yoko bought some of them.	洋子はそれらのいくつかを買った。
What are the visiting hours?	面会時間を教えてください。
Feel light at heart; feel happy.	明るい気分になる。
You may get it free of charge.	無料でそれが得られる。
I go to church every Sunday.	毎日曜日に教会に行きます。
I go to church every Sunday.	毎週日曜日教会へ行きます。
I have bought a lot of books.	本をたくさん買ったんだ。
I turn over a page of the book.	本のページをめくる。
Have you sent in your report?	報告書を提出しましたか。
My mother took my temperature.	母は私の体温を計った。
There is a limit to everything.	物事には限度がある。
Was there anyone in the room?	部屋には誰かいましたか。
She made her mother happy.	彼女は母さんを幸せにしました。
She met him three years ago.	彼女は彼に３年前に会った。
She is as beautiful as ever.	彼女は相変わらずきれいだ。
She is wearing a blue dress.	彼女は青い服を着ています。
She had a new dress made.	彼女は新しい服を作ってもらった。
She wrote me a long letter.	彼女は私に長い手紙をくれた。
She seems to have been happy.	彼女は幸せだったようだ。
She was by no means happy.	彼女は決して幸福ではなかった。
She was by no means happy.	彼女は決して幸せではなかった。
She covers Wall Street.	彼女は金融市場の取材を担当している。
She ran as fast as she could.	彼女は一生懸命に走った。
She is applying the glasses.	彼女はメガネをかけている。
The color of her eyes is blue.	彼女の目の色は青です。
Her voice carries very well.	彼女の声はとても良く通る。
Ask her what she bought.	彼女が何を買ったかきいてみなさい。
I received a letter from her.	彼女から手紙をもらった。
She is beautiful and how!	彼女、美しいのなんのって・・・！
They watched their chance.	彼らは好機を訪れるのを待った。
They came round about.	彼らはぐるっと回り道をしてやってきた。
He received a good education.	彼は立派な教育を受けた。
He watched with the patient.	彼は病人を寝ずに看病した。
He will be waiting for her.	彼は彼女を待っているだろう。
He waited until she came.	彼は彼女がやってくるまで待った。
He couldn't bear the heat.	彼は熱さにがまんできなかった。
He comes from the middle class.	彼は中流階級の出だ。
He is a man whom we can trust.	彼は信頼できる男です。
He is lacking in common sense.	彼は常識に欠けている。
He was standing on the floor.	彼は床の上に立っていた。
He is still green in business.	彼は商売はまだ未熟だ。
He has been dead for ten years.	彼は十年前に死んだ。
He did a check on the quality.	彼は主要点を点検した。
He made reference to my book.	彼は私の著書に言及した。
He is an old friend of mine.	彼は私の昔からの友達です。
He explained the rule to me.	彼は私にルールを説明した。
He wrote away for a sample.	彼は見本請求の手紙を書いた。
It seems that he is wrong.	彼は間違っているように思える。
He writes an English letter.	彼は英語の手紙を書きます。
He came home in high spirits.	彼は意気揚々と帰宅した。
He closed the door suddenly.	彼はばたんとドアを閉めた。
He wrote a story just now.	彼はちょっと前に物語を書いた。
He is leading a fast life.	彼はだらしない生活をしている。
He always makes a ready answer.	彼はいつも即答する。
He is always day-dreaming.	彼はいつも空想にふけっている。
He comes round once a week.	彼は１週間に１度やって来る。
I had a phone call from him.	彼から電話がかかってきた。
Do you have a dress in white?	白いドレスはありますか。
A horse can run very fast.	馬はとても速く走る事ができる。
I work every day save Sundays.	日曜日以外は毎日働く。
Write in the date yourself.	日付は自分で書き込みなさい。
Please walk back a few steps.	二、三歩下がって下さい。
Tokyo is the capital of Japan.	東京は日本の首都です。
Hold the line, please.	電話を切らないでそのままお待ち下さい。
Watch out for passing cars.	通過する車に気をつけなさい。
I passed a boy in the street.	通りで少年とすれ違った。
The pain will wear off.	痛みはだんだん無くなっていくだろう。
Have I kept you waiting long?	長いこと待たせましたか。
The entire town was under water.	町全体が水没した。
Please go and see who it is.	誰だか見に行ってください。
Who lives in the room below?	誰が階下に住んでいますか。
Have you been waited on?	誰かが御用を伺っているでしょうか。
We flew across the Atlantic.	大西洋を飛行機で横断した。
Let me take your temperature.	体温を計ってみましょう。
Would you like a window seat?	窓側の席をご希望ですか。
Make it a window seat please.	窓際の席にしてください。
Move up to the front, please.	前のほうに進んで下さい。
You don't have to dress up.	盛装なさる必要はありません。
Please give me a glass of water.	水を一杯ください。
A new argument was presented.	新たな議論が提起された。
What is the use of worrying?	心配して何の役に立つのか。
Will you take a personal check?	小切手は使えますか。
I need something to write with.	書くものが欲しいな。
I have to write a letter.	書かねばならない手紙があります。
Please show me your picture.	写真をどうぞ見せて下さい。
Other times, other manners.	時代が変われば風習も変わる。
Follow me to a fitting room.	試着室にご案内いたします。
You as well as I are wrong.	私同様あなたも間違っている。
Stop talking and listen to me.	私語をやめて話を聞け。
I came upon a friend of mine.	私は友人とふと出会った。
I talked to her for an hour.	私は彼女と１時間話をした。
I wrote him to ask why.	私は彼になぜかと尋ねる手紙をかいた。
I waited more than two hours.	私は二時間以上も待った。
I saw her a week ago today.	私は先週の今日彼女に会った。
I am going to buy a new car.	私は新車を買うつもりです。
I will fight to the last breath.	私は死ぬまで戦う。
I chanced talking to her.	私は思い切って彼女に話しかけた。
I just flew in on business.	私は仕事でさっきつきました。
I had a good dream last night.	私は昨夜良い夢を見た。
I wrote a letter last night.	私は昨夜手紙を書きました。
I had a bad dream last night.	私は昨夜いやな夢を見た。
I want to live a happy life.	私は幸福な生活を送りたい。
I am running short of memory.	私は記憶が不足している。
I'd be happy to help you.	私は喜んであなたの援助をします。
I am ready to follow you.	私は喜んであなたのお供をします。
I have given myself to music.	私は音楽に熱中していた。
I can wait for him no longer.	私はもはや彼を待てない。
I'm happy to see you again.	私はまた君に会えてうれしい。
I'm going to Hawaii by ship.	私はハワイへ船で行きます。
I have a lot of pictures.	私はたくさん写真を持っています。
I saw it with my own eyes.	私はそれを自分自身の眼でみた。
I felt for the poor dog.	私はそのかわいそうな犬に同情した。
I parted from her long ago.	私はずっと前に彼女と別れた。
I visited Canada long ago.	私はずっと前にカナダを訪れた。
I am not liked by this dog.	私はこの犬に好かれていない。
I waited for him all day long.	私は１日中彼を待った。
Put yourself in my place.	私の立場になって考えてください。
My dog goes to its house.	私の犬は自分の犬小屋に帰ります。
My brother works in a bank.	私の兄弟は銀行で働いている。
Charge this to my account.	私のカードにつけておいてくれ。
We took a direct road to town.	私たちは町へ直行した。
We all live on the earth.	私たちはみんな地球に住んでいる。
We all enjoyed the film.	私たちはみんなその映画を楽しんだ。
We named the dog White.	私たちはその犬をホワイトと名付けた。
Could you take our picture?	写真を撮っていただけますか。
Children grow up so quickly.	子供の成長は驚くほど早い。
My sister is subject to colds.	姉は風邪をひきやすい。
Don't worry about your work.	仕事のことは心配しないで。
It was very cold this morning.	今朝はとても寒かった。
Can you page someone for me?	呼び出していただけますか。
The dog looked into the water.	犬は水の中をのぞいた。
A dog is a man's best friend.	犬は人間の最良の友です。
Dogs see in black and white.	犬は黒と白の見分けがつく。
A dog followed me to my house.	犬が家までついて来た。
I always feel blue on Mondays.	月曜日はいつも憂鬱だ。
It'll add to the same thing.	結局は同じ事になるだろう。
The result is still in doubt.	結果はまだ不確かである。
I have a surprise for you.	君をびっくりさせるものがある。
Your letter made me happy.	君の手紙で私はうれしくなった。
All you can do is to wait.	君にできるのは待つことだけだ。
I'll take my chances with you.	君と運命を共にしよう。
All you have to do is wait.	君ただ待ってさえすればいい。
You may as well go yourself.	君が自分で行ってもいいよ。
How late is the bank open?	銀行は何時まで開いていますか。
He came in fifth in the race.	彼は競争で５着になった。
It is you who is in the wrong.	間違っているのは君だ。
How many pictures did you buy?	絵を何枚買いましたか。
How did you enjoy the party?	会はおもしろかったですか。
Don't worry about the past.	過去のことをくよくよするな。
We are not cold in the house.	家の中は寒くありません。
The price reflects the demand.	価格は需要を反映する。
Will you give us a statement?	何か述べてくれませんか。
The door gave to my pressure.	押したらその戸はあいた。
I was here about a year ago.	一年前くらい前に来ました。
Try to avoid bad company.	悪い仲間を避けるようにしなさい。
Love makes the world go round.	愛の力は世界を動かす。
I wish you a Happy New Year.	よいお年をお迎えください。
Show me how to do it, please.	やり方を教えてください。
I can wait for him no longer.	もう彼のことを待てない。
No one trusts him any more.	もう誰も彼を、信用してない。
I am looking for my glasses.	メガネを探しているんだよ。
Mac is loved by everyone.	マックはみんなから好かれている。
Hitomi looked very happy.	ひとみはとても楽しそうにみえた。
What a beautiful picture!	なんてキレイな写真なんでしょう。
Nancy looks like my sister.	ナンシーは私の姉に似ている。
Nancy is stressed out.	ナンシーはストレスでダメになっている。
What sort of work do you do?	どんな仕事をしていますか。
How long will we have to wait?	どれくらい待ちますか。
Tom made Jill a new dress.	トムはジルに新しい服を作った。
Is something wrong with you?	どこか具合が悪いのですか。
Please make way for him.	どうぞ彼のために道をあけて下さい。
Please make yourself at home.	どうぞ楽になって下さい。
Please come in one by one.	どうぞ一人ずつお入りください。
Please stay as long as you wish.	どうぞごゆっくり。
Please make yourself at home.	どうぞおくつろぎ下さい。
Please help yourself.	どうぞ、食べ物をご自由にお取りください。
Please make yourself at home.	どうか楽にしてください。
Please make yourself at home.	どうかおくつろぎ下さい。
Don't let opportunities pass by.	チャンスを逃すな。
That will fly on the market.	それは売れ足が早いですよ。
That was only a year ago.	それはほんの１年前のことだった。
Cross the road with care.	その道路は気をつけて渡りなさい。
The road came to a dead end.	その道は行き止まりだった。
Did you receive the letter?	その手紙を受け取りましたか。
The dog was run over by a car.	その犬は車にひかれた。
Is the bank far from here?	その銀行はここから遠いですか。
I had him in that discussion.	その議論で彼を論破した。
I bought the TV from her.	そのテレビは彼女から買ったんだ。
The idea made my soul rise.	そう思うと私の心は高ぶった。
I will write to you soon.	すぐあなたに手紙を書きましょう。
We made a date to meet soon.	じきにまた会う約束をした。
Cut this into very fine pieces.	これを寸断してくれ。
Bear these rules in mind.	これらの規則を覚えておきなさい。
This is the best thing on earth.	これは天下一品だ。
This problem seems difficult.	この問題は、難しそうだ。
This book seems easy to me.	この本は私には簡単に思える。
Is there a bank near here?	この辺りに銀行はありませんか。
Can he write this character?	彼はこの文字が書けますか。
This room is air-conditioned.	この部屋は冷房してある。
Send this letter by air.	この手紙を航空便で出してください。
The rule reads in two ways.	この規則は二通りに読めます。
The picture is true to life.	この絵は実物にそっくりだ。
This rose is very beautiful.	このバラはとてもきれいだ。
May I try on this dress?	このドレスを試着してもいいですか。
Don't share this with anyone.	このことは誰にも言うな。
This glass contains water.	このコップには水が入っている。
Come over here and join us.	ここへきて仲間に入りなさい。
Ken runs faster than you.	ケンはあなたよりも速く走ります。
Your knowledge surprises me.	きみの博識は私を驚かせる。
Come on! Give me a chance.	お願いだ！俺にチャンスをくれ。
I can't give up on my dreams.	オレは夢を捨てられない。
What are you eyeing?	おまえの目はいったいどこについているんだ。
We call our dog Johnnie.	うちの犬はジョニーと呼ばれている。
Please call me at any time.	いつでも電話をしてください。
Can anyone believe you?	いったい誰が君の話を信じるだろうか。
I wonder when Anne will come.	アンはいつ来るのかしら？
You are quite in the wrong.	あなたは全く間違っています。
May I have your name, please?	あなたの名前は何ですか。
May I take your picture?	あなたの写真を撮ってもいいですか。
Choose a dress you like.	あなたのすきなドレスを選びなさい。
It is a cold morning for June.	６月にしては寒い朝だ。
I'll be back within two hours.	２時間以内に戻ります。
I'll be back within an hour.	１時間以内に戻ってきます。
Everything is fine so far.	今のところはすべて申し分無い。
At what hour was she born?	彼女は何時に生まれたんですか。
Who cares about bad manners?	無礼もヘチマもあるものか。
Everyone's heard that once.	その言葉を誰もが一度は耳にした
It is said that is effective.	それが効果的と言われている
I understood X very clearly.	Xが、はっきりと分かりました
He played the music with me/them.	彼が一緒に音を出す
I don't see anyone else at all. 	全く人の姿が見えない
It will produce more effect.	それがさらに効果を発揮します
It's around the city center.	それがほぼ街の中心に位置する
I felt like I was protected.	自分が護られている様に思えた
It's too early to check in.	まだチェックインには時間が早い
X is finally more likely.	Xがいよいよ現実味を帯びてきました
Everyone holds each other's hands.	みんなで手を繋ぐ
The two roads cross there.	二本の道はそこでクロスしている。
Would you please stop talking?	話をやめてくれませんか。
Let's be done with the argument.	論議を終えましょう。
That's the spirit, Mr Suzuki.	鈴木さん、その意気ですよ。
I'm going by the post office.	郵便局のそばを通ってるよ。
We must not break our promise.	約束を破ってはいけない。
I want you to keep your promise.	約束を守って欲しい。
I quite forget your name.	名前をすっかり忘れてしまいました。
May all my dreams come true.	夢がすべてかないますように。
Should it be fine, I will go.	万一天気なら私は行きます。
My house looks toward the sea.	僕の家は海に面している。
Trade helps nations develop.	貿易は諸国の発展を促進する。
There is a picture on the wall.	壁に絵が掛かっている。
A lot of colds are going around.	風邪がはやっている。
Could I see the room please?	部屋を見せていただけますか。
She wrote down what he said.	彼女は彼の言葉を書き留めた。
She has a small black dog.	彼女は小さな黒い犬を飼っている。
She attempted to kill herself.	彼女は自殺しようとした。
She found me a good seat.	彼女は私によい席を見つけてくれた。
She says that she is happy.	彼女は幸せであると言っている。
She seems to have been happy.	彼女は幸せであったようだ。
She is by no means beautiful.	彼女は決して美人ではない。
She waited for hours and hours.	彼女は何時間も待った。
What is she worried about?	彼女は何を心配しているのですか。
She kissed me like anything.	彼女ははげしく私にキスした。
She especially likes music.	彼女はとりわけ音楽が好きです。
She ran as fast as possible.	彼女はできる限り速く走った。
She ran as fast as possible.	彼女はできるだけ速く走った。
She began to talk to the dog.	彼女はその犬に話し始めた。
I don't particularly like her.	彼女はあまり好きでない。
She passed away two days ago.	彼女は２日前に亡くなった。
She could pass for twenty.	彼女は２０歳といっても通用する。
She came back an hour later.	彼女は１時間後に帰ってきた。
I enjoyed talking with her.	彼女とのおしゃべりを楽しんだ。
I will wait until she comes.	彼女が来るまで待つつもりだ。
She has been dead five years.	彼女が死んで５年たちます。
Can she get the law degree?	彼女、法律の学位は取れますか。
They will keep their promise.	彼らは約束を守るでしょう。
They seem to go together.	彼らは釣り合いがとれているようだ。
Are they writing a letter?	彼らは手紙を書いているのですか。
Do they take care of the dog?	彼らは犬の世話をしますか。
They lacked for nothing.	彼らは何一つ不自由なものはなかった。
They are talking about music.	彼らは音楽の話をしている。
They carried out the project.	彼らはその計画を実行した。
They work eight hours a day.	彼らは１日に８時間働きます。
He showed me her picture.	彼は僕に彼女の写真を見せてくれた。
He gave her a piece of paper.	彼は彼女に紙を１枚あげた。
He was waiting for a long time.	彼は長い間待っていた。
He came back home a while ago.	彼は先程家に帰ってきた。
He had been writing a letter.	彼は手紙を書き続けていた。
He comes to meet me sometimes.	彼は時々私に会いに来る。
He showed us some pictures.	彼は私達に写真を見せてくれた。
He does not run as fast as I.	彼は私ほど速くは走らない。
He is a good husband to me.	彼は私にとって良い夫なんです。
He is in the banking line.	彼は銀行関係の仕事をしています。
There is nothing wrong with him.	彼は何処も悪くない。
He came home in high spirits.	彼は意気揚々と引き返した。
He kept me waiting on purpose.	彼はわざと私を待たせた。
He has become a memory.	彼はもはや思い出の人となってしまった。
He looks blue for some reason.	彼はなぜかふさいでいる。
Which direction did he go?	彼はどっちの方向へ行きましたか。
No doubt he will come later.	彼はたぶん後から来るだろう。
He laid claim to the land.	彼はその土地の所有権を主張した。
He left everything to chance.	彼はいっさいを運に任せた。
He was listening to music.	彼は、音楽に聞き入っていました。
He has an eye for the beautiful.	彼には審美眼がある。
He feels the cold very much.	彼には寒さがとてもこたえる。
He kept me waiting for an hour.	彼に１時間待たされた。
The horse would not move.	馬はどうしても動こうとしなかった。
Japan was hard up for oil.	日本は石油が不足して困っていた。
The capital of Japan is Tokyo.	日本の首都は東京である。
He was suddenly very happy.	突然とてもうれしくなりました。
The road rises from there.	道はそこから上り坂になっている。
Effort produces fine results.	努力は良い結果を生み出す。
Please hold on a moment.	電話を切らずにちょっとお待ち下さい。
Are you through with the phone?	電話もうおすみですか。
Did you see anyone run away?	誰かが逃げるのを見ましたか。
Have you been waited on?	誰かがご用を伺っているのでしょうか。
The price of oil is going up.	石油の値段が上がっている。
Keep an eye on the girls.	女の子たちから目を離さないように。
Don't forget to write to me.	手紙を書くのを忘れないでね。
I'm saving money for a car.	車を買うために貯金をしている。
Time is pressing every moment.	時間が刻々と迫っている。
We lived close by the sea.	私達は海のすぐそばに住んでいた。
We came in view of the sea.	私達は海が見えるところに来た。
I go to church every Sunday.	毎週日曜日は教会に行きます。
I left earlier than my sister.	私は妹より早く出発した。
I talked with her for an hour.	私は彼女と一時間話した。
I received a letter from her.	彼女から手紙を受け取った。
I called him up on the phone.	私は彼を電話に呼び出した。
I explained the rule to him.	私は彼にその規則を説明した。
I have nothing special to say.	私は特に言うことはない。
I met him in Tokyo by chance.	私は東京で偶然彼に会った。
I walked about the street.	私は通りをあちこち歩きまわった。
I'm not in the least worried.	私は少しも心配していない。
I am going to write a letter.	私は手紙を書くつもりです。
I saw it with my own eyes.	私は自分の目でそれを見たのです。
I saw it with my own eyes.	私は私自身の目でそれを見たのだ。
I had a bad dream last night.	私は昨晩悪い夢を見ました。
I passed a test in Japanese.	私は国語のテストに受かった。
I have to go to the bank.	銀行に行かなければいけないんです。
I am running short of memory.	私は記憶力が不足している。
I am ready to go with you.	私は喜んであなたとご一緒します。
I took a picture of my family.	私は家族の写真を撮った。
I wrote a letter in English.	私は英語で手紙を書きました。
I do not trust him any longer.	私はもう彼を信用しない。
I wrote my name on the paper.	私はその紙に名前を書いた。
I was able to pass the test.	私はそのテストに合格できた。
I grew up in this small town.	私はこの小さな町で育った。
I will apply for help to him.	私はかれに助けを求めよう。
I am ready to help you.	私はいつでもあなたのお手伝いをします。
I ran as fast as I could.	私はありったけの力を出して走った。
I want a picture of that dog.	私はあの犬の写真がほしい。
I came to Japan two years ago.	私は２年前に日本に来た。
I wrote a letter to my mother.	私は、母に手紙を書いた。
I had him take my picture.	私は、彼に写真を撮ってもらった。
I met an old friend by chance.	私は、偶然旧友に会った。
I made that dress by myself.	私は、一人でその服を縫った。
My friend died from a wound.	私の友達は怪我が元で死んだ。
My brother speaks very fast.	私の弟はとても速く話します。
My sister is shorter than you.	私の姉は君より背が低い。
In my view, you are wrong.	私の考えでは、君は間違っている。
Don't worry about my dog.	私の犬のことは心配しないで下さい。
I found my glass in pieces.	私のコップが粉々になっている。
Please give me a glass of water.	私に水を１杯下さい。
Please let me know about it.	私にもそれを知らせて下さい。
I have nothing to write with.	私には書く道具が何もない。
To me, he is like a king.	私にとって彼は王様のような人です。
We gave him up for dead.	私たちは彼を死んだものとあきらめた。
We let him keep the dog.	私たちは彼にその犬を飼わせてやった。
We waited for hours and hours.	私たちは何時間も待った。
We rested there for an hour.	私たちはそこで１週間休んだ。
Why don't you join our party?	私たちの仲間に入りなさい。
Wait here until I come back.	私が戻るまでここで待ってて。
I met my friend on the street.	昨日通りで友人に会った。
I'm feeling the breath of life.	魂の吐息を感じ始めた。
I forgot to call him today.	今日彼に電話をするのを忘れた。
She looks very happy today.	今日の彼女は、嬉しそうですね。
I'll apply for the job today.	今日その仕事を申し込もう。
Next Wednesday will be fine.	今度の水曜日ならいいですよ。
Avoid each other's society.	互いに顔を合わせるのを避ける。
I was looking at old pictures.	古い写真を見てたんだよ。
The dog followed me to my home.	犬は家までついてきた。
The dog ran around and around.	犬はぐるぐる駆け回った。
My health is my only capital.	健康が私の唯一の資本です。
Let me take your blood pressure.	血圧を計りましょう。
You must do it yourself.	君は自分でそれをしなければいけない。
You'd better not wait here.	君はここで待たないほうがよい。
My financial worries are past.	金銭の心配はなくなった。
Don't step on the broken glass.	割れたガラスを踏むな。
I work for a shipping company.	海運会社に勤めています。
We enjoyed watching the game.	我々は試合を見て楽しんだ。
Never forget to put out the fire.	火を消し忘れるな。
Are you doing anything special?	何か特別なことやるの。
I need something to write with.	何か書くものが必要だ。
Music makes our life happy.	音楽は私達の生活を楽しくする。
The English are a great nation.	英国人は偉大な国民だ。
Where is the nearest bank?	一番近い銀行はどこにありますか。
Why on earth are you here?	一体全体何故君がここにいるのだ？
Will you listen to a piece of music?	一曲聞くか。
Try to avoid bad company.	悪友とつき合わないようにしなさい。
It already has taken me hours.	もう何時間も掛かったよ。
Please show it to me again.	もう一度それを見せてください。
Please show me another one.	もう一つ別の物を見せて下さい。
I have three more pages to go.	もう３ページ残っている。
Please pass the note around.	メモを読んで回してください。
Brian kept Kate waiting.	ブライアンはケイトをずっと待たせた。
Pass me the butter, please.	バターをこちらに回して下さい。
Where shall I wait for you?	どこであなたを待ちましょうか。
Please give us some examples.	どうぞ例をあげてください。
Please tell me the truth.	どうぞ本当のことを言ってください。
Please make yourself at home.	どうぞ楽になさって下さい。
Please come and see me again.	どうぞまた御出でください。
Please make yourself at home.	どうぞおくつろぎください。
But you will write, won't you?	でも、手紙を書いてよね。
Our eyes met just fleetingly.	チラッと目が合っただけで。
Just stand there, please.	ちょっとそこに立ってもらえますか。
That is the same color as mine.	それは僕のと同じ色だ。
Is it anything like mine?	それは私のにはすこしはにてますか。
I have some doubts about it.	それにはちょっと疑問がある。
The problem was beyond me.	その問題は私にはわからなかった。
That book had a lot of pages.	その本はページが多かった。
The beautiful woman is kind.	その美しい女性は親切である。
It was very cold that evening.	その晩はとても寒かった。
That horse came in first place.	その馬は一着になった。
The day turned out to be fine.	その日は上天気となった。
The road turns left there.	その道はそこで左に曲がっている。
The town grew into a city.	その町は大きくなって市となった。
Is that as fast as you can go?	その速さで精一杯ですか。
The boy is full of promise.	その少年は大いに将来性がある。
What's the date of the letter?	その手紙の日付はいつか。
That car is quite up to date.	その車はなかなか最新式だ。
Why not apply for that job?	その仕事に応募したらどうだい。
The dog wants to go outside.	その犬は外に出たがってます。
The decision is not final.	その決定は最終的なものではない。
Both the brothers are dead.	その兄弟は２人とも死んでいる。
The argument has no force.	その議論には、全く説得力がない。
I didn't meet anyone there.	そこではだれにも会わなかった。
Steve looked very happy.	スティーブはとても嬉しそうに見えた。
He was flying down the road.	すごい勢いで駆けていったよ。
I will write to you soon.	すぐにあなたに手紙を書きましょう。
Judy is kind to everyone.	ジュディーさんはみんなに親切です。
Let's get the show on the road.	さあ、計画を始めよう。
Have you been waited on?	ご用をお伺いしておりますでしょうか。
Never have I been so happy.	こんな幸せであったことがない。
Never have I been so happy.	こんなに幸せだったことはない。
Will you type this, please?	これをタイプしてくれませんか。
These figures don't add up.	これらの数字は合計と合わない。
These dresses are too large.	これらのドレスは大きすぎる。
It's just too good to pass up.	これは絶対見逃せないよ。
This book has a lot of pictures.	この本は写真が多い。
This book seems easy to me.	この本は私にはやさしく思える。
This wall feels very cold.	この壁はとても冷たい感じがする。
This road goes to the city.	この道路はその市へ通じている。
This road leads to Hong Kong.	この道は香港に通じている。
A part of this land is mine.	この土地の一部は私のものだ。
Please take charge of this key.	この鍵を預かってくれ。
Come over here and join us.	こっちに来て仲間に入りなさい。
Koko continued to learn fast.	ココは速やかに学び続けた。
Write down your name here.	ここにあなたの名前を書きなさい。
I am happy to see you here.	ここであなたに会えてうれしい。
It should be pleasing.	きっとお気に召していただけると思います。
I've enjoyed talking to you.	お話しできて楽しかったです。
Please take care of yourself.	お体にお気を付けください。
Could I get some water, please?	お水をいただけますか。
This way, please, mademoiselle.	お嬢様こちらへどうぞ。
You are trying to kill me.	おまえはオレを殺そうとしている。
Cut the talking and listen.	おしゃべりをやめて聞きなさい。
I'm always ready for death.	いつでも死ぬ覚悟ができている。
I am always ready to help you.	いつでもお手伝いします。
Where ever did you buy it?	いったいどこでそれを買ったのか。
Would you join me for a walk?	いっしょに散歩しませんか。
Ann does not lack for friends.	アンは友人に事欠かない。
Don't be too hard on yourself.	あまり自分を責めないで。
That car is quite up to date.	あの車はなかなか最新式だ。
Have a look at that picture.	あの絵をちょっと見てごらん。
Are you subject to colds?	あなたは風邪にかかりやすいですか。
You do not have to run fast.	速く走らなくてもいいんだよ。
How many sisters do you have?	あなたは何人妹がいますか。
Please go on with your story.	あなたの話を続けて下さい。
Please write down your name.	あなたの名前を書いて下さい。
I enjoyed talking with you.	あなたとお話しして楽しかった。
May you always be happy!	あなたがいつも幸福でありますように。
Either you or I am wrong.	あなたかあるいは私が間違っている。
Please read page ninety-four.	９４ページを読んで下さい。
Five years is too long to wait.	５年待つには長すぎる。
If you add 3 to 3, you get 6.	３に３を加えれば６になる。
My sister has a very good brain.	姉はすごく頭がいい。
I don't have a very good memory.	記憶には全く自信が無い
He immediately turns on the TV.	彼がすぐにテレビをつける
Let's play the music together. 	一緒に音楽をやりましょう
He immediately bought a book.	彼が早速一冊の本を買いました
He has produced many works.	彼が多くの作品を発表してきました
There are strong doubts about X.	Xには大いに疑問が残る
His/Her eyes immediately lit up.	すぐに目の色が変わった
He finally found the target.	彼が最後には目的の物を見付けた
We carry a lot of products.	当店は多数の商品を揃えております
First of all, make people happy.	まず、人を喜ばせるべし
It really makes people happy.	それがほんとに人を幸せにする
This fits my hands better.	こちらの方が手にしっくり馴染みます
Man can't live without dreams.	夢もなければ生きられない。
I've finally got the whole set!	ついにフルコンプしたぞ！
The argument ended in a fight.	論議は最後に喧嘩になった。
Mr Suzuki has three daughters.	鈴木さんには娘が３人いる。
The green leaves are coming out.	緑の葉が出てきている。
I'm still waiting for my order.	頼んだ物がまだ来ません。
Can I have a friend paged?	友達を呼び出してもらいたいんです。
Keep oil away from the fire.	油を火からはなしておきなさい。
We must not forget our promise.	約束を忘れてはいけない。
One must keep one's promises.	約束は守らなければならない。
Close your eyes and go to sleep.	目を閉じて眠りなさい。
The eye is the window of the soul.	目は心の窓である。
What are the visiting hours?	面会時間はどうなっていますか。
Write your name in capitals.	名前を大文字で書いてください。
May I have your name, please?	名前を教えていただけますか。
May I have your name, please?	名前は何とおっしゃいますか。
Have you ever written a book?	本を書いたことがありますか。
I looked over my shoulder.	僕は肩越しに振り返ってずっと見た。
I go to bed at ten as a rule.	僕はいつも１０時に床につく。
We gave him up for dead.	僕たちは彼が死んだものだとあきらめた。
Mother bought me the book.	母は私にその本を買ってくれました。
There was not a breath of air.	風はそよとも吹かなかった。
Father bought me some books.	父は私に本を買ってくれました。
Father bought me the book.	父は私にその本を買ってくれました。
My father's hair has grown white.	父の髪は白くなった。
She felt happy to see him.	彼女は彼に会ってうれしいと思った。
She was beautiful in her time.	彼女は若いころ美しかった。
She took to him immediately.	彼女は一目で彼が好きになった。
She is as beautiful as a rose.	彼女はバラのように美しい。
What a beautiful girl she is.	彼女はなんと美しいのだろう。
How fast she is running!	彼女はなんて速く走っているのでしょう。
She forced that task on me.	彼女はその仕事を私に押し付けた。
She took to him immediately.	彼女はすぐに彼が好きになった。
She was happy for some time.	彼女はしばらくの間幸福だった。
She was as happy as could be.	彼女はこの上なく幸せだった。
I wonder where she lives.	彼女は一体どこに住んでいるのかしら？
She kissed me like anything.	彼女は、激しく私に接吻をした。
Her dream is to visit Paris.	彼女の夢はパリを訪れることだ。
Her father works at the bank.	彼女の父は銀行で働いている。
Her hair comes to her shoulders.	彼女の髪は肩まである。
She has no one to wait on her.	彼女に付き添う人がいない。
I met up with her on the street.	彼女と町で偶然あった。
I took her for her sister.	彼女とお姉さんを間違えてしまった。
They go to church on Sunday.	彼らは日曜日に教会へ行きます。
They finally appeared to arms.	彼らはついに武力に訴えた。
They are wanting in industry.	彼らには勤勉さが欠けている。
I'm sure he is a man of ability.	彼は有能な人だと思う。
He was happy, poor as he was.	彼は貧乏だったが幸せでした。
He looked her right in the eye.	彼は彼女の目を直視した。
He passed away quite suddenly.	彼は全く突然に亡くなった。
He forgot to turn off the light.	彼は電灯を消し忘れた。
He walked about the streets.	彼は町のあちこちを歩き回った。
He is in good physical condition.	彼は体の調子がよい。
He promised me to come early.	彼は早く来ると私に約束した。
He will be writing a letter.	彼は手紙を書いているでしょう。
He sometimes comes home late.	彼は時々遅く帰ることがある。
He will not listen to me.	彼は私の言うことなど聞こうとしない。
He is in charge of our class.	彼は私たちのクラスの担任だ。
He has been dead for five years.	彼は死んで５年になる。
He was given up for dead.	彼は死んだものとあきらめられていた。
He saw a dog near the door.	彼は玄関の近くで一匹の犬を見た。
He has a good eye for art.	彼は芸術に関しては目が肥えている。
He has been driving for hours.	彼は何時間も運転している。
He is not pleased with anything.	彼は何事にも喜ばない。
He acted the part of King Lear.	彼はリヤ王の役を演じた。
He ran the fastest of all.	彼はみんなのなかで最も速く走った。
He is a man of great ability.	彼はとても才能のある人です。
He ran as fast as he could.	彼はできる限り早くはしりました。
He is pleased with the plan.	彼はその計画が気に入っている。
He has been gaining weight.	彼はこのところふとってきている。
He promised me to come here.	彼はここに来ると私に約束した。
I believe that he'll do fine.	彼はきっとうまくやると思う。
He will be waiting for you.	彼はあなたを待っているでしょう。
He came home three hours later.	彼は３時間後に帰宅した。
He left school two weeks ago.	彼は２週間前に卒業しました。
He left here a few days ago.	彼は２、３日前にここを去った。
He has been waiting for an hour.	彼は１時間待っている。
He is in charge of our class.	彼は、我々のクラスの担任だ。
He has been dead for five years.	彼が死んで五年になる。
I understand him to be happy.	彼が幸せでいると思っている。
It was a glass that he broke.	彼が割ったのはコップなんだ。
We have a black and white dog.	白黒ぶちの犬を飼っている。
It is getting colder day by day.	日毎に寒くなってくる。
Please hold on a moment.	電話を切らずにそのまま待ってください。
I have to make a phone call.	電話を掛けなければなりません。
The street is full of activity.	通りは活気に溢れている。
Have I kept you waiting long?	長いことお待たせしましたか。
The days are growing longer.	昼がだんだんと長くなってきた。
Can anyone tell me the time?	誰か時間を教えてくれませんか。
Would you page Mr Sawada?	沢田さんを呼び出していただけますか。
I'd like a window seat, please.	窓側の席をお願いします。
Our teacher seemed surprised.	先生は驚いているようだった。
A red dress looks good on her.	赤い服は彼女によく似合う。
The water supply was turned off.	水道の水が止められた。
Man has the ability to speak.	人間は話す能力を持っている。
We'd better send for help.	人をやって助けを求めたほうがいい。
Everyone has a right to live.	人はみんな生きる権利がある。
There is no cause for worry.	心配するようなことは何もない。
Please give us three references.	照会先を３件ください。
Is there anything on the floor?	床の上に何がありますか。
Little thing please little minds.	小事は小人を喜ばす。
Could you write it down, please?	書いてくださいますか。
Driving a car taxes the eyes.	車の運転は目に負担をかける。
Wasn't he killed by a car?	自動車にひかれたのではないですか。
We waited for him to turn up.	私達は彼が現れるのを待った。
We'd better call the police.	私達は警察を呼んだほうがいい。
I study for 3 hours every day.	私は毎日３時間勉強します。
I've written a lot of stories.	私は物語をたくさん書いた。
I look on her as my sister.	私は彼女を妹のように思っている。
I wanted to surprise her.	私は彼女をびっくりさせたいと思った。
I wrote a long letter to her.	私は彼女に長い手紙を書いた。
I parted from him on the street.	私は彼と通りで別れた。
I saw him cross the street.	私は彼が通りを横断するのを見た。
I have been here for two hours.	私は二時間ここにいます。
I like blue best of all colors.	私は青色が一番好きです。
I chanced talking to her.	私は思い切って彼女に話しかけてみた。
I am not happy with my job.	私は今の自分の仕事に不満である。
I chanced to be working there.	私は偶然そこで働いていた。
I'm dead set against the plan.	私はその案に絶対反対です。
I will wait for my sister here.	私はここで妹を待ちます。
I'm ready to leave now.	私はいつでも出かける準備はできています。
I will show you the picture.	私はあなたに絵を見せましょう。
Please put yourself in my place.	私の立場になってくれ。
My sister isn't studying now.	私の妹はいま勉強してません。
Please write down my address.	私の住所を書き留めておいて。
My home is on the eighth floor.	私の家は８階にあります。
I'm about ready to go.	私のほうは出かける支度はほぼできています。
All of my strength gave out.	私のすべての力を出し尽くした。
Don't forget to write to me.	私に手紙を書くのを忘れないで。
Please explain the rule to me.	私に規則を説明して下さい。
Please let me try the game.	私にそのゲームをさせてください。
If I were you, I'd buy that one.	私ならそれを買います。
My sister was a beautiful woman.	姉は美しい女性だった。
It is very cold today, isn't it?	今日はとても寒いわね。
I will give him another chance.	今度だけは許してやろう。
It is especially cold this morning.	今朝は特に寒い。
Choose any dress you like.	好きなドレスをどれでも選びなさい。
I just can't seem to make contact.	交信が出来ません。
Please leave nothing behind.	御忘れ物なきようお願いします。
A dog followed me to my school.	犬が学校までついてきた。
The dog walked across the street.	犬がとおりを渡った。
Take good care of yourself.	健康には十分気をつけてください。
Write your name in capitals.	君の名前を大文字で書きなさい。
Either you or he is wrong.	君か彼のどちらかがまちがっている。
The bank keeps money for people.	銀行は人の金を預かる。
Open your texts to page 50.	教科書の５０ページを開きなさい。
A strong wind began to set in.	強風が陸の方へ吹き始めた。
The argument ended in a fight.	議論は最後に喧嘩になった。
The patient was allowed up.	患者は起き上がることを許された。
Let's drive as far as the sea.	海までドライブしましょう。
Everything comes to those who wait.	果報は寝て待て。
Are you happy in your house?	家庭にいてあなたは幸せですか。
Please give me leave to go home.	家に帰る許可を下さい。
I want something cold to drink.	何か冷たいものがほしい。
Give me something to write on.	何か書くものを貸してくれ。
I want something to write on.	何か書きつけるものが欲しい。
I feel that something is wrong.	何かおかしいと思います。
Music makes our life happy.	音楽は私達の暮らしを楽しくする。
Where's the nearest church?	一番近い教会はどこにありますか。
It was the same all year round.	一年中いつも同じでした。
He'll make a good husband.	意識的努力によって将来はいい夫に。
A car passed by in the dark.	暗がりを１台の車が過ぎ去った。
We should keep our promise.	われわれは約束を守るべきである。
We've made a final decision.	われわれは最終的決定を行った。
I am more beautiful than you.	わたしは、あなたより美しい。
Lucy sometimes visits May.	ルーシーはときどきメイを訪ねます。
Please turn off the light.	ライトのスイッチを切ってください。
You must keep your eyes open.	よく見張ってなければだめよ。
He was flying down the road.	ものすごい勢いで駆けていった。
We can see a church over there.	むこうに教会が見えます。
Paris is the capital of France.	パリはフランスの首都だ。
Why are your eyes so big?	なぜ、あなたの目はそんなに大きいの？
Tom saved her from the fire.	トムは彼女を火事から救出した。
We had a very good time indeed.	とてもおもしろかったよ。
Please tell me your address.	どうぞご住所を教えてください。
Please make yourself at home.	どうぞお楽になさって下さい。
Please have a second helping.	どうぞおかわりをして下さい。
Please remain seated.	どうぞ、そのままお座りになっていてください。
Carry the table out, please.	テーブルを運びだしてください。
There is a dog under the table.	テーブルの下に犬がいる。
The war finally broke out.	ついに戦いの幕が切って落とされた。
Now you've given yourself away.	ついに正体を暴露したな。
At last, I passed the test.	ついに私はそのテストに合格した。
I'd like to check in, please.	チェックインしたいのですが。
We can but wait for the results.	ただ結果を待つのみだ。
Don't speak so fast, please.	そんなに速く話さないで下さい。
Don't worry about such a thing.	そんなことを心配するな。
Will you carry it out for me?	それを運び出してくれますか。
These figures don't add up.	それらの数字は、合計があわない。
It is a task beyond my power.	それは私の力に余る仕事です。
The tree grows very quickly.	その木はとても速く大きくなる。
Where did you buy that book?	その本をどこで買ったのですか。
The couple led a happy life.	その夫婦は幸福な生活を送った。
That car is quite up to date.	その電車はなかなか最新式だ。
The ship will call at Yokohama.	その船は横浜に寄港する。
The water is not fit to drink.	その水は飲むのに不適当だ。
Look over the papers, please.	その書類をざっと見て下さい。
Post that letter right away.	その手紙をすぐに投函しなさい。
That car is quite up to date.	その車なかなか最新式である。
Please try me for the job.	その仕事に私を使ってみてください。
The dog saved the girl's life.	その犬は少女の命を救った。
The plan was put into operation.	その計画は実施された。
That music really gets me.	その音楽には本当に感動をおぼえた。
The door is sometimes open.	そのドアは開いていることがある。
Hold on for a while, please.	しばらくこのままお待ち下さい。
To San Francisco, please.	サンフランシスコまで行ってください。
I can't get my contacts out.	コンタクトレンズが取れません。
This is a picture of my mother.	これが私の母の写真です。
I bought this book at Kakuzen's.	この本を角善で買った。
This book seemed interesting.	この本は面白いように思えた。
I bought this book for less.	この本はもっと安い値で買った。
I enjoyed this book so much!	この本とてもおもしろかったわ。
Who's in charge of this section?	この部の責任者は誰か。
Where does this street lead to?	この道はどこに出ますか。
Have a good look at this picture.	この写真をよく見て。
This task is too much for me.	この仕事は私の手におえない。
I can't put up with this cold.	この寒さは我慢出来ないな。
It has been fine for a week.	この一週間ずっとよい天気です。
This dress fits you well.	このドレスは君にぴったり合っている。
Don't open this door, please.	このドアを開けないで下さい。
Could you sign here, please?	こちらにサインをいただけるか。
Can I take pictures here?	ここで写真を撮ってもいいでしょうか。
Christmas is fast approaching.	クリスマスが近づいてきた。
No doubt she will come soon.	きっと彼女はじきに来るだろう。
I ask to see your daughter.	お嬢さんに会わせていただきたい。
I can't really trust Toshiba.	いまいち東芝は信用できない。
Always be true to yourself.	いつも自分自身に誠実でいなさい。
What on earth are you doing?	いったい何をしているのだろう。
The capital of Italy is Rome.	イタリアの首都はローマです。
No, I haven't written it yet.	いいえ、まだ書いていません。
In a sense, you are wrong.	ある意味では、きみが間違っている。
Please don't walk too fast.	あまり速くあるかないでください。
You shouldn't trust that man.	あの男を信用してはいけない。
Are you listening to him?	あなたは彼の話を聞いているのですか。
You must know yourself.	あなたは自分自身をしらなければならない。
You no doubt bore people.	あなたは間違いなく人々を退屈させる。
You are listening to English.	あなたは英語を聞いています。
Your dreams have come true.	あなたの夢が現実のものとなった。
I am happy to hear your voice.	あなたの声を聞いて嬉しい。
Write your name and address.	あなたの住所氏名を書きなさい。
Please give me three of each kind.	３個ずつください。
He will be back in an hour.	１時間もたてば彼は帰ってきます。
Look at the notes on page 10.	１０ページの注釈を見なさい。
They did not have a discussion.	彼らが議論をしませんでした
He/She is immaculately dressed.	清潔なものを身につけている
It also improves my ability.	それがまた自分の能力を向上させる
This kind of method is effective.	このような方法が有効だ
Talking is a human ability.	話すことは人間の能力の一つである。
No road is long with good company.	旅は道連れ世は情け。
Promises are made to be broken.	約束は破られるためにある。
Are there special evening rates?	夜間の割引はありますか。
I study for many hours at night.	夜に何時間も勉強します。
The water was dead around us.	僕らの周囲で水はよどんでいた。
I am no more happy than you are.	僕も君と同様楽しくない。
I work best under pressure.	僕は追い込まれると一番仕事をする。
My dog is smaller than yours is.	僕の犬は君のより小さい。
Remember to post the letter.	忘れずにその手紙を投稿しなさい。
Can I change the date of return?	返却日を変更できますか。
Please show me another example.	別の実例を教えてください。
He is in bed with a touch of cold.	風邪ぎみで寝ている。
My father has bought a new car.	父は新しい車を買いました。
A good husband makes a good wife.	夫がよければ妻もよし。
Please be sure to come on time.	必ず時間どおりに来なさい。
She has grown up to be a woman.	彼女も一人前の女になった。
She has to study science.	彼女は理科を勉強しなければなりません。
She turned a page of her book.	彼女は本のページをめくった。
She sent me a long letter.	彼女は僕に長い手紙を送ってよこした。
She is poor, but she is happy.	彼女は貧しいけれど幸福です。
She is a local government officer.	彼女は地方公務員だ。
She seemed to be very surprised.	彼女は大変驚いたらしい。
She must keep early hours.	彼女は早寝早起きしなければならない。
She takes a walk with her dog.	彼女は犬と一緒に散歩します。
She didn't seem interested.	彼女は関心がなさそうな様子だった。
She waited for him for hours.	彼女は何時間もの間彼を待った。
I wonder what's on her mind.	彼女は何を心配しているのだろう。
She likes to listen to music.	彼女は音楽を聞くことが好きだ。
She looks blue for some reason.	彼女はなぜかふさいでいる。
I wonder what has become of her.	彼女はどうなったかしら。
She put the money in the bank.	彼女はその金を銀行に預けた。
She came home in low spirits.	彼女はがっかりして帰ってきた。
She is dressed in her best.	彼女はいちばんの晴れ着を着ている。
I doubt that she loves you.	彼女はあなたを愛していないと思う。
She laid the table for six.	彼女は６人用のテーブルセットした。
She left school two years ago.	彼女は２年前に学校をやめた。
She wrote as many as ten books.	彼女は１０冊も本を書いた。
Her ideas are quite original.	彼女の考えはほんとに独創的だ。
Take a seat over against her.	彼女の向い側の席をとりなさい。
Her face turned red suddenly.	彼女の顔は突然まっかになった。
I was happy to see her again.	彼女に再び会えてうれしかった。
I wonder what happened to her.	彼女に何が起こったんだろう。
She has an eye for the beautiful.	彼女には審美眼がある。
She is lacking in common sense.	彼女には常識が欠けている。
She sent you her best wishes.	彼女からよろしくとのことです。
All we can do is wait for him.	彼を待つよりほか仕方がない。
They didn't keep their promise.	彼らは約束を守らなかった。
They made the road more even.	彼らは道路をもっと平らにした。
They looked really happy.	彼らはほんとうに幸福そうに見えました。
Not all of them are happy.	彼らがみな幸福であるとはかぎらない。
He is said to have a cold.	彼は風邪をひいているということです。
He touched her on the shoulder.	彼は彼女の肩に手を触れた。
He is particularly kind to her.	彼は彼女にとくにやさしい。
He lives just across the road.	彼は道の反対側に住んでいる。
He is better than anyone else.	彼は他の誰より優れています。
He can't tell right from wrong.	彼は善悪の区別が付かない。
He took the public by surprise.	彼は世間をあっといわせた。
He was dressed down in public.	彼は人前でしかりつけられた。
He always wears dark glasses.	彼は常に黒メガネをかけている。
He is as ready to talk as to work.	彼は手八丁口八丁だ。
He felt himself growing old.	彼は自分が老いていくのを感じた。
He wrote to me from time to time.	彼は時々手紙を書いた。
He has a liking for modern music.	彼は現代音楽が好きだ。
He walked about the streets.	彼は街のあちこちを歩きまわった。
He took out a piece of paper.	彼は一枚の紙切れを取り出した。
He can write with either hand.	彼はどちらの手でも書けます。
I wonder what has become of him.	彼はどうなったのかしら。
He will not listen to me.	彼はどうしても私の話を聞こうとしない。
He always wears dark glasses.	彼はつねに黒眼鏡をかけている。
He applied himself to the task.	彼はその仕事に打ち込んだ。
He seemed to have thought so.	彼はそう考えていたようだった。
He has to get up immediately.	彼はすぐおきなければならない。
Not only he but I am wrong.	彼ばかりでなく私もまちがっている。
He is always pressed for money.	彼はいつも金に困っている。
He seems to live in Britain.	彼はイギリスに住んでいるらしい。
He left Japan on a fine day.	彼はある晴れた日に日本を去った。
He promised me to come at four.	彼は４時に行くと約束した。
He will return within 3 hours.	彼は３時間以内に戻るだろう。
He came to Japan two years ago.	彼は２年前日本に来ました。
He works hard all the year round.	彼は１年中懸命に働く。
He lived here ten years ago.	彼は１０年前にここにすんでいた。
How fast he speaks English!	彼の話す英語の速いことと言ったら。
Please ask him to call me.	彼に電話をくれるように頼んで下さい。
I'm always surprised by him.	彼にはいつもびっくりさせられる。
He thought of a good solution.	彼がよい解決策を思いついた。
The horse ran through the fields.	馬は野原を走り抜けた。
I don't receive on Sundays.	日曜日はどなたにもお会いしません。
It is getting colder day by day.	日増しに寒くなっていく。
Suddenly, they stopped talking.	突然彼らは話すのをやめた。
It's very cold here in February.	当地は２月がとても寒い。
Have I kept you waiting long?	長いことお待たせいたしました。
Many happy returns of the day!	誕生日おめでとうございます。
I try not to bother anyone.	誰にも迷惑をかけないようにします。
Can someone take our picture?	誰か写真を撮ってくれるかしら？
You've put on weight, haven't you?	体重が増えましたね。
Do you have anyone to look up to?	尊敬する人はいますか。
Please answer all the questions.	全ての質問に答えなさい。
If it's all real just kill me.	全てが現実ならオレを殺して。
Oil is of great use to us.	石油はたいへん私たちの生活に役立つ。
Oil is of great use to us.	石油はたいへんわたしたちの役に立つ。
Start off on the green light.	青信号が出たとたんに動き出す。
You may leave your seat at will.	随意に退席して結構です。
Water was supplied from outside.	水は外側から供給された。
Men can not exist without air.	人は空気なしで生きられない。
A woman asked me for directions.	女の人が私に道を尋ねた。
Give me some paper to write on.	書くために紙を少し下さい。
You have to have an operation.	手術をしなければなりません。
The letter was written by her.	手紙は彼女によって書かれた。
Would you call up my husband?	主人を読んでいただけませんか。
You must do it for yourself.	自分でそれをしなければならない。
Please write to me once in a while.	時々は手紙下さい。
We walked along the road.	私達はその道をずっと歩いていきました。
I go by that church every day.	私は毎日その教会の前を通る。
I have been down with a cold.	私は風邪をひいて寝ていました。
I was taken in by her promise.	私は彼女の約束にだまされた。
I ran into her in the street.	私は彼女に町で偶然出くわした。
I go to church on Sundays.	私は日曜日には教会へ礼拝に行きます。
I don't know it. Nor does he.	私は知らないし、彼も知らない。
I do not doubt it in the least.	私は少しもそれを疑わない。
I am not writing a letter.	私は手紙を書いているところではない。
I didn't feel like buying a car.	私は車を買う気がしない。
I don't care for moving pictures.	私は映画が好きでない。
I passed over the dark street.	私はその暗い道を通り過ぎた。
I was surprised at John's death.	私はジョンの死に驚いた。
I'll take care of this dog.	私はこの犬の世話をするつもりです。
I can't stand the cold here.	私はここの寒さには耐えられない。
When am I to contact you?	私はいつあなたに連絡を取るべきですか。
I can't run as fast as you.	私はあなたほどに速くは走れません。
I'll be your first patient.	私はあなたの第一号の患者になるわ。
I had been reading for an hour.	私は１時間読書をしていた。
I feel like nothing on earth.	私は、ひどく、面食らっている。
I wish my dream would come true.	私の夢が実現したらなぁ。
It's time my dream came true.	私の夢がもう実現するところだ。
My sister's name is Patricia.	私の妹の名前はパトリシアです。
I have nothing to add on my part.	私の方には意見はない。
Mine is not so good as yours.	私の物は君の程よくありません。
May I see the room, please?	私の部屋を見せていただけませんか。
My father died four years ago.	私の父は四年前に死にました。
Something is wrong with my watch.	私の時計は調子が悪い。
My office is on the fifth floor.	私の事務所は五階にある。
My sister has a very good brain.	私の姉はとても頭が良い。
I've mine right here in my hand.	私のは手に持っています。
Don't wait on my account.	私のためにお待ちにならないでください。
Please let me know the truth.	私に本当のことを教えて下さい。
Please let me try it again.	私にそれをもう一度させてください。
We enjoyed watching the TV.	私たちはそのテレビを見て楽しんだ。
Please wait until I come back.	私が戻るまで待ってください。
She will report directly to me.	私が直属の上司になります。
I am a little out of sorts today.	今日は少し気分が悪い。
It is very cold today, isn't it?	今日はとても寒いですね。
It was now a race against time.	今や時代との競争になった。
The picture is on the wall now.	今その絵は壁に貼ってある。
Please read between the lines.	言外の意味をとってください。
The dog knows black from white.	犬は白と黒との区別がつく。
You should apply for that post.	君はその職に応募すべきだ。
What has become of your sister?	君の妹はどうなりましたか。
There is nothing wrong with you.	君には何も悪い所はない。
Suddenly, he changed the subject.	急に彼は話題を変えた。
There is little room for doubt.	疑いの余地はほとんどない。
Don't forget to put out the fire.	火を消すのを忘れるな。
He had been walking for hours.	何時間も歩き続けてきたのだ。
How late can I check in?	何時までにチェックインすればいいですか。
There is nothing to worry about.	何も心配することはない。
I was wrong all the same.	何といっても私がまちがっておりました。
I want something cold to drink.	何か冷たい飲み物が欲しい。
Please give me something to drink.	何か飲物をください。
You can see the sea on your right.	右手に海が見えます。
What time are you the happiest?	一番楽しいのはどんなとき。
Communication takes many forms.	意思伝達は色々な形をとる。
There used to be a church here.	以前はこの教会にいました。
It is too dark to see clearly.	暗すぎてはっきりと見えない。
It is love that rules the world.	愛こそが世界を支配する。
I wasn't always happy.	わたしはいつも幸福だったわけではありません。
I don't trust him any longer.	もはや私は彼を信用していない。
Have you got over your cold yet?	もう風邪は治りましたか。
I wish I had a better memory.	もう少し記憶力がよければなあ。
It's 7:30 now. I must fly.	7時30分だ。大急ぎで行かなくては。
Let's be done with the argument.	もう議論はよしましょう。
I don't know, nor do I care.	ぼくは知らないし、気にもしない。
What did you do with my glasses?	ぼくの眼鏡をどうしたの。
Betty laid herself on the bed.	ベティはベッドに横になった。
I met him on the street by chance.	ふと街で彼に会った。
Please put it on the scale.	はかりの上にそれを置いてください。
You can take either road.	どちらの道を通って行ってもいいですよ。
Please make yourself at home.	どうぞ気楽になさってください。
Please take good care of yourself.	どうぞお体を大切に。
Please take care of yourself.	どうぞお体を大事にして下さい。
There is a glass on the table.	テーブルの上にコップがある。
Everyone must keep the law.	だれでも皆法律に従わねばならない。
I chanced to see him in town.	たまたま私は町で彼と出会った。
It's time you faced reality.	そろそろ現実を直視していい頃だ。
He has enough money to buy it.	それを買うだけのお金がある。
Give it to anyone you like.	それを誰でも好きな人にあげなさい。
I'm surprised you came at all.	そもそも君が来たとは驚いた。
The story turned my blood cold.	その話を聞いてぞっとした。
Both girls have blue eyes.	その娘達は２人とも青い目をしている。
How cold it was in the room!	その部屋はなんて寒かったことか。
A son was born to the couple.	その夫婦に、男の子が生まれた。
The ship left every Monday.	その船は毎週月曜日に出航していた。
The boy looked like a grown-up.	その少年は大人びて見えた。
Will you show me the picture?	その写真を見せてくれませんか。
The sisters look like each other.	その姉妹は似ています。
The play was produced by him.	その劇は彼によって演出された。
The picture set her wondering.	その絵を見て彼女は驚嘆した。
I wish I had seen the film.	その映画を見ておけばよかったなあ。
I heard it on good authority.	そのことは確かな筋から聞いた。
That is where you are wrong.	そこが君の間違っているところだ。
Susie loves Japanese music.	スージーは日本の音楽が大好きです。
John is a good friend of mine.	ジョンは私の親しい友人です。
Jane is not such a bad sort.	ジェーンはそんな悪い人ではない。
Please come over with your wife.	ご夫婦でおこしください。
This is what I was waiting for.	これを待ち望んでいました。
This is a picture of my family.	これは私の家族の写真です。
This is the dog that Ken owns.	これは健が飼っている犬です。
This book was written by Haley.	この本はヘイリーが書いた。
Where does this road lead to?	この道を行くとどこへ出ますか。
These totals check with mine.	この合計は私のとぴったりあう。
This dress fits me very well.	このドレスは私にぴったりです。
This dress is too big for me.	このドレスは私には大きすぎる。
The glass was broken to pieces.	コップはこなごなになった。
Please wait here for a while.	ここでしばらく待ってて下さい。
Christmas is fast approaching.	クリスマスが近くなってきた。
How do you heat the house?	お宅の暖房はどのようにしていますか。
I'm very happy to meet you.	お会いできとてもうれしく思います。
Alex will answer, "Color!"	アレックスは「色」と答えるのである。
The green color becomes Alice.	アリスにはグリーンが似合う。
There is a limit to everything.	あらゆるものに限界がある。
That red dress becomes her.	あの赤いドレスは彼女によく似合う。
Are you interested in music?	あなたは音楽に興味がありますか。
Are you listening to English?	あなたは英語を聞いていますか。
Do you think he is dead?	あなたは彼が死んでしまったと思いますか。
Did you carry out your plan?	あなたは、計画を実行しましたか。
Your letter crossed mine.	あなたの手紙は私のと行き違いになった。
I am pleased to see you again.	あなたに再会できてうれしい。
You are both in the wrong.	あなたたちは２人ともまちがっている。
Please take a rest for a few days.	２、３日骨休めして。
There is but one chance left.	１度だけチャンスが残っている。
Twelve years is old for a dog.	１２歳といえば犬は年寄りだ。
Sign up for the point site.	あなたがポイントサイトに登録をします
He looks at much older pictures.	彼がもっと過去の画像を見る
Two examples will be shown below.	以下に２つの例を示します
He immediately returned to home.	彼がすぐに自分の家に戻った
The weight comes back very quickly.	体重がすぐに元に戻る
I gain weight back really quickly.	すぐに体重がもとに戻る
It seems like a different person.	まるで人が変わったようだ
He sometimes goes to Kyoto.	彼がたまに、京都のほうまで足を伸ばす
I check several sites myself.	自分で複数のサイトをチェックする
Many things are written about X.	Xがいろいろ書かれています
Three hours have already gone by.	既に３時間を経過している
Finally, these two joined hands.	ついにこの二人が手を組んだ
He suddenly looked up into the air.	彼がふと空を見上げた
It comes with a special case.	それには専用のケースが付属します
I said I would make her happy.	僕は彼女を幸せにすると言った。
An old man spoke to me suddenly.	老人が突然私に話しかけた。
I'm saving money for my old age.	老後のためにかねをためる。
You may as well keep your promise.	約束は守った方がいい。
Can my daughter go to school?	娘を学校に行かせてもいいですか。
I bought this book the other day.	僕は先日この本を買った。
The streets in Hokkaido are wide.	北海道の道路は幅が広い。
Don't forget to sign your name.	忘れずに署名をして下さいね。
Do you have anything for a cold?	風邪に効く薬はありますか。
Mt. Fuji is known to everyone.	富士山はみんなに知られている。
A wonder lasts but nine days.	不思議なことも９日しか続かない。
They are pleased with your work.	彼等は仕事に満足している。
Let's put her in charge of that.	彼女をその任務に就けよう。
She indicated her reasons to us.	彼女は理由を簡単に述べた。
She is particular about her dress.	彼女は服に凝っている。
She looked around in wonder.	彼女は不思議そうに周りを見渡した。
She has an eye for the beautiful.	彼女は美を見る目がある。
She looks very happy today.	彼女は今日うれしそうな顔をしている。
She was dressed all in black.	彼女は黒ずくめの服装をしていた。
What a beautiful woman she is!	彼女はなんと美人なのでしょう。
She came round to watching TV.	彼女はテレビを見る気になった。
She seems happy to be here.	彼女はここにいて幸せそうに見えます。
She will return within an hour.	彼女は１時間以内に戻ります。
Her dream has come true at last.	彼女の夢がついにかなった。
Her hair is long and beautiful.	彼女の髪の毛は長くて美しい。
We received word of her death.	彼女の死の知らせを受け取った。
Take a seat over against her.	彼女の向かい側に席を取りなさい。
Please book a room for her.	彼女のために部屋を予約してください。
I saw her only a week ago.	彼女にあったのはつい一週間前のことだ。
She laid hands on her own child.	彼女が我が子に手をかけた。
All we can do is to wait for him.	彼を待つより仕方がない。
They supplied us with food.	彼らは私たちに食料を供給してくれた。
They don't take care of that dog.	彼らは犬の世話をしない。
They waited for him for hours.	彼らは何時間もの間彼を待った。
They were ranged against the king.	彼らは王の敵に回った。
He's going from strength to strength.	彼は滅法強いね。
He has just bought a used car.	彼は中古車を買ったばかりです。
He looked around the waiting room.	彼は待合室を見回した。
He cut a fine figure in company.	彼は人なかで立派にみえた。
He thought he would kill himself.	彼は自殺しようと思った。
He was floored by my argument.	彼は私の論議でやり込められた。
He kept me waiting all morning.	彼は午前中ずっと待たされた。
He is not as old as he seems.	彼は見かけほど歳をとっていない。
He finally had to step down.	彼は結局あきらめざるを得なかった。
He was walking toward the sea.	彼は海の方へ歩いていきました。
He looked me right in the eye.	彼はわたしの目をまっすぐ見た。
He particularly liked history.	彼はとりわけ歴史が好きだった。
He seems not to have known it.	彼はそれを知らなかったらしい。
He looked into the boy's eyes.	彼はその少年の目を覗き込んだ。
He is still green at the job.	彼はその仕事にはまだ経験が浅い。
He took Connie for my sister.	彼はコニーを私の姉だと誤解した。
I couldn't get him on the phone.	彼に電話連絡できなかった。
Please give him my best regards.	彼によろしくお伝え下さい。
He can't tell right from wrong.	彼には善悪の区別がつかない。
He was seen crossing the road.	彼が通りを横切るのが見られた。
Small wonder that he thinks so.	彼がそう思うのも無理はない。
Not every horse can run fast.	馬がみな速く走れるとは限らない。
Have you taken your temperature?	熱をお計りになりましたか。
It has suddenly got cold, hasn't it?	突然寒くなったね！
The same applies to my class.	同じ事が私のクラスにもいえます。
The phone was out of order again.	電話はまた故障していた。
Anyone can do it if they try.	誰でもやってみればそれはできる。
Can anyone answer my question?	誰か私の質問に答えられますか。
A man with a big dog came in.	大きな犬を連れた男が入って来た。
Are you watching your weight?	太らないように気をつけているの？
We make the total about $50.	総額はおよそ５０＄ぐらいだと思う。
Do you want a seat by the window?	窓側の席をお望みですか。
We've been fine, by and large.	全体的にはうまくやっています。
There used to be a church here.	昔はここに教会があったんだ。
Once there lived a great king.	昔１人の偉い王様が住んでいた。
Please lie still on the bed.	静かにベッドに横になってください。
Tell me the right time, please.	正確な時間を教えてください。
What does all this add up to?	これはいったいどういうことなの。
Lack of sleep began to tell on me.	睡眠不足が響いてきた。
One must keep one's promises.	人は約束を守らなければならない。
How fast the new Shinkansen goes!	新しい新幹線の速いこと！
There's nothing to worry about.	心配する事は何もありません。
Don't worry. You'll make it.	心配するな。君たちはうまくいくよ。
The floor was running with water.	床一面に水が流れていた。
Do you think I should write?	手紙を書いた方がいいと思いますか。
Would you move your car, please?	車をどかしてくれませんか。
Apply yourself to your own work.	自分の仕事に専念しなさい。
You brought it on yourself.	自分でやったことだから仕方がないね。
At times, I can't trust him.	時々、彼のことが信じられなくなる。
Some read books to kill time.	時間つぶしに読書する人もいます。
I'd like to take that out, please.	持ち帰りにして下さい。
The fitting room is being used now.	試着室は今使用中だ。
We want to be international.	私達は国際人になりたいと思います。
We booked seats for the play.	私達はその芝居の切符を予約した。
We worry about your future.	私達は、あなたの将来を心配している。
I think I'm getting a cold.	私は風邪をひきかけていると思います。
I took her for her sister.	私は彼女を彼女の姉だと思っていました。
I was worried on her account.	私は彼女のことが気がかりだった。
I wait here until she comes.	私は彼女が来るまでここで待ちます。
I have a great regard for him.	私は彼を大いに尊敬しています。
I asked him to wait here.	私は彼にここで待ってくれるように言った。
I am the happiest man on earth.	私は地球上で一番幸せな男だ。
I'm taking a couple of days off.	私は数日間休みを取ります。
I have enjoyed myself to the full.	私は十分楽しみました。
I was told to wait for a while.	私は暫く待つように言われた。
I listened to some CDs last night.	私は昨晩ＣＤを聞いた。
I have a black and white dog.	私は黒白まだらの犬を飼っている。
I ran into an old friend of mine.	私は旧友に偶然であった。
I forgot the date of the meeting.	私は会議の日付を忘れた。
I want something cold to drink.	私は何か冷たいものが欲しい。
I finally got through the test.	私はやっとテストに合格した。
I feel as if I were dreaming.	私はまるで夢を見ているようです。
I reflected on the problem.	私はその問題についてじっくり考えた。
I accept the statement as true.	私はその陳述を真実と認める。
I am not in the least surprised.	私はすこしも驚いていない。
I was asked to wait here.	私はここで待っているように頼まれました。
I can run faster than Ken.	私はケンよりも速く走ることが出来ます。
I want time instead of money.	私はお金ではなくて時間がほしい。
I am taking a couple of days off.	私は２、３日仕事を休む。
I had a bad cold for a week.	私は１週間ひどいかぜをひいていた。
I started this job an hour ago.	私は１時間前に仕事を始めた。
I sometimes dream of my mother.	私は、母の夢をときどき見る。
I must carry on my studies.	私は、勉強をし続けなければいけない。
I am happiest when I sleep.	私は、寝ている時がいちばん幸福です。
I'll send you home in my car.	私の車でお宅まで送らせましょう。
Please leave my things alone.	私の持ち物に触れないでください。
Don't forget what I told you.	私の言ったことを絶対に忘れるな。
Please give me something to eat.	私に何か食べる物を下さい。
We named our dog White.	私たちは私たちの犬をホワイトと名づけました。
We immediately became friends.	私たちはたちまち仲良くなった。
We enjoyed watching the game.	私たちはその試合を見て楽しんだ。
I ran off some of the oil.	私が石油をいくらか流出させてしまった。
I'd like to pay the check, please.	支払いをお願いします。
Follow the example of your sister.	姉さんを見習いなさい。
We left the final decision to him.	最終決定は彼に任せた。
It brought me down to earth.	再び惨めな現実に引き戻されました。
What seems to be the problem today?	今日はどうしました。
Bring your sister next time.	今度は妹さんを連れていらっしゃい。
A bad cold is going about now.	今悪性の風邪がまん延している。
It is now in the best condition.	今、最良の状態にあります。
One man's gain is another man's loss.	甲の損は乙の得。
What do you think of modern art?	現代芸術をどう思いますか。
You should face up to the reality.	現実を直視するべきだ。
The dog attacked the little boy.	犬が小さな男の子を襲った。
The police are looking into it.	警察はそれを調査しています。
The police broke up the fight.	警察はそのけんかをやめさせた。
You shall be my daughter's husband.	君を娘の夫にしよう。
Do you like Mozart's music?	君はモーツァルトの音楽は好きですか。
Where did you get your degree?	君はどこで学位を取りましたか。
All you have to do is to wait.	君はただ待ってさえいればいい。
What you said surprised me.	君が言ったことで、僕はびっくりした。
The bank isn't open on Sundays.	銀行は日曜にはやってません。
The argument ended in a fight.	議会はさいごにけんかになった。
Cross out all the wrong answers.	間違った答えは全部消す事。
Walk fast so as to be in time.	間に合うように速く歩きなさい。
It is written in simple English.	簡単な英語で書かれている。
May you and your family be happy.	家族のご多幸を祈ります。
Above all, take care of yourself.	何よりも、お体を大切に。
I want to drink something cold.	何か冷たいものが飲みたいな。
I need something to write with.	何か書くためのものが必要だ。
I'll give you a piece of my mind.	遠慮なく意見してやるぞ。
What are the business hours?	営業時間は何時から何時までですか。
Where on earth did you meet him?	一体どこで彼に会ったんだ。
What on earth are you doing?	一体あなたは何をしているのですか。
There used to be a church here.	以前ここに教会がありました。
There is a church near my house.	わが家の近くに教会がある。
Please put it back in its place.	もとの場所に戻して下さい。
I'm going to save more money.	もっとお金をためようと思うんだ。
Write your name, first of all.	まず、第一に名前を書きなさい。
There are some flies on the wall.	ハエが壁に止まっている。
Tom has an eye for modern art.	トムは現代美術を見る目がある。
Sometimes I run out of money.	ときどきお金が足りなくなります。
Please make yourself at home.	どうぞごゆっくりなさって下さい。
How can we buy British goods?	どうしたら英国商品が買えますか。
How can I forget those days?	どうしたらあの日々が忘れられるか。
Please don't bother about me.	どうか私に気を使わないで下さい。
Please take care of yourself.	どうかお体に気をつけてください。
I want to put this on house charge.	つけでお願いします。
I've just been to the bank.	ちょうど銀行へ行ってきたところです。
I'm just about to check in.	ちょうどチェックインするところです。
I'd like to book three seats.	チケットを３枚予約したいのです。
It's getting colder and colder.	だんだん寒くなってきている。
How many samples, for example?	たとえば、標本はいくつですか。
I've never seen so big a dog.	そんな大きな犬は見たことが無い。
It has great weight with her.	それは彼女にとって重大であった。
You are acting beyond your position.	それは越権行為だ。
Be that as it may, you are wrong.	それはとにかく君が悪い。
The problem was under discussion.	その問題は討議中でした。
That question is under discussion.	その問題は審議中です。
The dream has become a reality.	その夢が現実のものとなった。
Who was the book written by?	その本は誰によって書かれましたか。
The patient is up and about.	その病人は起きて動きまわっている。
In that case, call the police.	その場合には警察を呼びなさい。
The dog was running toward him.	その犬は彼の方に走っていた。
The dog came running to me.	その犬は私のほうに走ってやって来た。
I've seen that picture before.	その絵は以前に見たことがある。
You should have seen the film.	その映画を見るべきだったのに。
I found the film interesting.	その映画を見たらおもしろかった。
He has the lead in the race.	そのレースでは彼がリードしている。
Such a method is out of date.	そのような方法は時代遅れである。
You must not trust every man.	すべての人を信用してはいけない。
I can see a ship in the distance.	ずっと遠くに船が見える。
Our sister will be with us soon.	すぐにシスターが参ります。
Can I have the key now, please?	じゃあ、キーをもらえますか。
But we carried on without him.	しかし我々は彼なしで続行した。
Come on! I can't wait any more.	さあ行こう、もう待てないよ。
Now, I'll take your temperature.	さあ、体温を計りましょう。
These problems are beyond me.	これらの問題は私の手に負えない。
This didn't fit me very well.	これは私には似合いませんでした。
What a beautiful rose this is!	これはなんて美しいバラだろう。
This is mine, and that's yours.	これが僕ので、これが君のだ。
Please keep this book at hand.	この本を手元に置いてください。
What is written in the book?	この本には何が書いてあるのですか。
Can you save this seat for me?	この席を見ていてくれませんか。
I'll never tell this to anyone.	この事は絶対に口外しません。
This task is too much for him.	この仕事は彼には手に負えない。
This job is beyond my ability.	この仕事は私には手に負えない。
What a surprise to see you here!	ここで君に会うとは驚きだ。
Mr Green keeps a little dog.	グリーン氏は小さな犬を飼っている。
I'm very pleased to meet you.	お目にかかってたいへんうれしい。
Don't be too hard on me, please.	お手柔らかにお願いします。
Ottawa is the capital of Canada.	オタワはカナダの首都です。
Please come and see me any time.	いつでも遊びに来て下さい。
Why should you be surprised?	いったいなぜ驚いたりするのですか。
Some day my dream will come true.	いつか私の夢は実現する。
Shall I buy some for him?	あの人のために何か買ってあげましょうか。
The sisters are quite unalike.	あの姉妹はまったく似ていない。
You should do away with that dog.	あの犬は始末すべきだよ。
That dress really becomes her.	あのドレスは彼女によく似合う。
You shouldn't break promises.	あなたは約束を破ってはいけない。
You are not in the least happy.	あなたは少しも幸せではない。
What are you worrying about?	あなたは何を心配しているのですか。
What on earth are you doing?	あなたは一体何をしているんですか。
You must do it yourself.	あなたはそれを自分でやらなければならない。
Write your name and address.	あなたの名前と住所を書いて下さい。
I'd like to see your sister.	あなたの妹さんに会いたいものです。
Please tell me what you think.	あなたの考えを言ってください。
I'm surprised to see you.	あなたにお会いするとは思いませんでした。
I really enjoyed your company.	あなたと一緒にいて楽しかった。
Please call me at about 7:30.	７時３０分ごろに電話をください。
Are both of you ready to go?	２人とも行く用意はできていますか。
He stayed there a couple of days.	２、３日そこに滞在した。
I'll be back in an hour or so.	１時間かそこらで帰ってきます。
I'd like seats on the first floor.	１階席が欲しいのです。
Her hair fell over her shoulder.	彼女の髪は肩にたれている。
The ship is at sea for India.	その船はインドに向けて航海中だ。
The person in charge will check it.	係の人がチェックをする
He determines future directions.	彼が今後の方向付けを行います
He suddenly looks out of the window.	彼がふと窓の外を見る
Someone quickly answered the phone.	すぐに、電話に人が出た
He reads the next part immediately.	彼が早速その続きを読む
It seems to me that X exists.	それがあるように、私には思われます
Everyone knew X for the first time.	Xを初めて誰もが知った
Finally, I got used to people.	自分がやっと人間に慣れてきました
He enjoys the music with me/them.	彼が一緒に音楽を楽しみます
I will give you two examples below.	以下に例を２つあげます
It's getting colder and colder.	ますます寒さが厳しさを増します
I 'm determined to try again.	私が再チャレンジを心に誓っています
He will be in charge of the design.	彼がデザインを手掛ける
Everyone is really happy about X.	Xを誰もが心から喜んでいる
I haven't gotten over this cold yet.	まだ風邪が治りません
Chewtarou is Mrs Tanaka's dog.	チューたろうは田中さんの犬です。
Would you please let go of my arm?	腕を放してくれませんか。
This is a condition caused by aging.	老化現象の一種です。
You must look to your manners.	礼儀に気をつけなければならない。
In the evening, I walk with my dog.	夕方私は犬と散歩する。
Where can I find the post office?	郵便局はどこにありますか。
It is not good to break a promise.	約束を破るのは良くない。
You should not break your promise.	約束を破ってはならない。
Can you walk with your eyes closed?	目を閉じて歩けますか。
Happy is a man who is contented.	満足している人は幸福である。
Don't forget to post the letter.	忘れずに手紙を投稿しなさい。
Remember to post the letter.	忘れずにその手紙を投函してください。
My mother is laid up with a cold.	母は風邪で寝込んでいます。
Mother made me a fine dress.	母は私に素敵なドレスを作ってくれた。
Try to do things for yourself.	物事を自分でするよう努めなさい。
It was dark and cold in the room.	部屋の中は暗くて寒かった。
That's beautiful, said John.	美しい曲だね。とジョンが言いました。
She doesn't care about her dress.	彼女は服装に気を使わない。
She enjoyed talking with him.	彼女は彼とのおしゃべりを楽しんだ。
She always kisses up to teachers.	彼女は先生にこびてばかり。
She has an eye for the beautiful.	彼女は審美眼を持っている。
She smiled, waving her hand.	彼女は手を振りながらにっこり笑った。
She is getting better by degrees.	彼女は次第に回復している。
She is writing a letter now.	彼女は今手紙を書いているところです。
Did she show you the picture?	彼女は君にその写真を見せましたか。
She continued her job in the bank.	彼女は銀行に勤め続けた。
She listened to music for hours.	彼女は何時間も音楽を聞いた。
I wonder where she has gone.	彼女はどこへ行ってしまったのかしら。
I wonder what has become of her.	彼女はどうなったのだろうか。
She's not in the least worried.	彼女はちっとも気にしていない。
She may not wait any longer.	彼女はこれ以上待てないかもしれない。
She runs fastest in our class.	彼女はクラスの中で一番足が速い。
She is always dressed in black.	彼女はいつも黒い服を着ている。
She is always kind to everyone.	彼女はいつもだれにも親切です。
She thought of a good solution.	彼女はいい解決策を思いついた。
I saw her coming up the road.	彼女がこちらへやって来るのを見た。
They go to church every Sunday.	彼らは毎週日曜日に教会へ行く。
They kept me waiting for an hour.	彼らは私を１時間待たせた。
They must be waiting for you.	彼らは君を待っているにちがいない。
They lived a happy life there.	彼らはそこで幸せな生活を送った。
They immediately fell to work.	彼らはすぐに仕事に取りかかった。
He put on airs in her presence.	彼は彼女の前で気取って見せた。
He never seems to grow older.	彼は全然年を取らないように見える。
He is not a man to be trusted.	彼は信頼できるような男ではない。
He is crossing the street now.	彼は今道を横切っているところだ。
He is not as simple as he seems.	彼は見かけほど単純ではない。
Does he write an English letter?	彼は英語の手紙を書きますか。
He listened to music by himself.	彼は一人で音楽を聴いていた。
He has lain there for an hour.	彼は一時間そこで横になっていた。
He died from the cold last night.	彼はゆうべの寒さで死んだ。
He acts as if he were a king.	彼はまるで王様のように行動をする。
He is the happiest man on earth.	彼はこの世で一番の幸せ者だ。
He worked for five hours on end.	彼は５時間つづけて勉強した。
He looked for them for five hours.	彼は５時間それを捜した。
He'll get there in ten hours.	彼は１０時間でそこに着くでしょう。
What he said proved true.	彼の言ったことは本当であるとわかりました。
He has been dead for three years.	彼が死んで３年になります。
It is certain that he is wrong.	彼が間違っているのは確かです。
There is little oil in Japan.	日本にはほとんど石油がありません。
Will you please show me the way?	道を教えてくださいませんか。
Please hold the line a moment.	電話を切らずに少しお待ち下さい。
Please phone me before you come.	電話をしてからきてください。
Can you take notes over the phone?	電話でメモが取れますか。
Here's to a long and happy life!	長寿とご幸福を祝して、乾杯。
I chanced to see her on the street.	町で偶然彼女に会った。
Knowledge is power without doubt.	知識は疑いもなく力である。
Everything comes to those who wait.	待てば海路の日和あり。
Try to be patient with others.	他人には辛抱するようにしなさい。
Please keep the windows open.	窓を開けたままにしておいて下さい。
I'm used to keeping early hours.	早寝早起きには慣れています。
He is thinking of going to sea.	船乗りになろうかと考えている。
You had better have gone by ship.	船で行く方がよかったのに。
The light changed from red to green.	赤信号が青に変った。
You may leave your seat at will.	随意に退席してかまいません。
Could you page someone for me?	人を呼び出していただけませんか。
Please, you can have the paper first.	新聞を先にどうぞ。
Please send us more information.	新しい資料をお送りください。
Would you mind waiting a moment?	少し待っていただけませんか。
Remember to post the letter.	手紙をポストに入れるのを忘れないで。
Reflect on what you have done.	自分のしたことをよく考えなさい。
I sometimes see him on the street.	時々彼に通り出会います。
I tried writing with my left hand.	試しに左手で書いてみた。
How is it in a private school?	私立の学校はどういう感じですか。
We came to a turn in the road.	私達は道が曲がったところに来た。
We need to review the case.	私達はその事件を再調査する必要がある。
I'd be happy if you'd help me.	私を助けてくださるならうれしい。
I took her for her sister.	私は彼女を彼女の姉妹だと思っていました。
I remember writing to her.	私は彼女に手紙を書いたことを覚えている。
I was very worried about her.	私は彼女について大変心配している。
I know that she is beautiful.	私は彼女が美しいのを知っています。
I saw her crossing the street.	私は彼女が通りを横切るのを見た。
I told him that he was wrong.	私は彼に彼が間違っているといった。
I was seen to cross the street.	私は通りを横切るのを見られた。
I was made to wait for a long time.	私は長い間待たされた。
I waited for her for a long time.	私は長い間、彼女を待った。
I don't believe just anyone.	私は誰でも信ずるというわけではない。
I have read many modern authors.	私は多くの現代作家を読んだ。
I am pleased with my new house.	私は新しい家が気に入っている。
Do I have to write a letter?	私は手紙を書かなければなりませんか。
I save what money I got.	私は手に入るわずかばかりの金をすべて蓄えた。
I am very pleased with my job.	私は自分の仕事が気に入っている。
I watched for the last chance.	私は最後のチャンスを待ち構えた。
I opened my account with the bank.	私は銀行に口座を開いた。
I received a good job offer.	私は割のいい仕事の申し入れを受けた。
I want something cold to drink.	私は何か冷たい飲み物が欲しい。
I want to drink something cold.	私は何か冷たいものが飲みたい。
I want to buy something to eat.	私は何か食べるものを買いたい。
I like listening to good music.	私はよい音楽を聞くのが好きだ。
I have money enough to buy it.	私はそれを買うだけのお金がある。
I have seen the film before.	私はその映画を以前に見たことがある。
I want to join Joe's group.	私はジョーのグループに加わりたいです。
I have waited a full three hours.	私はきっちり３時間待った。
I have enjoyed talking to you.	私はあなたとお話ししてよかった。
I first met him three years ago.	私は３年前始めて彼にあった。
I visited Fukuoka ten years ago.	私は１０年前に福岡に訪れた。
I have been learning a science.	私は、ずっと科学を習っている。
I like the music of Austria.	私は、オーストリアの音楽が好きです。
My dream is to become a teacher.	私の夢は先生になることです。
My dream is still just a dream.	私の夢は今でもまだただの夢だ。
My sister lives near Yokohama.	私の妹は横浜の近くに住んでいる。
My room looks out on the street.	私の部屋は通りに面している。
My father doesn't like music.	私の父は音楽が好きではありません。
Don't bother yourself about me.	私のことはかまわないで下さい。
Half of my class like dogs.	私のクラスの生徒の半分は犬が好きです。
Please speak to me in English.	私には英語をしゃべってください。
We shall do this free of charge.	私たちは無料でこれをします。
We were looking at the picture.	私たちはその絵をながめていた。
This rule reads several ways.	この規制は行く通りにも解釈できる。
The bank was held up last night.	昨夜その銀行に強盗が入った。
I'm feeling a little blue today.	今日は少し気がめいっている。
There is not the least wind today.	今日はちっとも風がない。
He'll become a good husband.	今はそうじゃなくても将来はいい夫に。
I'm worn out by the hard work.	骨の折れる仕事をしてくたくただ。
Give your argument against going.	行かない理由を述べなさい。
Will you phone me later, please?	後で電話をしてくれませんか。
The dog came running up to me.	犬が私のところに駆けよってきた。
Do you like to be kept waiting?	君は待たされるのが好きですか。
Your problem is similar to mine.	君の悩みは僕の悩みと同じだ。
It is no use your waiting for him.	君が彼を待っても無駄だ。
Your meaning is beyond me.	君が言わんとする事は僕には理解できない。
What are the banking hours?	銀行は何時から何時まで開いていますか。
I have no money, but I have dreams.	金はないけど夢はある。
I was too surprised to speak.	私は驚きのあまり口もきけなかった。
I will be pleased to help you.	喜んであなたのお手伝いをします。
I hope my dream will come true.	願いが現実になるとよいのだが。
The wrong time, the wrong place.	間違った時代、間違った場所。
You must follow school rules.	学校の決まりは守らないといけない。
It was piercingly cold outside.	外は身を切るような寒さだった。
Everyone says that he's a good man.	皆彼はいい人だと言う。
A fire broke out on the first floor.	火事は１階から出た。
Could you please drive me home?	家まで送ってくださいませんか。
Prices seem to be going down.	価格はどんどん下がっていくようだ。
What time should I check in?	何時にチェックインすればいいですか。
When should we check out?	何時にチェックアウトしなければならないの？
What do you do to pass the time?	何をして時間をつぶしますか。
I must save her at all costs.	何としても彼女を救わねばならない。
English is a means of communication.	英語は伝達の手段だ。
I'll be back within an hour.	一時間もたたないうちに帰ってきます。
Put more spirit into your work.	もっと気合いを入れて仕事しろ。
Mary is respected by everyone.	メアリーは皆から尊敬されている。
Everyone thinks the same thing.	みんなが同じことを考えている。
Everyone always asks me that.	みんながいつも私にそれをたずねる。
Could you keep still, everyone?	皆さんじっとしていてください。
I felt as if I were in a dream.	まるで夢を見ているようだった。
Let's take your temperature first.	まず体温を計りましょう。
Really? What's your special today?	ほんと。今日のお勧めは？
Nancy has a hold on her husband.	ナンシーは夫を支配している。
It is said that Tom has a cold.	トムは風邪をひいているそうだ。
Please feel free to call me up.	どうぞ遠慮なく電話をください。
Please put this into English.	どうぞこれを英語に直してください。
Please give me a glass of water.	どうか私に水を一杯ください。
Would you please open the door?	ドアを開けていただけませんか。
Someone seems to be calling me.	だれかが私を呼んでいるようだ。
Forget about that right now.	そんな事はすぐに忘れてしまいなさい。
Please don't speak so fast.	そんなに早口でしゃべらないでください。
Don't worry about money so much.	そんなにお金の心配をするな。
It is no use worrying about it.	それを思い悩んだって無駄だよ。
It's not a road, but a path.	それは道路ではなくてただの小道です。
It seems very difficult for me.	それは私にはとても難しそうだ。
There seems no doubt about it.	それについては疑いはないようだ。
The old couple had no children.	その老夫婦には子供がなかった。
There wasn't anyone in the room.	その部屋には誰もいなかった。
It was a really beautiful day.	その日は実にすばらしい日だった。
She clearly does not mean it.	その通り受け取っちゃいけませんよ。
Please don't open the window.	その窓を開けないようにして下さい。
The man died a few hours ago.	その人は数時間前に亡くなりました。
The women will fine the man.	その女性は男性に罰金を課すつもりだ。
It was Tom that saved the girl.	その女の子を救ったのはトムだ。
Don't forget to post the letter.	その手紙を出すのを忘れるな。
Three years have passed since then.	その時より３年たった。
The dog came running to us.	その犬は私たちのほうへ走ってきました。
We have an account with the bank.	その銀行に取り引きがある。
I've seen that picture before.	その絵、以前に見たことがあるよ。
Please think no more about it.	そのことはもう考えないで下さい。
There is no doubt about it.	そのことについてはまったく疑いがない。
There is a post office close by.	すぐ近くに郵便局があるんだ。
Susan made a dress for Jill.	スーザンはジルに服をつくってやった。
Switzerland is a beautiful country.	スイスは美しい国です。
John had a bad cold last week.	ジョンは先週ひどい風邪をひいた。
No one stops to listen to him.	じっくり彼に耳を貸す者はいない。
But everyone else is still.	しかし、他の人は誰も動いてはいません。
Jane wrote the letter herself.	ジェーン自身がこの手紙を書いた。
Please remember me to your family.	ご家族の皆様によろしく。
This should be clear to everyone.	これは誰にも明らかだろう。
This is a picture of my sister.	これは私の妹を撮った写真です。
This is my best work to date.	これが現在までの私の最高傑作です。
Could you take me to this seat?	この席まで案内してくれますか。
Please take me to this address.	この住所まで、行ってください。
Please take a look at this picture.	この写真を見て下さい。
This picture was taken by him.	この写真は彼によって撮影された。
This fact must not be forgotten.	この事実を忘れてはならない。
This dog eats almost anything.	この犬は何でもほとんど食べます。
This rule applies to you, too.	この規則はあなたにも当てはまる。
I can no longer stand the cold.	この寒さにはもう耐えられない。
Who wrote these two letters?	この２通の手紙を書いたのは誰ですか。
Please bring me some glasses.	コップをいくつか持ってきて下さい。
Give me a glass of water, please.	コップ１杯の水をください。
Here is a picture to show you.	ここにあなたに見せる写真がある。
The goal is still some distance away.	ゴールはまだ先だ。
Kumi is the girl who likes dogs.	クミは犬が大好きな少女です。
Kumiko runs as fast as Tom.	クミコはトムと同じくらい速く走ります。
It seems that Cathy likes music.	キャシーは音楽が好きらしい。
You shall be my daughter's husband.	お前を娘の夫にしよう。
I don't mean to make you worry.	お前を心配させるつもりはない。
The Inca were religious people.	インカ人は信心深い民族だった。
Some ships are going out now.	いま出ていく船がいくつかあります。
Please tell me when to go.	いつ行ったらいいのか私に教えてください。
I am very pleased to meet them.	あの方たちに大変うれしいです。
You should have seen the film.	あの映画を君は見るべきだったね。
What shall we buy with that money?	あのお金で何を買おうか。
Did you feel the earth move?	あなたは地面が動くのを感じましたか。
Are you going to buy the car?	あなたはその車を買うつもりですか。
Your idea is similar to mine.	あなたの考えは私のとよく似ている。
Please write about your home.	あなたの家庭のことを書いて下さい。
I'm going to check out at eight.	８時にチェックアウトします。
I will come to you in an hour.	１時間して君のところに行きます。
"What time is it?" he wondered.	「何時だろうか」と彼は思った。
What will you do when you grow up?	大人になったら何になる？
I'm not sure what's wrong.	どこが間違っているのかよく分かりません。
You can check the situation with X.	Xで状況の確認が出来ます
It takes a lot of brains to do that.	それにはかなり頭を使う
Something will go wrong at/in/with X.	Xで必ず事件が起きる
It's much faster to do it like this.	断然こっちのほうが早い
He asked for directions four times.	彼が４回も人に道を尋ねた
Ten years is a long time to wait.	１０年は待つには長い時間だ。
An old man lay dead on the road.	老人が一人、道路で死んでいた。
You shouldn't eat anything cold.	冷たい食事は、避けてください。
Respect is greater from a distance.	離れてみれば尊敬は増す。
In a word, I don't trust him.	要するに僕は彼のこと信用していない。
I had a date with Jane last night.	夕べジェーンとデートした。
I received a letter from my friend.	友人から手紙をもらった。
The effect of the drug had worn off.	薬の効果は消えていた。
Promises are things that must be kept.	約束は守るものだ。
Every day I work different hours.	毎日働く時間帯が違うんです。
Please tell me how to take a book.	本の借り方を教えて下さい。
Something is wrong with my watch.	僕の時計はどこか具合が悪い。
Don't worry. I'll stay with you.	僕がついているから心配するな。
Did you enjoy staying in Hokkaido?	北海道は楽しかったですか。
Please remember to write to her.	忘れずに手紙を書いてください。
Remember to post the letter.	忘れずにその手紙をポストに入れなさい。
My mother made me a white dress.	母は私に白い服を作ってくれた。
My mother is writing a letter now.	母は今手紙を書いています。
She has received a good education.	彼女は立派な教育を受けた。
She kept him waiting half an hour.	彼女は彼を３０分待たせた。
She is not in the least surprised.	彼女は少しも驚いていない。
She can make her own dresses.	彼女は自分の洋服を作ることができる。
She has finally achieved her end.	彼女はついに目的を達成した。
She is pleased with the dress.	彼女はそのドレスが気に入っている。
She is the happiest in her class.	彼女はクラスで一番幸せです。
She can be trusted to some degree.	彼女はある程度信用できる。
I wondered if her story was true.	彼女の話は本当かなと思った。
Her husband is usually drunk.	彼女の夫はたいてい酔っぱらっている。
Did you notice her new dress?	彼女の新しいドレスに気づきましたか。
Why don't you tell her directly?	彼女に直接言ったらどうですか。
I wonder what has happened to her.	彼女に何か起こったのかな。
She has been dead for ten years.	彼女が死んでから１０年になる。
They made me wait for a long time.	彼らは私を長い事待たせた。
They are pleased with your work.	彼らは君の仕事に満足している。
They wondered what to do first.	彼らは何から始めるべきか考えた。
They left the town an hour ago.	彼らは一時間前にこの町を去った。
They moved here two years ago.	彼らは２年前当地に引っ越してきた。
He read the book from cover to cover.	彼は本を読み通した。
He is old, but he's worn well.	彼は年をとっていてもまだ若々しい。
He has been studying for two hours.	彼は二時間勉強している。
He grew up to be a great person.	彼は成長し立派な人間になった。
He drank three glasses of water.	彼は水をコップで三杯も飲んだ。
He seems to have known the truth.	彼は真実を知っていたらしい。
He is well able to pay the charge.	彼は十分その料金を払える。
He was happy being a Jew.	彼は自分がユダヤ人であることを幸せに思った。
He writes to me once in a while.	彼は時々わたしに手紙をくれる。
He tried writing a short story.	彼は試しに短い物語を書いてみた。
He told me not to wait for him.	彼は私に待たないでくれと言った。
He asked me what I had bought.	彼は私に、何を買ったのかと尋ねた。
He bought a small house in Kyoto.	彼は京都に小さな家を買った。
While resting, he listens to music.	彼は休憩中に音楽を聞く。
I believe him to be a man of ability.	彼はやり手だと思う。
He hasn't written the letter yet.	彼はまだ手紙を書いていない。
He sometimes goes to work by car.	彼はときどき車で仕事に行く。
He sometimes comes to see me.	彼はときどき私のところへ遊びに来る。
He seems to have left the country.	彼はその国を去ったらしい。
He has some money in the bank.	彼はその銀行にいくらか預金がある。
He made the most of the chance.	彼はその機会を最大限に活用した。
He is always forgetting things.	彼はいつも忘れ物ばかりしている。
He came to Japan seven years ago.	彼は７年前に日本に来ました。
He has turned 180 degrees around.	彼の態度は１８０度変わった。
What he writes comes to this.	彼の書いていることはこういう意味だ。
He had no chance to visit us.	彼には私たちを訪れる機会がなかった。
He was seen crossing the road.	彼が道路を渡るのが彼女に見られた。
We saw him walk across the street.	彼が通りを渡るのが見えた。
That he comes here is surprising.	彼がここに来るなんて驚きだ。
Suddenly, a young woman stood up.	突然若い女性が立ち上がった。
We'd like separate checks, please.	伝票は別々にお願いします。
Everyone said that I was wrong.	誰もが私は間違っているといった。
Write your name in capital letters.	大文字でお名前を書いて。
I wish you to go there instead.	代わりに君にそこへ行ってほしい。
I feel happiest when I'm running.	走っているときが一番幸せだ。
A red dress made her stand out.	赤いドレスのため彼女は目立った。
Can I speak to the person in charge?	責任者を出して下さい。
Nothing adds up in the world.	世の中に納得できるものなんてないよ。
You may leave your seat at will.	随時に退席してもかまいません。
Life is a long and winding road.	人生は長い曲がりくねった道だ。
A new dress was bought for her.	新しい服が彼女のために買われた。
Lack of sleep began to tell on me.	寝不足の影響がではじめた。
The class was carried on in English.	授業は英語でなされた。
I don't want to have an operation.	手術はしたくないのですが。
Don't you have a phone in your car?	車に電話はないのかしら？
Our ship touched at Marseilles.	私達の船はマルセーユに寄港した。
I have no time to write to her.	私は彼女に手紙を書く時間がない。
I can't trust such a man as he.	私は彼のような人は信用できない。
I had the letter written by him.	私は彼に手紙を書いてもらった。
I saw him crossing the road.	私は彼が道路を渡っているところを見た。
I saw him crossing the street.	私は彼が通りを渡っているのを見た。
I like the Mediterranean Sea best.	私は地中海が一番好きです。
I walked along the main street.	私は大通りをずっと一人で歩いた。
I have a mind to buy a new car.	新しい車を買おうかと思っている。
I can give you several instances.	私は事例をいくつか出せます。
I had a dream about you last night.	私はゆうべ君の夢を見た。
I see the dog almost every day.	私はほとんど毎日その犬に出会う。
I sometimes write to my mother.	私はときどき母に手紙を書きます。
I chanced on a beautiful girl.	私はたまたま美しい少女と出会った。
I have made a promise to do it.	私はそれをすると言う約束をした。
I was the happiest man on earth.	私はこの世で一番幸せ者でした。
I am always ready to help you.	私はいつでも喜んでお手伝いします。
I am not what I was ten years ago.	私は１０年前の私ではない。
I doubt the truth of the report.	私は、その報告の真実性を疑う。
Write to him for me, Jan.	私の代わりに彼に手紙を書いて下さい、ジャン。
Please give me a hand with my job.	私の仕事を手伝って下さい。
My brother can run very fast.	私の兄はとても速く走ることができる。
Give me something cold to drink.	私に何か冷たい飲み物を下さい。
We took part in the discussion.	私たちはその議論に参加しました。
We were flying about six hours.	私たちは、６時間ほど飛んでいた。
Our dream has come true, at last!	私たちの夢がついに実現した。
Our house stands by the road.	私たちの家は道路に沿って立っている。
Would you like to join our team?	私たちのチームに入りませんか。
Add two to three, and you get five.	三に二を足すと五になる。
I wrote a love letter last night.	昨夜ラブレターを書きました。
I wrote a love letter last night.	昨晩ラブレターを書きました。
Don't worry about what you've done.	済んだことを気にするな。
I wonder what I should do today.	今日私は何をしたらよいだろう。
I've been pressed for time today!	今日は時間に追われていてね。
Bring me today's paper, please.	今日の新聞を持って来てください。
For a full day from today please.	今日から丸１日お願いします。
You look very happy this morning.	今朝はとてもうれしそうだね。
I have done much writing this week.	今週は大いに書きました。
I am in communication with her now.	今、彼女と文通している。
Dogs are man's closest friends.	犬は人間の最も親しい友達である。
You must take care of your dog.	犬の世話をしなければなりません。
Can't you tell right from wrong?	君は善悪の判断ができないのか。
You may as well do the task now.	君はその仕事を今した方がよい。
Your ideas are different from mine.	君の考えは私のと異なる。
Your method is different from mine.	君のやり方は僕のと違う。
Modern methods improved industry.	近代的方法で産業は向上した。
Her eyes become round in surprise.	驚いて彼女は目を丸くした。
I've suddenly started to gain weight.	急に太りだしました。
The temperature fell several degrees.	気温が数度下がった。
A cold wave passed over Japan.	寒波が日本の上空を通過したのです。
It being cold, we made a fire.	寒かったので、我々は火を燃やした。
I am positive that he is wrong.	確かに彼が間違っていると思うよ。
May I have your attention, please?	皆様にご連絡申し上げます。
Please wait outside of the house.	家の外で待っていてください。
I am interested in listening to music.	音楽鑑賞が趣味だ。
I've never been beyond Okayama.	岡山から先には行ったことがない。
We can see Mt. Fuji in the distance.	遠くに富士山が見える。
We could see the ship in the distance.	遠くに船が見えた。
In a word, you are in the wrong.	一言で言えば君は間違っている。
There used to be a church here.	以前にはここに教会がありました。
Try to avoid bad company.	悪い仲間とつきあうのは避けるようにしなさい。
I doubt whether it is true or not.	わたしはそれの真意を疑う。
London is the capital of England.	ロンドンは英国の首都である。
Could you reduce the price a little?	もっと安くなりますか。
Meg must carry on her studies.	メグは勉強を続けなけれがならない。
I trust that I can see you again.	またお会いできると思います。
I wonder what happened to Paul.	ポールの身に何があったのかしら。
Come what may, I am ready.	どんな事があっても、私は覚悟ができている。
Any child can enjoy the story.	どんな子供でもその物語を楽しめる。
Above all, take care of yourself.	とりわけ体に気をつけなさい。
There seems to be no need to go.	どうも行く必要はないようです。
May I return the car instead?	そのかわりに車を返してもいいですか。
Please go up to the third floor.	どうぞ３階へ上がってください。
Please let me take your picture.	どうか写真を撮らせてください。
Don't let anyone come near the fire.	だれも火に近づけるな。
I don't go in for that sort of thing.	そんなことは嫌いだ。
Three years have passed since then.	それ以来３年が経過した。
Make sure that you do it yourself.	それは必ず自分でしなさい。
It is written in easy English.	それはやさしい英語で書かれている。
Keep it at a lower temperature.	それはもっと低温で保存しなさい。
The story had a happy ending.	その話はめでたしめでたしで終わった。
The problem is beyond my power.	その問題は私の手には負えません。
The tree was ready to fall down.	その木は今にも倒れそうだった。
The man kept talking for an hour.	その男は一時間喋りつづけた。
The war took place 45 years ago.	その戦争は４５年前に起こった。
The plants died for lack of water.	その植物は水不足で枯れた。
Something was wrong with the watch.	その時計は故障している。
The dog came running to her.	その犬は走りながら彼女のところへ来た。
Money for the plan was lacking.	その計画には資金が不足していた。
You must keep to the rules.	あなたはその規則を守らなければならない。
What does the company produce?	その会社は何を作っているのですか。
We will accept your conditions.	そちらの条件を受け入れましょう。
Make sure that you do it yourself.	ぜひ自分でそれをしなさい。
Please leave everything to me.	すべてのことを私に任せてください。
It's necessary to avoid stress.	ストレスを避けることが必要です。
Mr Jordan was a little surprised.	ジョーダンさんは少し驚いた。
Please call me up if you want me.	ご用のときはお電話ください。
Why don't you make it yourself?	ご自分で作ってみたらどうですか。
Please remember me to all your family.	ご家族によろしく。
We couldn't be happier for you.	これ以上嬉しいことはありません。
Please put these glasses away.	これらのグラスを片付けてください。
No other dog is bigger than this.	これより大きい犬はいません。
This book is written in English.	この本は英語で書かれています。
This room has air conditioning.	この部屋にはエアコンがあります。
This road is closed to cars.	この道路は車は駐車禁止になっています。
This road is closed to cars.	この道路は、車は通行止めになっている。
The red kills the whole pattern.	この赤色で柄全体がだいなしだ。
Who is the girl in this picture?	この写真の中の少女は誰ですか。
Please bear this fact in mind.	この事実を心に留めておいて下さい。
This rule reads several ways.	この規則はいく通りも解釈があります。
This rule reads several ways.	この規則はいくとおりにも解釈できる。
This rule reads several ways.	この規制はいくとおりにも解釈できる。
This touch is original with her.	このタッチは彼女独自のものだ。
Please keep this money for me.	このお金を預かっておいてください。
Please wait here for a while.	ここでしばらくの間待っていて下さい。
Kate speaks English very fast.	ケイトはとても速く英語を話します。
Please take good care of yourself.	くれぐれもお体をお大事に。
I wish you to go there instead.	かわりに君にそこへ行って欲しい。
You might have just forgotten.	お忘れになっただけかと思いました。
Father found me a good seat.	お父さんは私に良い席を見つけてくれた。
Best regards to your father.	お父さんにはくれぐれもお伝えください。
Please tell me when to leave.	いつ出発すべきか私に教えてください。
Once you start, carry it on.	いったん始めたら、やり続けてください。
Please take a look at that picture.	あの写真を見てください。
You must get ready quickly.	あなたは急いで準備をしなければならない。
Did you make it for yourself?	あなたはそれを独力で作ったのですか。
I am quite pleased with you.	あなたのことがすっかり気に入りました。
The new year will come in an hour.	あと１時間で年が明けます。
Add six and four and you have ten.	６と４を足すと１０になる。
I got out of the car at 40th Street.	４０丁目で車を降りた。
I'll be over in half an hour.	３０分後にはお母さんがそこに行くわ。
Love began to grow between the two.	２人の間に愛が芽生えた。
May I ask a couple of questions?	２つの質問をしてもよいですか。
I've been there a couple of times.	２、３度行ったことがある。
"She likes music." "So do I."	「彼女は音楽が好きだ」「私もそうだ」
"May I join you?" "Why not?"	「一緒にいいかい」「もちろんいいとも」
There's a church behind my house.	私の家の後ろには教会がある。
That sort of thing won't happen.	そんなことは起きないでしょう。
Do you have any brothers or sisters?	きょうだいはいますか？
Could you please take a picture?	写真を撮っていただけませんか？
I often wonder if it might be X.	Xではないかとつくづく疑問に思う
It always seems like it is there.	それがあるようにいつも思います
He opens to several pages at once.	彼が一気に複数のページを開く
It will achieve a low price with X.	それがXで低価格を実現する
It further increases weight loss.	さらにダイエットの効果が高まる
He writes the program by himself.	彼が自分でプログラムを組みます
The world exists in your mind.	その世界が、あなたの心の中に存在する
Each of them took their own path.	それぞれがそれぞれの道を歩んだ
You can't call dogs off from a fight.	噛み合う犬は呼び難し。
He's good at this sort of thing.	彼は、こういうのがうまいのです。
Please don't cut me off like that.	話をさえぎらないでください。
The old man passed away this morning.	老人は今朝亡くなった。
You must look to your manners.	礼儀作法に気を付けなければいけない。
Show me a list of your rates, please.	料金表を見せて下さい。
I've just been to the post office.	郵便局へ行ってきたところだ。
Please add my name to the list.	名簿に私の名前も追加してください。
Would you please take my picture?	僕の写真を撮ってくれませんか。
The supplies will give out soon.	補給はまもなく不足するでしょう。
The supplies will give out soon.	補給がまもなく不足するでしょう。
Can I change the date of return?	返却日を変更する事ができますか。
The wind grew stronger and stronger.	風がどんどん強くなった。
Would you like to wait in the room?	部屋でお待ちになりますか。
My father passed away two years ago.	父は２年前に亡くなった。
Though she is poor, she is happy.	貧しいといえども彼女は幸せだ。
She usually sleeps for eight hours.	彼女は普通８時間眠ります。
She must have been very beautiful.	彼女は美しかったに違いない。
She continued her job in the bank.	彼女は銀行での仕事を続けた。
She worked on it with her all soul.	彼女はそれに精魂を込めた。
She tried on the party dress.	彼女はそのパーティードレスを試着した。
She is on the wrong side of twenty.	彼女は２０歳を越えている。
Her name is known to everyone.	彼女の名前はみんなに知られています。
Did you notice her new dress?	彼女の新しいドレスに気がつきましたか。
You need not worry about her.	彼女のことを心配する必要はありません。
I'll never forget seeing her.	彼女に会ったのを決して忘れないだろう。
He gave me authority to fire them.	彼らを解雇する権限をくれた。
Don't they take care of the dog?	彼らは犬の世話をしないのですか。
They must work 8 hours a day.	彼らは１日８時間働かなければならない。
He died of old age two years ago.	彼は老衰で二年前に亡くなった。
Though he was poor, he was happy.	彼は貧しかったが、幸せだった。
He was poor and could not buy it.	彼は貧しいのでそれが買えない。
He flew from London to Paris.	彼は飛行機でロンドンからパリへ行った。
He has no sense of right and wrong.	彼は正悪の区別がつかない。
Business carried him to Kobe.	彼は商用で神戸に行かねばならなかった。
He will have written a letter.	彼は手紙を書いてしまっているだろう。
He kept us waiting for a long time.	彼は私達を長い間待たせた。
Directly he saw me, he ran away.	彼は私を見るやいなや走り去った。
He lives immediately next to us.	彼は私たちのすぐ隣に住んでいる。
He is known to the entire country.	彼は国全体に知られています。
He never seems to feel the cold.	彼は決して寒さを感じないようだ。
He will be pleased to help you.	彼は喜んであなたを手伝うでしょう。
He kept waiting for hours and hours.	彼は何時間も待ち続けた。
He searched all day for the letter.	彼は一日中手紙をさがした。
He took the first place in the race.	彼はレースで１着だった。
Has he written the letter yet?	彼はもう手紙を書いてしまいましたか。
He has made a promise to come again.	彼はまた来ると約束した。
He seems to make nothing of it.	彼はそれを全く理解できないようだ。
It seems that he knows about it.	彼はそれについて知っている様だ。
He regarded the money as gone.	彼はその金をなくなったものと考えた。
He is pleased with the present.	彼はそのプレゼントを喜んでいます。
It seems that he knows everything.	彼はすべて知っているらしい。
He will write an answer very soon.	彼はすぐに返事を書くだろう。
I first met him three years ago.	彼に初めて会ったのは3年前です。
If only I get a chance to see him.	彼に会う機会さえあればなあ。
He has a son and two daughters.	彼には１人の息子と２人の娘がいる。
He is the man who drew the picture.	彼がその絵をかいた人です。
Where in Japan did you grow up?	日本のどこであなたは育ちましたか。
The couple was walking arm in arm.	二人は腕を組んで歩いていた。
The same is true of the nation.	同じ事が国家についても当てはまる。
It can be cold here even in May.	当地では５月でも寒いことがある。
Don't forget to turn the light off.	電気を消すのを忘れないで。
Play out of doors on a fine day.	天気の良い日には外で遊びなさい。
The earth is made up of sea and land.	地球は海と陸からなる。
No one gave him a good chance.	誰も彼によいチャンスを与えなかった。
Am I waiting in the wrong place?	待ち合わせの場所間違えたかしら？
I received her letter the other day.	先日彼女から手紙がきた。
A long time ago, there was a young man.	昔、若い男がいた。
The girl with blue eyes is Jane.	青い目をした少女はジェーンです。
The world is running out of oil.	世界は石油を使い果たしています。
Bring me a glass of water, please.	水を一杯持ってきてください。
People believed her to be dead.	人々は彼女が死んだものだと思った。
Kobe is a sister city of Seattle.	神戸はシアトルの姉妹都市です。
She's pleased with her new dress.	新しいドレスが気に入っている。
I've been waiting for love to come.	心の傷を癒してくれる愛を。
Do you have this in any other colors?	色違いはありませんか。
Could you please make room for me?	場所を空けて下さいませんか。
The people present were surprised.	出席していた人たちは驚いた。
Please show me what to do next.	次はどうしたら良いか教えて下さい。
Please come over if you have time.	時間があったら来てください。
Don't forget to write to us.	私達に手紙を書くのを忘れないでください。
Please take me along with you.	私もいっしょに連れて行ってください。
I have been to the post office.	私は郵便局へ行ってきたところです。
I share the room with my sister.	私は妹と共同で部屋を使っている。
I couldn't tell her from sister.	私は彼女と妹を区別できなかった。
I have a letter written by him.	私は彼が書いた手紙を持っています。
I have a dog which can run fast.	私は速く走れる犬を飼っています。
I'll buy a watch for my son.	私は息子に腕時計を買ってやるつもりです。
I make it a rule to get up early.	私は早く起きることにしている。
I live an hour away from work.	私は職場から１時間の所に住んでいる。
I lived in Japan three years ago.	私は三年前に日本に住んでいた。
I wrote three letters last night.	私は昨晩手紙を３通書きました。
I can't go, nor do I want to.	私は行けないし、行きたいとも思わない。
I came to Liverpool by chance.	私は偶然にリバプールに来たのだった。
I felt a cold wind on my face.	私は顔に冷たい風が当たるのを感じた。
I am very interested in music.	私は音楽にたいへん興味をもっている。
I wrote to my teacher in English.	私は英語で先生に手紙を書いた。
I looked for the book for an hour.	私は一時間その本をさがした。
I have seen the picture before.	私は以前にその絵を見たことがある。
I feel as if I were dreaming.	私はまるで夢を見ているような気がする。
I'm Helen Cartwright's daughter.	私はヘレンカートライトの娘です。
I studied for perhaps two hours.	私はたぶん２時間ぐらい勉強した。
I'm not able to speak so fast.	私はそんなに早く話すことができない。
I couldn't make out the writing.	私はその筆跡を判読できなかった。
I passed the information on to him.	私はその情報を彼に伝えた。
I would like to carry out the plan.	私はその計画を実行したい。
I was all but dead at that time.	私はそのとき死んだも同然だった。
I use the room with my sister.	私はこの部屋を姉と共同で使っている。
I was the happiest man on earth.	私はこの世で一番の幸せ者でした。
I have some pictures to show you.	私はあなたに見せる写真がある。
I have been studying for two hours.	私は２時間勉強しています。
I will carry through the work.	私は、その仕事をやり遂げるでしょう。
Love me, love my dog.	私と友達になりたいなら、私の友達とも友達になってくれ。
We'll soon be happy, won't we?	私たちはもうじき幸福になるのですね。
We stood talking for half an hour.	私たちは３０分立ち話をした。
Please bear in mind what I said.	私が言ったことを覚えてください。
Kill me! Kill me! Kill all of me!	殺せ！殺せ！俺のすべてを殺せ！
It's time to move in for the kill.	最後のつめにはいるときです。
I tried to write with my left hand.	左手で書いてみようとした。
We are free from a cold wind today.	今日は冷たい風は吹かない。
The dog ran off as fast as it could.	犬は一目散に逃げ出した。
The police checked up on each car.	警官は車を１台１台検問した。
You have only to close your eyes.	君は目を閉じてさえすればよい。
Your dream will come true some day.	君の夢はいつか実現するさ。
I'd like to talk with you in private.	君にちょっと話がある。
A bear will not touch a dead body.	熊は死体には触れないものだ。
It seems like there's no money left.	金が残っていないようだ。
I put on a little weight last year.	去年少し体重が増えました。
You've got a good head on your shoulders.	気が利くなあ。
We must carry out that plan.	我々はその計画を実行しなければならない。
We regard him as a great man.	我々は、彼を偉大な人物とみなしている。
What time do you start check-in?	何時からチェックインできますか。
Sometimes everything goes wrong.	何もかも上手く行かない時がある。
English is an international language.	英語は国際言語である。
What on earth are you doing here?	一体全体君は何をしているんだ。
How on earth did you know that?	一体どうしてその事を知っていたの。
Please draw water from the well.	井戸から水をくんできてください。
If I had money, I could buy it.	もし金があれば、それが買えるのに。
A friend in need is a friend indeed.	まさかの時の友は真の友。
Bern is the capital of Switzerland.	ベルンはスイスの首都です。
Does Nancy want to have a dog?	ナンシーは犬を飼いたがっていますか。
Napoleon was a man of authority.	ナポレオンは権威がある男だった。
Please tell me where to go.	どこへ行ったらいいか私に知らせてください。
Please take good care of yourself.	どうぞ大事になさって下さい。
Please give me another chance.	どうかもう一度やらせてみてください。
There is a glass on the table.	テーブルの上にガラスのコップがある。
I finally contacted him by phone.	ついに彼と電話で連絡がついた。
Hold on a moment, please.	ちょっとの時間、電話を切らないでおきて下さい。
Please have someone else do it.	それは誰か他の人にやらせて下さい。
The old man was loved by everyone.	その老人は皆に愛されていた。
The theory is generally accepted.	その理論は広く承認されている。
The tree is green all year round.	その木は１年中青々としている。
The report proved only too true.	その報告は残念ながら本当だった。
The man was no better than a horse.	その男は、馬同然であった。
That red dress looks good on her.	その赤い服は彼女に合っている。
The boy drew a picture on the wall.	その少年は壁に絵を描いた。
The facts became known to everyone.	その事実は皆に知れ渡った。
Both sisters are very beautiful.	その姉妹は２人ともとても美人だ。
Carrying out the plan was easy.	その計画を実行するのは容易だった。
The church dates back to 1173.	その教会は１１７３年までさかのぼる。
What is the basis for the argument?	その議論の根拠は何ですか。
I found the picture interesting.	その絵画を見たらおもしろかった。
The picture is good in its way.	その絵はそれなりによくできている。
When will the film be released?	その映画は何時封切りになりますか。
You don't need to worry about it.	そのことで心配する必要はない。
And I always worried about it.	そして私はそれについていつも悩んだ。
Then, finally, she opened her mouth.	そしてついに口を開いた。
John is free from worry these days.	ジョンはこの頃心配がない。
The Joneses love their daughter.	ジョーンズ夫妻は娘を愛している。
It's not Joan. You are wrong.	ジョアンではなくて、君が間違っている。
Hold still for a moment, please.	しばらくそのままでいてください。
This is what I bought in Spain.	これは私がスペインで買った物です。
This applies to your case as well.	これは君の場合も当てはまる。
This is a direct road to London.	これはロンドンへ直行する道です。
This law does not apply in Japan.	この法律は日本では通用しない。
This material never wears out.	この素材は決してすり減ったりしない。
Will you keep this seat for me?	この席を取っておいてくれませんか。
This car is going 60km an hour.	この車は時速６０キロで走っている。
Is there a post office near here?	この近くに郵便局はありますか。
This rule applies to all cases.	この規則は全ての場合に当てはまる。
This rule applies to all cases.	この規則はどの場合にも当てはまる。
This rule applies to all cases.	この規則はどの場合でも当てはまる。
The whole class passed the test.	クラス全員がその試験に合格した。
Let's see. I bought it last week.	ええと、買ったのは先週でした。
When will you get ready to leave?	いつ出かける準備ができますか。
In a sense, life is but a dream.	ある意味で、人生は夢にすぎない。
He doesn't seem to be an American.	アメリカ人ではないようです。
Don't let that dog come near me!	あの犬を私の方へ来させないでよ。
You must think by yourselves.	あなた方は独力で考えなくてはいけない。
It's time for you to buy a new car.	あなたは新車を買うべきだ。
You have only to wait here.	あなたはここで待ってさえいればいいのです。
Your plan must fit in with mine.	あなたの計画を私に合わせなさい。
Your argument came across well.	あなたの議論は良く相手に伝わった。
When do you plan to check out?	あなたのチェックアウトはいつですか。
I will show you some pictures.	あなたに何枚かの写真を見せましょう。
You can trust him with any job.	あいつに仕事を任せておけば安心だ。
Two years is a long time to wait.	２年とは、待つには長い時間だ。
I'll call you up again in an hour.	１時間後にまたお電話します。
He is open to discussion at any time.	彼が随時相談の受付を行う
X protected their own way of life.	Xが自分たちの生活を守りました
He's heading directly to her house.	彼がそのまま彼女の家に向かう
I listen to their music in the car.	私が車の中で彼らの音楽を聴く
It would develop children's ability.	それが子どもの能力を育てる
I was happier about X than anything.	Xが私には何より嬉しかった
The couple had their third child.	夫婦に３人目の子供が生まれました
He is suddenly attacked by two men.	彼が突如二人組の男に襲われる
At first, everyone is surprised by X.	誰もがXにまず驚かされる
A friend of mine is coming this evening.	友達が今晩来ます。
You should carry out your promises.	約束はきちんと果たすべきだ。
My daughter will come of age this year.	娘は今年成年になる。
The drug problem is international.	麻薬汚染の問題は国際的である。
Before I forget, I will tell you.	忘れないうちに言っておきますと。
They'll walk there in half an hour.	歩いて３０分で着くでしょう。
There are some pictures on the wall.	壁に何枚かの絵があります。
Father made me a model of a ship.	父は私に船の模型を作ってくれた。
My father has five brothers and sisters.	父は５人兄弟です。
I would buy the car, but I am poor.	貧しくなければ車を買うのに。
Don't try to keep her to yourself.	彼女を一人占めしようとするな。
She just kept her distance from him.	彼女は余り親しくなかった。
She is as beautiful as her mother.	彼女は母親と同じぐらい美人だ。
She cut me dead in the street.	彼女は道で会っても僕をわざと無視した。
She is getting better by degrees.	彼女は徐々に態度がでかくなった。
She knows she's looking fine.	彼女は自分が素敵に見えるって知っている。
She kept me waiting for a long time.	彼女は私を長い間待たせた。
She wears the same watch as mine.	彼女は私のと同じ時計をしている。
She passed by without seeing me.	彼女は私に気がつかずに通り過ぎた。
She fitted me out with the money.	彼女は私にその金を調えてくれた。
She's not as beautiful as her sister.	彼女は姉ほど美しくない。
She made a face when she saw a dog.	彼女は犬を見ると顔を顰めた。
She addressed herself to the task.	彼女はその仕事に精力を傾けた。
She was pleased to see the results.	彼女はその結果をみて喜んだ。
She visited Kanazawa two years ago.	彼女は２年前に金沢を訪れた。
Her dream will one day come true.	彼女の夢はいつか実現するだろう。
Her mother is writing a letter.	彼女のお母さんは手紙を書いています。
Her voice sounds very beautiful.	彼女の声はとても美しく聞こえます。
She can't have written it herself.	彼女が自分で書いたはずはない。
They named their daughter Helen.	彼らは娘にヘレンという名をつけた。
They looked on him as an authority.	彼らは彼を権威者とみなした。
They each received a present.	彼らはひとりひとりプレゼントをもらった。
They have been here for an hour.	彼らがここにきて１時間になります。
He stood up and took a deep breath.	彼は立ち上がって深呼吸した。
He would do anything for gain.	彼は利益のためならなんでもするだろう。
He carried out what he had promised.	彼は約束した事を実行した。
He works every day save Sundays.	彼は日曜日を除いて毎日働いている。
He is known to everyone in the town.	彼は町の皆に知られている。
He should have bought a used car.	彼は中古車を買うべきだったのに。
He believed that the earth was round.	彼は地球が丸いと信じた。
He gave a party on a large scale.	彼は大々的にパーティーを催した。
He carried on business for many years.	彼は多年営業を続けた。
He saw the surprise on my face.	彼は私の驚きの表情を見てとりました。
He saw a UFO flying last night.	彼は昨夜ＵＦＯが飛んでいるのを見た。
He lived a life full of worries.	彼は苦労でいっぱいの一生を送った。
He had a lot of money in the bank.	彼は銀行に多額の預金があった。
He took many pictures in London.	彼はロンドンで多くの写真を撮った。
What kind of job is he fit for?	彼はどんな仕事にむいているのですか。
He is getting better by degrees.	彼はだんだんと快方にむかっている。
He need not have run so fast.	彼はそんなに速く走る必要がなかったのに。
He did it, and in her presence.	彼はそれをやった、しかも彼女の前で。
He wrote a paper on the subject.	彼はその問題について論文を書いた。
He will take charge of the class.	彼はそのクラスを担任するだろう。
He seems to have lived in Spain.	彼はスペインに住んでいたようです。
He has the ability to do the job.	彼にはその仕事をする能力がある。
He is the right man for the post.	彼こそその地位にふさわしい人だ。
Three years have passed since he died.	彼が死んで三年たった。
Day by day he seemed to get better.	日に日に彼は良くなるだろう。
It is getting colder day by day.	日ごとにだんだん寒くなっています。
All sorts of people live in Tokyo.	東京には色々な人が住んでいる。
My efforts produced no results.	努力したが何の成果も得られなかった。
Sadako wanted to forget about it.	禎子それを忘れてしまいたかった。
Why not come in and wait here?	中に入ってお待ちになったらどうですか。
There are many cultures on Earth.	地球上にはたくさんの文化がある。
It is true that the earth is round.	地球が丸いというのは真実だ。
It is true that the earth is round.	地球が丸いというのは事実だ。
Many people were killed in the war.	多くの人がその戦争で死んだ。
Don't worry about what others say.	他人のいうことを気にかけるな。
I used to go to church on Sunday.	昔日曜日には教会に行ったものだ。
People regard him as nothing.	世間は彼をつまらない人物とみなしている。
I'd like a glass of water, please.	水を一杯いただきたいのですが。
Shall I bring you a glass of water?	水を１杯持ってきましょうか。
All life is a series of activities.	人生は全て活動の連続である。
It is bad manners to point at people.	人を指差すのは無作法だ。
One should keep one's promise.	人は自分の約束を守らなければならない。
A new dress was bought for her.	新しいドレスが彼女に買い与えられた。
Three pieces, including a small one.	小さいのを入れて３個です。
Masaru doesn't care for this color.	勝君はこの色が好きではない。
An important post was given Tom.	重要な地位がトムに与えられました。
Don't forget to post the letter.	手紙を投函するのを忘れないように。
Please tell us what to do next.	次に何をしたらいいか教えてください。
Please come to my room to help me.	私を手伝いに部屋に来て下さい。
I saw her crossing the street.	私は彼女が道路を横断しているのを見た。
I regarded him as a good teacher.	私は彼をよい先生だと考えていた。
I am happiest when I am reading.	私は読書しているときが一番幸福だ。
I was just going to write a letter.	私は丁度手紙を書こうとした。
I got my son to post the letters.	私は息子にその手紙を投函させた。
I'm saving up to buy a new car.	私は新車を買うために貯金をしている。
I have enough money to buy a car.	私は車を買えるだけのお金がある。
I will work to the best of my ability.	私は思いきり働きたい。
I am pleased with your present.	私は君のプレゼントが気に入っている。
I have already written a letter.	私はもう手紙を書いてしまいました。
I wonder where I put my glasses.	私はどこにメガネを置いたのだろう。
I hope you'll get over your cold soon.	風邪早く治るといいね。
My father goes to church on Sunday.	私の父は日曜日に教会へ行く。
My brother can run as fast as I.	私の弟は私と同じくらい速く走れる。
My brother takes care of our dog.	私の弟が私たちの犬の世話をする。
There is something wrong with my car.	私の車はどこかおかしい。
My watch gains five seconds a day.	私の時計は１日に５秒進みます。
My home lies far across the sea.	私の故郷は海のはるか向こうにある。
It seems to me that he likes music.	私には彼が音楽好きに思える。
I have eight brothers and sisters.	私には８人の兄弟姉妹がいます。
We were poor, but we were happy.	私たちは貧乏でしたが、幸せでした。
I have a black and a white dog.	私たちは黒い犬と白い犬を飼っている。
We enjoyed listening to the music.	私たちは音楽を聴いて楽しんだ。
We were surprised at the sound.	私たちはその物事をきいて驚きました。
I'm still waiting for my order.	私が頼んだものがまだ届いていません。
There are many doubts to a child.	子供には疑問がたくさんあります。
My sister showed me a new watch.	姉が僕に新しい時計を見せてくれた。
Mr Yamada, you are wanted on the phone.	山田さんお電話です。
She dreamed a happy dream last night.	昨夜彼女はよい夢をみた。
Kiss the fifth man from the left.	左から５人目の男にキスしなさい。
It is colder this year than last year.	今年は去年よりも寒い。
Are you pleased with your new job?	今度の仕事は気に入っています。
He got up an hour early this morning.	今朝は１時間早く起きた。
Happy is the man who is contented.	幸せなるかな。心満ちてる者は。
Open your mouth and close your eyes.	口を開けて目を閉じなさい。
Open the door and let in the dog.	戸を開けて犬を入れてやりなさい。
Language is a means of communication.	言葉は伝達の手段である。
Please show me the meaning of word.	言葉の意味を教えてください。
Language is a means of communication.	言語は伝達の手段である。
You must not get away from reality.	現実から逃げてはいけないよ。
A dog can run faster than a man can.	犬は人間よりも速く走れる。
I saw a dog crossing the street.	犬が通りを横切っているのが見えた。
What do your words add up to?	結局お言葉はどういう意味になるのですか。
The police will go into the case.	警察はその事件を調査するだろう。
How long have you been dating?	君達はいつからつきあっているのですか。
Did you buy it on the black market?	君はそれをヤミで買ったのか。
You should make use of this chance.	君はこの機会を利用すべきだ。
You are always doubting my word.	君はいつも私の言う事を疑っている。
Your conduct is beyond bearing.	君の行為にはまったくがまんできない。
Mr Hashimoto is known to everyone.	橋本さんは皆に知られています。
Kyoto was an old capital of Japan.	京都はかつて日本の首都でした。
I'll be happy to answer your question.	喜んで質問に答えます。
I'm cold. May I close the window?	寒いので窓を閉めてもいいですか。
The streets are laid out quite well.	街路はよく設計されている。
You may bring anyone you want.	会いたい人は誰でも連れてきてよろしい。
We passed through a town at night.	我々は夜一つの町を通り抜けた。
We left the final decision to him.	我々は最終決定を彼にまかせた。
We should always keep our promise.	我々はいつも約束を守るべきだ。
A fire broke out on the fifth floor.	火事は５階から起きました。
Above all, be true to yourself.	何よりもまず自分に忠実でありなさい。
I want something with which to write.	何か書くものが欲しいな。
Ask him if you have any doubt.	何か疑問があったら彼にお尋ねください。
What on earth are you doing here?	一体全体ここで何をしているんだ？
Can I take your picture with us?	一緒に写真に入っていただけますか。
I study about two hours every day.	私は毎日およそ二時間勉強する。
I will write Judy a letter.	わたしはジュディさんに手紙を書くつもりなの。
Did you enjoy yourself last evening?	ゆうべは楽しかったですか。
I had hoped to save more money.	もっとお金を貯めたかったのだけれど。
I don't feel like waiting any longer.	もう待つ気が無くなった。
Give me another chance to try.	もう１度やるチャンスを与えてください。
There's enough food to go round.	みんなに行き渡るだけの食料がある。
I felt as if I were dreaming.	まるで夢を見ているかのような気分だった。
Mayuko avoided doing hard work.	マユコはつらい仕事をするのをさけた。
A friend in need is a friend indeed.	まさかの時の友こそ真の友。
Did you enjoy yourself at the party?	パーティーは楽しかったの？
I just can't wait for the party.	パーティーが待ち遠しくて仕方ない。
Some people are difficult to please.	なかには気難しい人がいる。
Totoro makes friends with everyone.	トトロはみんなと友達になる。
I wonder which way is the shortest.	どちらの道が一番近いかしら。
I want to speak to Mr Sato please.	どうぞ佐藤さんをおよび下さい。
Will you step this way, please?	どうぞ、こちらの方へおこしください。
Please let me make it up to you.	どうか埋め合わせをさせてください。
Please come as soon as possible.	どうかできるだけ早く来てください。
We start here in two hours, then.	では２時間後にここを出発しよう。
At last, Mayuko achieved her goal.	ついにマユコは目的を達成した。
Can you buy one for me as well?	ついでに私のも買ってきてくれますか。
Let me have a look at the picture.	ちょっとその絵を見せて下さい。
Please don't look at me like that.	そんなに見つめないでください。
All you have to do is write it down.	それを書き取るだけでよい。
Some of them are really fine.	それらのいくつかは本当に素敵なものです。
It is on the left side of the street.	それは通りの左側にある。
That doesn't regard you at all.	それはまったく君に関係のないことだ。
That leaves no room for doubt.	それで疑いをさしはさむ余地はなくなる。
Please think about the problem.	その問題について考えてみてください。
That dress becomes her very well.	その服は彼女にとても良く似合う。
The sign indicates the way to go.	その標識は進む方向を示している。
This plant grew little by little.	その植物は少しずつ大きくなった。
The small dog tried to get away.	その小さな犬は逃げようとしました。
He has the ability to do the work.	彼はその仕事をする能力がある。
The dog answers to the name John.	その犬はジョンというなまえです。
The rule holds good in this case.	その規則はこの場合に当てはまる。
That patient may die at any time.	その患者はいつ死ぬかわからない。
Therefore many people passed away.	そのため大勢の人が亡くなった。
We must contact the police at once.	すぐに警察に連絡しなくちゃ。
Susan enjoys listening to music.	スーザンは毎晩音楽を聴いて楽しむ。
Judy sent her children to bed.	ジュディーは子供たちを寝室へ行かせた。
Please hold the line a moment.	しばらく電話を切らずにお待ちください。
But the answers were all wrong.	しかしその答えはすべて間違っていた。
Jane took her dog for a walk.	ジェーンは彼女の犬を散歩に連れて行った。
Jane sometimes runs to school.	ジェーンはときどき学校まで走っていく。
Now, I'll take your temperature.	さあ、あなたの体温を計りましょう。
There is nothing wrong with this.	これは別に間違ったことではない。
This book is a little out of date.	この本はちょっと時代おくれだ。
Make yourself at home in this room.	この部屋でくつろいで下さい。
There is an old church in this town.	この町には古い教会がある。
This large type is easy on the eyes.	この大きな活字は眼に楽だ。
What is the cause of my condition?	この健康状態、原因は何なんだ？
This rule applies to any case.	この規則はどんな場合にでも当てはまる。
This rule applies to all cases.	この規則はすべてのケースに適応する。
This rule applies to all cases.	この規則はあらゆる場合に当てはまる。
Could you send it to this address?	この宛先に送ってもらえますか？
You look better in this dress.	このドレスを着たほうがすてきに見える。
This dress comes in three sizes.	このドレスには３つのサイズがある。
Does anyone here speak Japanese?	ここに日本語を話せる人はいますか。
Stay here and wait for him, please.	ここにいて彼を待って下さい。
I'm surprised to see you here.	ここであなたにお会いして驚いています。
Best regards to your father.	お父さんにくれぐれもよろしくお伝え下さい。
I can't buy it for lack for money.	お金がないのでそれが買えない。
Can you wait until I make up my face?	お化粧するまで待ってて。
I think it's wrong to tell a lie.	うそをつくのは悪いことだと思う。
Please come to our town some day.	いつか私たちの町へいらっしゃい。
You are wrong in some respects.	いくつかの点では君がまちがっている。
That is the main street of this city.	あれがこの町の大通りだ。
There was a strong wind that day.	あの日は強い風が吹いていました。
You must take care of the dog.	あなたは犬の世話をしなければならない。
You should apply for that post.	あなたはあの勤め口に申し込むべきだ。
May all your dreams come true!	あなたの夢がみんな実現されますように。
Your sister can not speak English.	あなたの妹は英語が話せません。
Please allow me to measure you.	あなたの寸法を計るのを許して下さい。
I enjoyed your company very much.	あなたと一緒でとても楽しかった。
I'd like to join your group.	あなたがたのグループにはいりたいんですが。
We covered three states in two days.	２日で３つの州を走破した。
Please wait in front of Room 213.	２１３号室の前でお待ちください。
Carry on working while I am away.	私がいない間も作業を続けなさい。
The focus is centered on the Edo period.	江戸時代を中心とする
Everyone had something in their hands.	それぞれが手に物を持った
Sometimes stories from the past come up.	たまに昔の話しが出る
This can not be seen with human eye.	これは人間の眼には見えません
That will determine policy direction.	それが施策の方向を定めます
It will further improve my ability.	それがさらに自分の能力を高める
Everyone let out a surprised sound. 	誰もが思わず驚きの声をあげる
He suddenly stopped what he was doing.	彼がふと作業の手を止めた
That's why it's very easy to carry.	そのため、持ち運びに大変便利だ
The site will open on the 20th!	いよいよサイトが２０日にオープンします
He almost reached this year's goal.	彼がほぼ本年度の目標を達成した
I was moved by how beautiful it was.	あまりの美しさに感動しました
This house and this land are mine!	この土地とこの家は私の物ですよ。
It's not as if he can't run fast.	彼は走るのが速くないわけではない。
Everyone, please keep to netiquette.	皆さんネチケットはしっかり。
We must have a new supply of forms.	用紙を補充しなければならない。
The post office is down the street.	郵便局は通りに沿ってあります。
John, a friend of mine, told me so.	友達のジョンが私にそう言った。
Always come by the time promised.	約束の時間までに必ずきてください。
When did your daughter come of age?	娘さんはいつ成人されましたか。
I'll bring my sister to the party.	妹をパーティーに連れて行きます。
My sister saw it with her own eyes.	妹はそれを自分自身の目で見た。
I asked her to send us the book.	本を送ってくれるように彼女に言った。
It is not always cold in Hokkaido.	北海道がいつも寒いわけではない。
Don't forget to post this letter.	忘れないでこの手紙を投稿しなさい。
My mother bought me a new dress.	母は私に新しいドレスを買ってくれた。
I am worried about my mother's health.	母の体のことが心配です。
Would you please show me another one?	別のを見せてくれませんか。
Would you bring me another one, please?	別のをいただけますか。
Please don't run about the room.	部屋の中を走り回らないでちょうだい。
My husband is in high spirits today.	夫は今日はとても機嫌がいい。
My husband is always reading in bed.	夫はいつもベッドで本を読む。
Please hand in the necessary papers.	必要書類を提出してください。
She is particular about what she wears.	彼女は服装にうるさい。
She calls her sister Mina-chan.	彼女は彼女の妹を美奈ちゃんと呼びます。
She kept him waiting for a long time.	彼女は彼を長い間待たせた。
She had a happy time with them.	彼女は彼らと楽しいひとときを過ごした。
She got her brother to walk the dog.	彼女は弟に犬の散歩をさせた。
She talks a very fast game.	彼女は早口でまくしたてて、人をまるめこみます。
She was pleased with her new dress.	彼女は新しい服に満足していた。
She applied her mind to her new job.	彼女は新しい仕事に専念した。
She kept me waiting for half an hour.	彼女は私を３０分待たせた。
She is wearing a white dress today.	彼女は今日は白い服を着ている。
She said that she had been happy.	彼女は幸福だったと言っていました。
She is studying fine art at school.	彼女は学校で美術を学んでいる。
She likes to talk in our presence.	彼女は我々の前で話すのが好きだ。
She dressed up for the party.	彼女はパーティーに出かけるために盛装した。
She is getting better by degrees.	彼女はだんだん良くなってきている。
She is getting well by degrees.	彼女はだんだん体調がよくなっています。
She pressed the child to her heart.	彼女はその子を胸に抱きしめた。
I don't doubt that she will come here.	彼女はきっとここに来る。
Her hair came down to her shoulders.	彼女の髪は肩まで届いていた。
I was writing her a love letter.	彼女にラブレターを書いていたんだよ。
Shall I send a few books for her?	彼女に２、３の本を送りましょうか。
They go to church on Sunday morning.	彼らは日曜日の朝教会へ行く。
They were not listening to music.	彼らは音楽を聞いていませんでした。
They moved here three years ago.	彼らは３年前に当地に引っ越してきた。
He is poor, but he is in high spirits.	彼は貧しいが元気は良い。
He will make her a good husband.	彼は彼女にとってよい夫となるだろう。
He avoided meeting her on the way.	彼は途中で彼女に会うのを避けた。
He was kept waiting for a long time.	彼は長いこと待たされました。
He immediately sought a response.	彼は即座に答えることを求められた。
I wonder when he will come next time.	彼は今度いつ来るのだろう。
He has been looked for by the police.	彼は警察によって探される。
He reflected on what answer to make.	彼は何を答えてよいか考えた。
He does not have anyone to play with.	彼は一緒に遊ぶ人がいない。
He lived in the center of London.	彼はロンドンの中心部に住んでいた。
He is not what he was ten years ago.	彼はもう十年前の彼ではない。
He did it, and in her presence.	彼はそれをした、しかも彼女のいる前で。
He applied for the job and got it.	彼はその仕事に志願し採用された。
He is what we call the man of the hour.	彼はいわゆる時の人だ。
He left for New York a week ago.	彼は１週間前にニューヨークへ発った。
I passed up an opportunity to see him.	彼に会う機会を見送った。
He couldn't tell green from blue.	彼には緑と青の区別がつかなかった。
He has a brother and two sisters.	彼には兄弟が一人と姉妹が二人いる。
It is difficult to gain access to him.	彼にはなかなか会えない。
You must not come in contact with him.	彼と接触してはいけない。
Be waiting here until he comes.	彼が来るまでここで待っていてください。
I know him for a man of ability.	彼が有能な人であることは知っている。
Let's wait here until he turns up.	彼が姿を見せるまでここで待とう。
I was surprised to see him there.	彼がそこにいるのを見て私は驚いた。
Please tell me when he'll be back.	彼がいつ戻るのか教えてください。
He will be here in half an hour.	半時間したら彼はここに来るでしょう。
Our brains control our activities.	脳が私たちの活動を支配している。
I just ran into her on the street.	道でばったり彼女に会いましてね。
Mr Tanaka, you are wanted on the phone.	田中さん、電話ですよ。
Come on in and make yourself at home.	適当に入って勝手にやって。
Trees are planted along the street.	通り沿いに木が植えられている。
There is a church across the street.	通りの向こう側に教会がある。
No one was to be seen in the street.	通りには誰一人見えなかった。
We see a lot of cars on the street.	通りにはたくさんの車が見える。
Write to me as soon as you get there.	着いたらすぐ手紙を下さい。
All the people on earth are brothers.	地上のすべての人は同胞だ。
Please send someone to my room.	誰かすぐに部屋に来てもらってください。
Everything comes to him who waits.	待つ人にはすべての物が手に入る。
They charged me for the broken window.	窓の破損料を請求された。
The ship cut her way through the waves.	船は波を切って進んだ。
Please remember me to your teacher.	先生によろしくお伝えください。
I used to go to church on Sunday.	昔、日曜日には教会へ行ったものだ。
You don't have to buy water, do you?	水を買う必要がないですよね。
One of the boys suddenly ran away.	少年たちの１人が急に逃げ出した。
You seem to have gained some weight.	少し体重が増えたようですね。
Please include lots of small change.	小銭を多めに入れてください。
Please take more care in the future.	将来はもう少し注意しなさい。
To tell the truth, she is my sister.	実を言えば、彼女は私の妹だ。
Please move your car out of here.	自動車をここから動かしてください。
I make it a rule to get up at six.	私は六時に起きることにしている。
I don't see eye to eye with my father.	私は父と意見が合わない。
I am ready to give up my position.	私は地位を捨てる覚悟をしている。
I was charged with an important task.	私は大切な仕事を任された。
I viewed the picture at a distance.	私は少し離れてその絵を眺めた。
I am interested in taking pictures.	私は写真を撮る事に興味がある。
I can prove that I am right.	私は自分が正しいことを証明することができる。
I would like to try this dress on.	私は試しにこの服を着てみたいわ。
I may write a letter for you.	私は君の代わりに手紙を書いてもいいですよ。
I stayed at home instead of going out.	私は外出せずに家にいた。
I looked round the inside of the house.	私は家の中を見回した。
I like English better than music.	私は音楽よりも英語の方が好きです。
I study English an hour every day.	私は英語を毎日１時間勉強します。
I flew from London to New York.	私はロンドンからニューヨークへ飛んだ。
I often think of my dead mother.	私はよく死んだ母親のことを思い出す。
I've had only a couple of drinks.	私はほんの２、３杯飲んだだけです。
I read the book from cover to cover.	私はその本全編残らず読んだ。
I will be able to pass the test.	私はそのテストに合格できるでしょう。
I don't mind waiting for a while.	私はしばらくの間待つのは構わない。
I bought this dress at a low price.	私はこの服を安い値段で買った。
I'm going to carry out this plan.	私はこの計画を実施するつもりです。
I'm going to carry out this plan.	私はこの計画を実行するつもりです。
I almost forgot all about that.	私はうっかりそれを忘れるところだった。
I make it a rule to get up at six.	私は６時に起きることにしている。
I lived in Sasayama two years ago.	私は２年前篠山に住んでいました。
I'm not a hundred percent wrong.	私は１００パーセント間違っていない。
A friend of mine came to see me.	私の友人の１人が私に会いにきました。