I know a little Spanish.	スペイン語を少し知っている。
Will I make it through?	こんな自分から抜け出せるのか。
This is what I wanted.	これは私が欲しいと思った物です。
I would like to go with you.	お伴したいものです。
When did you get to Kyoto?	いつ京都に着きましたか。
When did you go to Rome?	いつローマに行ったんですか。
You needn't have come.	あなたは来る必要はなかったのに。
Who do you think he is?	あなたは彼が誰だと思いますか。
Where were you going?	あなたはどこに行くところでしたか。
I will do as you say.	おっしゃるとおりにいたしましょう。
I'd like for you to go.	あなたに会ってほしいのですが。
Tony said, "I like it."	「好きです」とトニーは言った。
He makes the best use of X.	彼がXを最大限に利用する
My thinking did a 180.	１８０度自分の考え方が変わりました
Can we say "No" to America?	米国にノウと言えるのか？
No, no! That's not right.	どっこい。そうはいかないよ。
She wanted me to come.	彼女は私に来てもらいたがっていた。
She's at work, isn't she?	彼女は仕事に行っていますね。
All of them were gone.	彼らはみんないなくなってしまった。
He is used to traveling.	彼は旅をする事に慣れています。
He is not what he used to be.	彼は昔の彼ではない。
He knows us very well.	彼は私たちをとてもよく知っている。
He will come back at four.	彼は四時にもどるでしょう。
Need he go right now?	彼は今すぐ行かなければなりませんか。
Did he go to see Mary?	彼はメアリーに会いにいきましたか。
He has made me what I am.	彼が今日の私を育ててくれた。
Did you see him go out?	彼が外へ出て行くのを見ましたか。
Do you know how to get there?	道順はご存知ですか。
Mr Tanabe is out now.	田辺先生はただいま外出しております。
Naoko came back to Japan.	直子さんは日本に戻ってきた。
Come on, it'll be all right.	大丈夫、心配しないで。
Where are all the others?	他の人はどこにいるのですか。
Just like you want it to.	世の中を動かしてみたいんだ。
Take your time over it.	時間をかけてゆっくりやりなさい。
I do not know any of them.	私は彼らを一人も知らない。
I want him to go there.	私は彼にそこへ行ってもらいたい。
I saw that he was right.	私は彼が正しいことが分かった。
I came to Japan from China.	私は中国から日本にきた。
I've got time on my hands.	私は時間を持て余している。
I have seen her before.	私は以前彼女に会ったことがある。
I am going to do it.	私はそれをしようとしているところです。
All is well with me.	私に関しては、すべてうまく行っている。
Will you make up with me?	私と仲直りしてくれませんか。
Are you through with your work?	仕事は終わった?
She will be there by now.	今頃彼女はそこにいるだろう。
Can you do it in one day?	君は１日でそれができますか。
How can you say that?	君にそんなことを言う資格があるのか。
What is it that you want?	君が欲しいのはいったい何だ。
What did you go there for?	何故そこへ行ったのですか。
Well, I have to be going.	もうそろそろ失礼しなくては。
Where would you like to go?	どちらへ行きたいですか。
He may well be right.	たぶん彼の言うことはただしいだろう。
I think it's the best way.	それは最高の方法だと思う。
How did it come about?	それはどのようにして起こったのか。
I think it's the best way.	それが最善の方法だと思う。
I was there all the time.	その間ずっと私はそこにいた。
Will you take me there?	そこへ連れていってくれませんか。
How can I get there?	そこへはどうやって行けばいいのですか。
You should go back right now.	すぐに戻るべきだよ。
Jim has gone to London.	ジムはロンドンへ行ってしまった。
I would like to go with you.	ご一緒したいものです。
This is how I made it.	こんなふうにして私はそれを作った。
Is this made in Switzerland?	これはスイス製ですか。
This work is made for him.	この仕事は彼に向いている。
You should go to see him.	きみは彼に会いに行くべきだ。
How would you like them?	お金の種類はどういたしますか。
No, I don't have it with me.	いや、今は持ってない。
When did you come to Paris?	いつパリに来たのですか。
Come on any day you like.	いつでも好きな日に来なさい。
You may use it any time.	いつでもそれを使ってください。
How should I know?	いったいどうして私にわかると言うのですか。
You'd better not go out.	あなたは出かけないほうがよい。
A is 5 times as long as B.	ＡはＢの５倍の長さがある。
That's what I want to say.	それはこっちのセリフですよ。
I'll take back what I said.	僕が言ったことを取り消す。
She's getting on all right.	彼女は元気にやっています。
She has gone to America.	彼女はアメリカに行ってしまった。
She came back before eight.	彼女は８時前に帰ってきた。
He had come back from China.	彼は中国から帰ってきた。
When did he get to Kyoto?	彼はいつ京都についたのですか。
He came back from America.	彼はアメリカから帰ってきた。
He is a little over forty.	彼は４０歳を少しすぎている。
He has made me what I am.	彼が私を現在の私にしてくれた。
He has made me what I am.	彼が私をいまの私にしてくれた。
I saw him come this way.	彼がこっちへ来るのが見えました。
I saw him come this way.	彼がこっちに来るのが見えました。
Who do you think you are?	自分が何さまだと思ってるんだ？
You won't get there on time.	時間通りには着けないよ。
We work from nine to five.	私達は９時から５時まで働く。
I think he has done it.	私は彼がそれをしてしまったと思う。
I don't know any French.	私はフランス語を少しも知らない。
I don't know any French.	私はフランス語は少しも知らない。
I want to be a Picasso.	私はピカソのようなヒトになりたい。
I've only just come back.	私はたった今帰ったばかりです。
I like that about you.	私はあなたのそんなところが好きです。
All of us know him well.	私たちは皆彼をよく知っています。
He has made me what I am.	私が今日あるのは彼のおかげだ。
I'm seeing her this evening.	今晩私は彼女に会います。
Where have you been up to now?	今までどこにいたの。
Korea is now up and coming.	韓国は今や活気づいている。
Do you know what day it is?	何時だったか知ってるかい。
I don't know what to say.	何を言ったら良いかわからない。
I don't know what to say.	何を言えばよいのか分からない。
What are you working for?	何のために働いているのですか。
What did you go there for?	何のためにそこへいったのか。
Hmmm, how shall I say this?	何て言ったらいいのかなあ。
You like English, don't you?	英語は好きなのでしょう。
I would like to go with you.	一緒に行きたいのですが。
It's about time you got up.	もう起きてもいいころだよ。
Mike said that he would come.	マイクは来ると言った。
Tom wants to go to Japan.	トムは日本に行きたがっている。
Which way shall we go now?	どっちの方に行くとよいかな。
I do want to go to Italy.	どうしてもイタリアへ行きたい。
How did it all come about?	それは一体どうして起きたの。
What was he up to then?	その時彼は何をたくらんでいたのか。
What's going on down there?	したで何が起こっているの？
That is all that he said.	これが彼が言ったことの全てだ。
You are only just in time.	かろうじて間に合いましたね。
You did it all right.	お前は、やるべき事はちゃんとやったよ。
I'll be with you right now.	いますぐそちらに参ります。
When are you going to say, I do?	いつ結婚するの？
What are you going to do?	あなたは何をするつもりですか。
What would you like to do?	あなたは何をしたいのですか。
What are you going to be?	あなたは何になるつもりですか。
It is time that you got up.	あなたはもう起きる時間だ。
Did you see her there?	あなたはそこで彼女に会ったのですか。
He saw X for the first time.	彼がXを初めて目にしました
He saw that for the first time.	彼が初めてそれを見た
I think I have tendonitis.	腱鞘炎ではないかと思うのです。
She is not less than thirty.	彼女は少なくとも３０歳だ。
She was about to go out.	彼女はまさに外出しようとしていた。
She likes it least of all.	彼女はそれがもっともきらいだ。
What man has done, man can do.	彼も人なり我も人なり。
I don't think that he will come.	彼は来ないと思う。
What do you think he is?	彼は何をしている人だと思いますか。
He had been there before.	彼は以前そこに行った事があった。
He is not what he used to be.	彼はもう昔の彼ではない。
He will be back before long.	彼はまもなく帰るでしょう。
He got in for Chester.	彼はチェスター区選出の議員に当選した。
He has gone to Switzerland.	彼はスイスへ行ってしまった。
He wants to go to Africa.	彼はアフリカに行きたがっている。
Do you know what he said?	彼が何を言ったか知っていますか。
What do you think of Japan?	日本についてどう思いますか。
That will not make even carfare.	足代にもならない。
I wanted him to go there.	私は彼にそこへ行ってほしかった。
I have known him a long time.	私は彼と知り合って長い。
I don't think I want to go.	私は行きたいとは思いません。
I'd like you to go there.	私は君にそこに行ってもらいたい。
I am going to be fourteen.	私はもうすぐ１４歳になります。
I am going to be fourteen.	私はもうじき１４歳になります。
I do want to go with you.	私はぜひあなたと一緒に行きたい。
I've been in Sapporo before.	私はこの一年間札幌にいる。
What do you want me to do?	私に何をしてほしいって言うの？
He came when I was out.	私が外出していたとき彼がやってきた。
Are you through with your work?	仕事を終えましたか。
I should think you are right.	君は正しいと思いますが。
Were you to take it back?	君はそれを取り返すはずでしたか。
You'd better not go there.	君はそこへいかないほうがよい。
When did you come to Japan?	君はいつ日本に来たのですか。
You have no right to say so.	君にはそういう権利が無い。
I will get even with you some day.	覚えていろよ。
You may come if you like.	よろしかったら来てもいいですよ。
I'm working for McDonald's.	マクドナルドで働いてるんだ。
How do you do, Mrs. Jones?	はじめまして、ジョーンズ夫人。
What made you think so?	どうしてあなたはそう考えたのですか。
You may as well get used to it.	でも慣れた方がいい。
But you like it!	でも、そういうキミはそれを気に入っているのだろう。
Give me a hand, will you?	ちょっと手を貸してくれませんか。
No one man could do it.	だれでも一人でそれはできないだろう。
I should say he won't come.	たぶん、彼は来ないでしょう。
There is no one but knows it.	それを知らない人はない。
I like this better than that.	それよりもこれが好きだ。
It came about in this way.	それはこのようにして起こった。
You'll get used to it in no time.	すぐに慣れるわ。
That's just what I wanted.	これこそ求めていたものですよ。
This is just between you and me.	ここだけの話だよ。
I will make a man of you.	おまえを一人前の男にしてやろう。
Come at any time you like.	いつでも好きなときに来なさい。
When shall I come for you?	いつお迎えにまいりましょうか。
I don't know who that man is.	あの人が誰か分からない。
I don't know who the man is.	あの人が誰か私は知らない。
You like English, don't you?	あなたは英語が好きですね。
I have to be there by 7:00.	７時までに着きたいんだけど。
How about $100 for three?	３個で１００ドルならどうですか。
What do you think about it?	それについてどう思いますか。
It can be used for a long time.	利用期間が長期間に渡る
I got what she was saying.	僕には彼女の言うことが分かった。
That's not what you said before.	話が違うじゃないか。
Make the best of your time.	余暇をできるだけ利用しなさい。
She is used to traveling.	彼女は旅行することに慣れています。
What do you think she said?	彼女は何と言ったと思いますか。
She has known better days.	彼女は羽振りのよいときもあった。
She has gone to Paris.	彼女はパリに行っていて、ここにはいない。
She comes from California.	彼女はカリフォルニアの出身です。
She is making use of you.	彼女はあなたを利用しているのです。
Do you know where she is?	彼女がどこにいるか知っていますか。
They have gone to Europe.	彼らはヨーロッパに行ってしまった。
They have seen better days.	彼らにだってよい時代もあった。
I thought he wouldn't come.	彼は来るまいとわたしは思った。
He is a Chopin for our times.	彼は現代のショパンである。
He's been working all day long.	彼は１日中働いている。
I couldn't get him to do it.	彼にそれをさせられなかった。
He is the very man I want.	彼こそ私が必要としている人物だ。
I will go when he comes back.	彼が戻ってきたら行きます。
What do you think of Japanese?	日本語をどう思いますか。
Saturday comes before Sunday.	土曜日は日曜日の前に来る。
Who do you think goes there?	誰がそこに行くと思いますか。
He is not what he used to be.	昔はあんな人ではなかった。
Where there's a will, there's a way.	成せば成る。
What do you have in your hand?	手に何をもっていますか。
Our work is all over now.	私達の仕事はもうすっかり終わった。
I don't like what he said.	私は彼が言った事が気に食わない。
I have seen a UFO before.	私は以前ユーフォーを見た事がある。
I like the works of Picasso.	私はピカソの作品が好きです。
I do not know how to use it.	私はその使い方を知りません。
I would like to go to America.	私はアメリカに行きたい。
What I want to say is this.	私の言いたいことはこのことだ。
I don't see what he says.	私には、彼のいうことがわからない。
I'll get there before you will.	私が先にそこへ着くよ。
It was Jane who came first.	最初に来たのはジェインだった。
Do I have to go right now?	今すぐいかなければなりませんか。
Kaoru has gone to America.	薫さんはアメリカに行っています。
Where are you from in Canada?	君はカナダのどこ出身なの？
I didn't know what to say.	何と言っていいかわからなかった。
I'm working in Tokyo now.	わたし今、東京で仕事をしているの。
"I don't know", said Tony.	わからないよ。とトニーは言った。
What time is it in London now?	ロンドンは今何時ですか。
When did you get to London?	ロンドンにはいつ着きましたか。
Hadn't we better be going now?	もう帰ることにしようか。
At first, I didn't like him.	はじめは彼が好きでなかった。
Well, you may be right.	なるほど、君の言うとおりかもしれない。
What did you go to Kyoto for?	なぜ京都へ行ったのですか。
I don't know where to go.	どこへ行ったらよいのかわからない。
That is to say, on May 10th.	つまり、５月１０日のことだ。
It was just as I thought.	それはまったく私が考えたとおりだ。
That was the time when he came.	それが彼がきた時間だ。
I'll be there at five p.m.	そちらには午後五時に到着します。
And so the man came in.	そして、そこでその男は入ってきました。
You had better not go there.	そこへは行かないほうがよい。
"That's right", said John.	そうだね。とジョンが言いました。
How did you like Singapore?	シンガポールはいかがでしたか。
I'd like to take this with me.	これは持っていたいのだ。
This is all I need to know.	これさえ分かっていればいいよ。
When will we get to Sydney?	いつシドニーに着いたのだろう。
He is sixty, if a day.	あの人は少なくとも60歳にはなっている。
I will make a man of you.	あなたを一人前の男にしてあげよう。
You don't have to go there.	あなたはそこへ行く必要はない。
When did you come to Japan?	あなたはいつ日本に来ましたか。
You are right in a way.	あなたの言うことはある意味では正しい。
I've been working all day.	１日中ずっと仕事をしていたから。
He wants to go to America.	彼はアメリカに行きたがっている。
He hasn't gotten to work on X.	彼がXにまだ手を付けてない
The way I see it, he is right.	僕の見るところ彼は正しい。
I don't think that she will come.	彼女は来ないと思う。
She is not what she used to be.	彼女は昔の彼女ではない。
She took me for Mr Tamori.	彼女は私をタモリさんとまちがえた。
She knows what to do now.	彼女は今何をすべきかよく知っている。
She can't be over thirty.	彼女は３０歳を超えているはずはない。
Do you know what she said?	彼女が何と言ったか知っていますか。
Do you know where she is?	彼女がどこにいるのか知っていますか。
How can they do this?	彼らはどうしてこんな事ができるのでしょうか。
They have the right to do so.	彼らにはそうする権利がある。
There is no need for him to work.	彼は働く必要はない。
He is not what he used to be.	彼は昔あんな人ではなかった。
He is not what he used to be.	彼は今やかつての彼ではない。
When did he go to Europe?	彼はいつヨーロッパに行ったのですか。
All what he said was right.	彼の言ったことは全て正しかった。
Did you make out what he said?	彼の言うことがわかったか。
There is no need for him to work.	彼が働く必要はない。
If only he had known!	彼が知ってくれさえすればよかったのだがなあ。
If only he had known!	彼が知っていてさえすればよかったのだがなあ。
I don't know what he is like.	彼がどんな人か私は知らない。
Where did you go to in Japan?	日本ではどこへ行きましたか。
What are you going to Tokyo for?	東京へなにしに行くの。
Do you know who goes there?	誰がそこに行くか知っていますか。
Will you make it to take out?	持ち帰りにしてもらえますか。
I can't make him out at all.	私は彼をまったく理解できない。
I don't like what he said.	私は彼の言ったことが気にくわない。
I thought he might come.	私は彼が来るかもしれないと思っていた。
I had to go to America.	私はアメリカに行かなければならなかった。
You may as well come with me.	私と来たほうがいいでしょう。
Hadn't we better go now?	私たちはもう行った方がよくないですか。
Our work is all over now.	私たちに仕事はもうすっかり終わった。
You will see that I am right.	私が正しいとわかるでしょう。
The work has just been done.	仕事はちょうど今終わりました。
Sawako wants to go to France.	佐和子はフランスに行きたい。
You've made me what I am.	今日私があるのはあなたのおかげです。
May I come and see you now?	今君に会いに行ってもいいですか。
You know it better than me.	君のほうが私よりよく知っている。
Do what you think is right.	君が正しいと思うことをしなさい。
I just don't know what to say.	何とも言いようがないなあ。
You can go if you want to.	もし行きたければ行ってもよろしい。
I need some get-up-and-go.	もうダメだ、もうくたくた、疲れた。
I would like to go to France.	フランスへ行きたいものです。
One of us will have to go.	どちらか一方が出て行くしかないな。
What makes you think so?	どうしてそのように考えられるのですか。
Dan came for Julie at six.	ダンは６時にジュリーを迎えに来た。
What do you think about it?	それについてはどうお考えですか。
That's what we want to know.	それが私達の知りたいことです。
I don't know where it is.	それがどこにあるのか私は知りません。
What were you doing then?	その時あなたは何をしていたのですか。
What is sukiyaki made of?	すき焼きはどんな材料を使うのですか。
Jane comes from Australia.	ジェーンはオーストラリアの出身だ。
Can't you go on any longer?	これ以上先に進んで行けないのか。
Where are you from, Karen?	カレンさんはご出身はどちらですか。
I have no time to see you.	お目にかかるのに時間はありません。
No, we have to go now.	いや駄目だ、今すぐに行かなくちゃ行けない。
What do you take me for?	あなたは私を何だと思っているのですか。
Had I better go with you?	あなたと一緒に行くほうがいいですか。
What is going on there now?	あそこで今何が起こっているんだ？
He said, "Come with us."	「私達と一緒に来なさい」と彼は言った。
For me, I like this better.	私といえば、こちらの方がすきだ。
I don't know if there is time.	時間があるか分かりません。
One is made up of three thirds.	１の中には１／３が３つ有る
What you see is what you want.	目に付くものが欲しいものだ。
I don't go by what he says.	僕は奴の言うことは信用しないんだ。
She took over the will of him.	彼女は彼の意志を引き継いだ。
She will be back before long.	彼女はほどなくもどるでしょう。
There is no need for her to work.	彼女が働く必要はない。
I took her for an American.	彼女がアメリカ人だとばかり思った。
It was she who made him do it.	彼は彼女にそれをさせられた。
He took me for an Englishman.	彼は私をイギリス人と間違えた。
He works from Monday to Friday.	彼は月曜から金曜まで働く。
He will have to go there.	彼はそこへ行かなければならないだろう。
When did he come over to see you?	彼はいつ会いに来たの。
He worked from nine to five.	彼は９時から５時まで働きました。
Do you know when he will come?	彼がいつ来るかご存知ですか。
Can you come on Sunday evening?	日曜日の晩に来られますか。
I'd like to see Mr Kosugi.	小杉さんにお目にかかりたいのですが。
We took him for an American.	私達は彼をアメリカ人だと思った。
I can make out what she said.	私は彼女のいうことを理解する。
I have to do right by him.	私は彼に義理を立てなければならない。
I know where he comes from.	私は彼がどこの出身か知っています。
I've been in Sapporo before.	私は前に札幌に住んでた事がある。
As for me, I don't want to go out.	私は出かけたくない。
I don't know what to do now.	私は今何をしたらよいか解らない。
I don't know what to do now.	私は今何してよいかがわからない。
I've been to Sapporo before.	私は以前に札幌に行った事がある。
What are you into these days?	最近はどんな物に凝っているの？
At this time I can't go back.	今となっては後戻りは出来ない。
You do not have to do it now.	今それをする必要はないんだよ。
What if he comes back now?	今、彼が戻って来たらどうなるだろう？
Don't go if you don't want to.	行きたくないのなら、行くな。
You have to come with me.	君は僕と一緒に行かなければならないよ。
What was it that you gave him?	一体何を彼にあげたのですか。
It's better than it was before.	以前と比べるとよくなった。
If you can, come with us.	もし来れたら、私たちと一緒に来なさい。
By the way, what do you do?	ところで、あなたの仕事は何ですか。
This is how it all came about.	それはこのようにして起きた。
Are you through with the work?	その仕事をもう終えましたか。
This may be of use to you.	これはあなたの役に立つかもしれない。
This is what we want to know.	これが私たちの知りたい事です。
How have you been getting on?	このところ調子はいかがですか。
This is just between you and me.	ここだけの話なんだけど。
We will go but you won't.	おれたちは行くのにおまえたちは行かぬ。
When did you come to Japan?	いつ日本にいらっしゃったんですか。
When are you going to Europe?	いつヨーロッパへ行くのですか。
You came when I was thirty.	アンタは私が三〇才のときの子だよ。
What are you thinking about?	あなたは何を考えているのですか。
It is time you should get up.	あなたはもう起きるべき時間だ。
What did you say to Paula?	あなたはポーラに何と言ったのですか。
Where did you see Nancy?	あなたはどこでナンシーを見かけましたか。
When do you come and see me?	あなたはいつ私に会いに来ますか。
You can have any you want.	あなたの好きなものは何でもあげます。
You may be right about that.	あなたの言う通りかもしれません。
We can see Mt. Fuji over there.	あちらに富士山が見えます。
What were you doing down there?	あそこで何をしていたのか。
You may as well give up.	あきらめた方が良いのではないでしょうか。
I don't know what I should do.	自分が何をやるべきかわからない
Where can Yoko have gone?	洋子は一体どこへ行ってしまったのだろう。
I've got no time for that now.	忙しくてそれどころじゃないよ。
It was not long before she came.	彼女はほどなくやってきた。
She's been working all day long.	彼女は、１日中働いている。
I don't know if she will come.	彼女が来るかどうかわからない。
Don't you like them any at all?	彼らを本当に嫌いなのですか。
They made us work all day.	彼らは私達に１日中その仕事をやらせた。
He has been in Hokkaido before.	彼は北海道にいたことがある。
He gave me what I needed.	彼は私に、私が必要としている物をくれた。
When did he say he would come?	彼は何時に来ると言いましたか。
He will be back in a day or two.	彼は一日か二日で帰ります。
He said, "I'm from Canada."	彼は「私はカナダ出身です」と言った。
I don't know when he will come.	彼がいつ来るか分かりません。
What do you like to do on Sundays?	日曜日は何をしますか。
She came to see me the other day.	先日、彼女が遊びにきた。
We'd better go back a little.	少し戻ってみたらいいんじゃない。
At first, I didn't like him.	初めは彼のことが好きではなかった。
Do you want me to give you a hand?	手伝ってほしいですか。
I've known her for a long time.	私は彼女とは長い付き合いだ。
I worked hand in hand with him.	私は彼と協力して仕事をした。
I don't think that he's right.	私は彼が正しいとは思いません。
I don't know what to do now.	私は今何をしてよいかがわからない。
I would like to go to America.	私はアメリカへ行きたいものだ。
I think you can get it.	私はあなたがそれを手に入れられると思います。
He didn't like her at first.	彼は彼女を最初は好きではなかった。
I'm coming to you just now.	今すぐ、あなたのところへ行きますよ。
You may come and go at will.	好きなように行き来していいですよ。
You'd better not see her now.	君は今彼女と会わない方がいいよ。
You shouldn't have done it.	君はそれをするべきではなかったのに。
I think your work is all right.	君の仕事は申し分ないと思う。
I'd like you to come at nine.	九時に来ていただきたいのですが。
I haven't seen him for a long time.	久しく彼に会わない。
I have been to London before.	ロンドンに以前行ったことがある。
I saw her just the other day.	ほんの２、３日前に彼女に会った。
If you do it at all, do it well.	どうせやるなら上手にやれ。
What are you going to do about it?	どうするつもりなんだ？
What were you doing then?	その時あなたたちは何をしていたのですか。
I don't know how to get there.	そこへ行く方法を私は知らない。
Are these all your belongings?	これはみんな身の回り品ですか。
This is what we want to know.	これが私達の知りたいことである。
This is just what I wanted.	これがまさに私の欲しかったものです。
This is just what I wanted.	こういうものが欲しいと思ってました。
How are you doing these days?	お変わりなくやっておられますか。
I know you can make it better.	お前ならもっとうまくやれるよ。
When did you come to know her?	いつ彼女と知り合ったのですか。
That is just what I wanted.	あれはちょうど僕が欲しかったものだ。
I have no time to go to America.	アメリカへ行く時間がない。
You have only to go there.	あなたはそこへ行きさえすればよいのだ。
Do you like San Francisco?	あなたはサンフランシスコが好きですか。
When do you go back to Japan?	あなたはいつ日本へ戻られますか。
Are you through with your work?	あなたの仕事を終えましたか。
I thought you were Japanese.	あなたが日本人だと私は思っていた。
I should not have said that.	言わずもがなのことを言ってしまった。
If I were you, I wouldn't do so.	僕だったら、そうはしないな。
I wouldn't do that if I were you.	僕が君ならそうはしないね。
They made us work all day long.	彼らは私たちを一日中働かした。
They made us work all day long.	彼らは私たちを１日中働かせた。
He wants to go out with her.	彼は彼女とデートしたいと思っている。
He did not know what to say.	彼は何と言ってよいかわからなかった。
He knows Mr. Davidson well.	彼はデービットソン氏をよく知っている。
It is said that he is in Britain.	彼はイギリスにいるそうだ。
He should have done it that way.	彼はああやれば良かったのに。
When would you like to see him?	彼にいつお会いになられますか。
I have long wanted to see you.	長い間君に会いたいと思っていた。
I'll have to go and see what I can do.	善処いたします。
Hand it over. That's all you've got?	出せ。他にないのか。
Come and see me from time to time.	時々遊びにいらっしゃい。
I don't know when he will come.	私は彼がいつ来るのか知らない。
I came to Japan for the first time.	私は初めて日本に来た。
I didn't know what to say.	私は何といってよいのか解りませんでした。
I want to go over to France.	私はフランスに渡りたいと思っている。
I don't know what to think.	私には、どう考えたってわかりませんわ。
As for me, I like this better.	私と言えば、こちらの方が好きだ。
You may as well come with me.	私と一緒にきたほうがよいでしょう。
Are you going out with Sachiko?	佐知子さんと付き合っているの？
Could you come over right now?	今すぐ来ていただけるでしょうか。
You had better do it right now.	今すぐそれをしたほうがいいよ。
How long have you been in Japan?	君はどれほど日本にいますか。
Miyazaki is not what it used to be.	宮崎は昔の姿とは違う。
What time will be right for you?	何時がご都合よいでしょうか。
Where there's a will, there's a way.	意志ある所に道あり。
This is the time you should get up.	もう起きる時間ですよ。
Where would you like to go first?	まずどこに行きたいですか。
This is Mike. Is Hiroshi there?	マイクですが、博君はいますか。
When did you see them first?	はじめて彼らに会ったのはいつですか。
How long will it take to get well?	どのくらいで治りますか。
Say which one you would like.	どちらが欲しいか言ってご覧なさい。
How do I get to Chinatown?	チャイナタウンにはどうやっていきますか。
What was it that you did there?	そこでいったい何をやったんだ。
I don't think we should do that.	そうするべきではないと思う。
I want to be with him all the way.	ずっと彼と一緒にいたい。
I like this. I'll take it.	これが気に入りました。これをもらいます。
This is just what I wanted.	これがちょうど私が欲しかったものです。
This would be better than that.	この方がまだしもあれよりよい。
How do you make Mirano?	このミラノという料理はどういう料理方法ですか。
Christmas Day is December 25th.	クリスマスは１２月２５日です。
Don't go down before such a man.	あんな男にまけてはいけない。
You should have come with us.	あなたも一緒に来ればよかったのに。
What do you have in your hand?	あなたは手に何を持っていますか。
You shouldn't say it.	あなたはそのことを言わないままにしておく方がよい。
You have no right to go there.	あなたにはそこに行く権利がない。
I don't know what to do now.	あたしは今何をしてよいかわからない。
I don't know if I'll have time.	時間があるかどうか分からない。
She will be in Paris by now.	彼女は今頃もうパリに着いているだろう。
She came from Canada to see me.	彼女はカナダから私に会いに来た。
Do you know when she will come?	彼女がいつ来るか知っていますか。
Shall I have him go with you?	彼をあなたと一緒に行かせましょうか。
You'd better do what they say.	彼らの言うとおりにしたほうがいい。
It was not long before he got well.	彼は間もなくよくなった。
He came back by way of Honolulu.	彼はホノルル経由で帰ってきた。
He did not know what to say.	彼はなんと言ってよいかわからなかった。
He thinks he is an Edison.	彼はエジソンのような発明家だと思っている。
He will be back in a day or two.	彼は１日か２日で帰ってきます。
You have made him what he is.	彼の今日あるのはあなたのおかげです。
How long have you known him?	彼と知り合ってどのくらいになりますか。
Is this your first time in Japan?	日本に来たのは初めてですか。
It was long before he knew it.	長い間たってから彼はそれを知った。
I can't make out what he wants.	私は彼の望むことを理解できない。
I know who likes Sachiko.	私は誰が佐知子さんを好きなのか知っています。
I didn't know what to say.	私は何と言ってよいのか分かりませんでした。
I should like to go with you.	私はあなたと一緒に行きたいものです。
When will we get there?	私たちはいつそこのたどり着くことになるだろうか。
Any one of us could do it.	私たちのうちの誰でもそれができるでしょう。
You don't like sashimi, do you?	刺し身は好きではないのでしょう。
Have you got through with your work?	仕事を仕上げましたか。
I have some work to do this evening.	今晩は仕事があります。
Where have you been all this time?	今までずっとどこにいたの。
There is less time than I thought.	考えていたほど時間はない。
You'd better not see her now.	君は今は彼女と会わないほうがいいよ。
You should have known better.	君はもっと分別を持つべきだったのに。
I haven't seen you for a long time.	久しく会っていませんね。
Could you make time for me?	何とか時間の都合をつけてもらえませんか。
What is it that "isn't only you"?	何があなただけではないって？
It is better to give than to take.	もらうより与える方が良い。
If he has time, he will come.	もしひまがあれば、彼は来るでしょう。
It was not long before he knew it.	まもなく彼はそれを知った。
How long have you been in Japan?	どのくらい日本にいるんですか。
Where did you get to know her?	どこで彼女と知り合いになったのか。
How did you get to know him?	どうして彼を知るようになったのですか。
What makes you think that way?	どうしてそんな風に考えるのですか。
It is up to you how you take it.	それをどうとるかは君しだいだ。
What are you going to do with it?	それをどうするつもりですか。
I don't know how I should do it.	それをすべき方法が分からない。
Get them out of the way.	それらを邪魔にならないところに置いてください。
That's how I got to know her.	そのようにして私は彼女と知り合った。
This is what I've long wanted.	これは私が長い間欲しかったものだ。
Which is better, this or that?	これとあれではどちらが良いですか。
How did you come to know this?	この事をどのようにして知ったのか。
What did you get for Christmas?	クリスマスに何をもらいましたか。
You may as well come with me.	あなたは私といっしょに来た方がいい。
Are you through with your work?	あなたは仕事をやり終えましたか。
Are you through with your work?	あなたは仕事をもう終えましたか。
He said that you need not go.	あなたは行く必要はないと彼は言った。
When will you go back to Japan?	あなたはいつ日本へ帰られますか。
What was it that you wanted?	あなたが欲しかったものは何だったのか。
I don't know what I should say.	何と言ったら良いか分かりません。
She likes traveling best of all.	彼女は旅行がとりわけ好きである。
She will come back before long.	彼女はまもなく戻ってくるでしょう。
She came up to Tokyo at eighteen.	彼女は１８歳のときに上京した。
She will be there by now.	彼女は、今ごろは、そちらに着いているでしょう。
He had to work even on Sunday.	彼は日曜でさえ働かねばならなかった。
He is getting better day by day.	彼は日ごとによくなってきている。
He did not know what to say.	彼は何と言ってよいのやらわからなかった。
He did not know where to go.	彼はどこへ行ったらいいか分からなかった。
He works from nine to five-thirty.	彼は九時から五時半まで働く。
I can't make out what he wants.	彼が何を欲しているのか分からない。
If only he had been there.	彼があそこにいてくれさえすればよかったのに。
The day is getting longer and longer.	日はだんだん長くなる。
Who do you think will come first?	誰が一番先に来ると思いますか。
It was not long before she came.	待つほどもなく彼女はやって来た。
I can't make out what she said.	私は彼女の言うことを理解できない。
I don't want to see him at all.	私は彼に絶対に会いたくありません。
I think of you all the time.	私はあなたのことを、いつも想っています。
Give me some time to think it over.	私に考える時間をください。
I can't make out what he wants.	私には彼のほしい物が理解できない。
All I can do is to do my best.	私にできるのは全力を尽くすだけです。
We came back by way of Hong Kong.	私たちは香港経由で帰ってきた。
I'm not going, and that's that.	行かないと言ったら行かないんだよ。
It is better for you to do it now.	君は、今それをやる方が良い。
I would like you to come with me.	君に一緒に来て欲しいのですが。
I would like to come and see you.	貴社にお伺いしたいと思います。
Have you been to London before?	ロンドンへ行ったことがありますか。
It will not be long before he comes.	まもなく彼がくるだろう。
I would like to see Mr Holmes.	ホームズさんにお会いしたいのですが。
Do you know which way to take?	どちらの道に行くべきかわかりますか。
By the way, where are you from?	ところであなたはどこの出身ですか。
How did you come to know her?	どうして彼女と知り合いになったのかい。
How come you aren't taking me?	どうして私をつれていってくれないの。
How come you don't know this?	どうして君、このことを知らないのかね？
As I had seen him before.	というのも、以前彼に会ったことがあったからだ。
About how long will it take?	だいたいどのくらいの時間がかかりますか。
She had no way to know about it.	それについては知る由もなかった。
I like him all the better for it.	それだからいっそう彼が好きだ。
Come and see me any time you like.	いつでも遊びにいらっしゃい。
You have only to go with me.	いっしょに付いて来てくれさえすればいい。
I want to go to America some day.	いつかアメリカに行きたいんだ。
When are you going back to Italy?	イタリアへはいつ戻るのですか。
He said that you had better go.	あなたは行く方がよいと彼は言った。
When will Yuko come to Denver?	優子さんはいつデンバーに来るのかなあ。
I will see that all goes well.	万事うまくいくように私が気をつけます。
I can't make out what she said.	僕は彼女が言ったことが理解できない。
They'll give in to us some day.	彼らもいつか我々に折れてくるだろう。
They may not know about it.	彼らはそのことについて知らないかもしれない。
He may come, or he may not.	彼は来るかもしれないし、来ないかもしれない。
He was willing to work for others.	彼は他人のために喜んで働いた。
He was willing to work for others.	彼は進んで他人のために働いた。
When did he come back from Osaka?	彼はいつ大阪から戻ったのですか。
You don't have to work on Sundays.	日曜日に仕事をする必要はない。
As it is Sunday, I have no work to do.	日曜なので仕事が無い。
No other man could do my work.	他人には私の仕事はできないでしょうに。
The Murais have gone back to Japan?	村井さん一家は日本に帰った？
"I like traveling." "So do I."	「私は旅行が好きです」「私も好きです」
I don't know if he knows it.	私は彼がそれを知っているかどうか知らない。
I haven't seen him for a long time.	私は長い間彼に会っていない。
I have no thought of seeing her now.	私は今彼女に会う気がない。
I don't know how to use a VCR.	私はビデオデッキの使い方が分からない。
I can't make out what he says.	私には彼が何を言っているのか解らない。
What are you doing this evening?	今晩あなたは何をするつもりですか。
I'll think about it and get back to you.	考えて返事します。
Come on, Shougo. You can do it.	頑張るのよ省吾、あなたなら出来るわ。
Do you think we can get there in time?	間に合うと思いますか。
Where there's a will, there's a way.	意志のあるところに道あり。
I took it that you would come.	わたしはあなたが来るものと考えていた。
If you do it at all, do it well.	やるからには、ちゃんとやりなさい。
There's no other way than this now.	もうこれよりほかに手はない。
What were you doing then?	その時あなたたちはいったい何をしていたのですか。
Would you like me to do that work?	その仕事を私がやりましょうか。
Said John, and he was right.	ジョンは言いましたが、彼の言う通りでした。
Haven't I seen you before?	これまでにお会いしたことがありませんでしたか。
How did all this come about?	これは全てどのようにして起こったのですか。
If you do it at all, do it well.	いやしくもやるからには上手くやれ。
When did you get back from London?	いつロンドンから戻りましたか。
I don't like her in some ways.	いくつかの点で私は彼女が気に入らない。
No, you need not go right now.	いいえ、今すぐに行く必要はありません。
Shall I get some for you?	あなたのためにいくらか手に入れてあげましょうか。
I want to see you before you go.	あなたが出かける前にお会いしたい。
What are some other nabemono?	なべ物にはほかにどんなものがありますか。
She and hers are all very well.	彼女も彼女の家族もみなとてもげんきだ。
She wants me to go with her.	彼女は私にいっしょにきてほしいと思っている。
I don't know what's got into her.	彼女は一体どうしちゃったのかしら。
She has got there just in time.	彼女はちょうど間に合ってそこに着いた。
How long have you known her?	彼女と知り合ってからどれくらいになりますか。
I couldn't make her out at all.	彼女と言う人がぜんぜん分からなかった。
They do not know how to do it.	彼らはそれをどのようにするかを知らない。
He will get better little by little.	彼は少しずつよくなるだろう。
He thinks he is an Edison.	彼は自分をエジソンのような発明家だと思っている。
He came all the way from Chicago.	彼ははるばるシカゴからやってきた。
I have not seen him for a long time.	私は彼に久しく会っていない。
There's no way I'm going to do that.	私は絶対にそんな事しません。
I got through with my work just now.	私は仕事をたった今仕上げた。
I'm thinking of going to Europe.	私はヨーロッパへ行こうと思っている。
I know the man you came with.	私は、あなたが一緒に来た人を知っています。
Can you see Mt. Daisetsu over there?	向こうに大雪山が見えますか。
How did you come to know her?	君はどうして彼女と知り合いになったんだい。
You shouldn't have gone there.	君は、そこに行かなかったほうが良かった。
I've been to Hokkaido before.	以前、ぼくは北海道に行ったことがあります。
A Mr. Marconi wants to see you.	マルコーニさんとかいう人がご面会です。
It was not long before she came back.	まもなく彼女が帰って来た。
Well, it'll do for the time being.	まあ当分はそれで間に合うだろう。
"Come and see", said Philip.	ピリポは「来て、そして、見なさい」と言った。
I'm thinking of going to Paris.	パリへ行ってみようかなと思っています。
How long have you been in Japan?	どのくらい日本にいらっしゃいますか。
How should I know where he is?	どうして私が彼の居場所を知っていようか。
How did you get to know her?	どうして君は彼女を知るようになったのですか。
How did you come to know it?	どうして君はそれを知るようになったのですか。
That's how I came to know her.	そんな風にして私は彼女と知り合ったのだ。
That's just what I was going to say.	それを私はいいたかったんだ。
I didn't know what to do then.	その時はどうすべきかわかりませんでした。
I don't know if George is coming.	ジョージが来るかどうか知りません。
But how can they do this?	しかし彼らはどうやってこれをすることができるのか。
This is just what I wanted.	これはちょうど私がほしいと思っていたものです。
When will you get through with work?	いつ仕事が終わる予定ですか。
I don't know what to say to Tom.	トムに何と言えばいいのか分からない。
I will come and see you when I get well.	良くなったら伺います。
Nagoya is between Tokyo and Osaka.	名古屋は東京と大阪の間にあります。
She is getting better day by day.	彼女は日ごとに快方に向かっています。
I can't make out what she is saying.	彼女が言ってる事がわからない。
He has been to Switzerland before.	彼は前にスイスへ行ったことがある。
He will come to see us some day.	彼はいつか私たちに会いにくるでしょう。
I haven't seen him for a long time.	彼には随分長いこと会っていない。
Have you known him for a long time?	彼と知り合ってもう長いのですか。
Not only he but also I am to go.	彼だけでなく私も行くことになっている。
I don't know where he comes from.	彼がどこの出身なのか私は知りません。
I don't know when he'll come back.	彼がいつ戻ってくるかわかりません。
Come and see me if you have any time.	時間があったら会いに来てね。
I can't make out what he wants.	私は彼の要求しているものが理解できない。
I have to use English all day.	私は一日中英語を使わなければならなかった。
I could have done better than he.	私だったら彼よりうまくできただろう。
A Mr Sakaki has come to see you.	榊さんとかいう方がお見えになりました。
I didn't know what to do first.	最初私は何をすればよいかわからなかった。
All you have to do is do your best.	君は最善を尽くしさえすればよい。
How did you come to know her?	君はどうして彼女と知り合うようになったのか。
This is all you have to do now.	君が今しなければならないのはこれだけだ。
Where there's a will, there's a way.	意志のあるところには道がある。
Where there's a will, there's a way.	意志があるところに道は開ける。
How did you get to know Mary?	メアリーとどうして知り合いになったのですか。
There! That wasn't long, was it?	ほらごらんなさい。長くなかったでしょ。
Hollywood isn't what it used to be.	ハリウッドには昔日の面影はない。
How did you get to know her?	どのようにして彼女を知るようになったのですか。
How did you get to know her?	どのようにして彼女と知り合いになったのですか。
How did you come to know her?	どうゆうふうにして彼女と知り合ったのですか。
When did you come back from Germany?	ドイツからいつ帰国しましたか。
Aren't you going to get Mr Tate?	テイト氏をつれてきていただけませんか。
It is time you get down to work.	そろそろ本気で仕事に取り組むころだよ。
It is about time I was going.	そろそろおいとましなければならない時間です。
The work was well done in a way.	その仕事はある意味では立派に成された。
Other than that, I've been doing well.	そのほかは、万事順調です。
How long have you known Jack?	ジャックと知り合ってどのくらいになりますか。
This is just the way I like it done.	これは私の好みにぴったりです。
We take the Asahi and Yomiuri.	うちは朝日新聞と読売新聞を購読しています。
When will you get through with work?	いつあなたは仕事を終えますか。
Do you like Japanese or English?	あなたは英語と国語どちらが好きですか。
How long have you been in Japan?	あなたはどのくらい日本においでですか。
Well done is better than well said.	よき言葉より、よき行いの方が勝る。
She need not have done the work.	彼女はその仕事をする必要はなかったのに。
I should think she is over sixty.	彼女は６０歳を過ぎていると思いますが。
They had gone there two days before.	彼らは二日前にそこへ行っていた。
He didn't give me time to think.	彼は私に考える時間を与えてくれなかった。
He is not the man that he used to be.	彼は以前のような人物ではない。
He is a man who will do what he wants.	彼はやりたいことを通す人だ。
"You'd better come in," the man said.	入りなさい、とその男は言った。
No other man could do my work.	他人には私のやっている仕事はできないだろう。
How long have you been in Kobe?	神戸にはもうどれくらいいらっしゃいますか。
When did you first come over to Japan?	初めて日本に来たのはいつか。
Come and see me when you have time.	時間のある時に私に会いに来なさい。
I don't know the day when he will come.	私は彼の来る日を知らない。
I didn't know what to do first.	私は最初に何をしたらよいかわからなかった。
I came to Japan to see Kyoto.	私が日本に来た目的は、京都を見物することです。
I'll come and see you one of these days.	近いうちにお訪ねします。
Mary came up to me when she saw me.	メアリーは私を見ると近づいてきた。
It will not be long before I come back.	まもなく私は戻って来ます。
I don't know when Bob came to Japan.	ボブがいつ来日したか分からない。
That's the best way we can do now.	それが私たちが今できる最善の方法だ。
I had a Nissan before this one.	この車の前は、ニッサン車に乗っていました。
I know that you did your best.	きみが全力をつくしたことをぼくは知っている。
I want to go to America some day.	いつかアメリカに行きたいと思っている。
I think I should do it for you.	あなたのためにそれをすべきだと思うのです。
I'm the one who wants to be with you.	あなたと一緒にいたいのは私だ。
"Is he coming?" "No, I think not."	「彼は来ますか」「来ないと思います」
You said so the other day, didn't you?	この間きみはそう言ったよね。
"Who is that man?" "Mr Kato."	「あの人は誰なんでしょうか」「加藤さんですよ」
She is no longer what she used to be.	彼女はもはや以前の彼女ではない。
I can't make out what she is saying.	彼女のいっていることがわからない。
They didn't know what to do first.	彼らはまず何をすべきかわからなかった。
They came all the way from Brazil.	彼らははるばるブラジルからやってきた。
They couldn't think where to go.	彼らはどこへ行ったらよいかわからなかった。
He has just come back from Paris.	彼はちょうどパリから帰ってきたところだ。
Could you make out what he was saying?	彼の言ってた事、分かったかい。
Could you make out what he was saying?	彼の言ってたことが解ったかい。
Are you taking in all he is saying?	彼が云っている事を全部理解できるの。
If you take four from ten, you have six.	十から四を引けば六が残る。
Give me what you have in your hand.	手に持っているものを私に渡しなさい。
I know a little about Shakespeare.	私はシェークスピアを少々知っています。
That's just what I was going to say.	私の言わんとするところもそこです。
Where can we get what we want?	私たちはどこで欲しいものが手に入れられますか。
Ken has been to England before.	健は以前イングランドに行ったことがあります。
Where there's a will, there's a way.	やる気があれば方法は見つかるもの。
If I were you, I wouldn't do it.	もし僕が君だったら、そんなことはしないよ。
I wouldn't do it if I were you.	もし私があなただったらそれをしないでしょう。
No other man could do my work.	ほかの人は私のやっていることが出来ないだろう。
It was used only from time to time.	それはときどき使用されるだけだった。
I like her all the better for that.	それだからいっそう私は彼女が好きだ。
What time is it now in San Francisco?	サンフランシスコは今何時ですか？
I don't know what to do from now on.	これから先何をすべきか分からない。
"No, I don't," said Mr Jordan.	「はい、ありません」とジョーダンさんは答えた。
I like a GP01Fb better than a GP02.	僕はＧＰ０２よりＧＰ０１Ｆｂが好きだ。
Do you know when they will be back?	彼等がいつ戻ってくるか知っていますか。
She got through her work before five.	彼女は５時前に自分の仕事を終えた。
I'd like to know which he likes.	彼はどちらがすきなのかぜひ知りたいものです。
He may be the very man that I need.	彼こそが私に必要な人なのかもしれない。
I don't know when he'll come back.	彼がいつ帰ってくるのか私にはわからない。
No other man could do my work.	他の人には私のやっている仕事はできないだろうに。
How long will it take to get well?	治るのにどのくらいの期間がかかりますか。
She comes to see me from time to time.	時々彼女は私に会いにやってくる。
I didn't know what to say to him.	私は彼に何と言ったら良いかわからなかった。
I made the best of her time in Japan.	私は、日本での時間を有効に使った。
Would you like me to do that work?	私にその仕事をやってもらいたいのですか。
We have to do the work in a day.	私たちは一日でその仕事をしなければならない。
We have to be at work by nine.	私たちは９時までに仕事に出ていなければならない。
Is there any need for me to go there?	私がそこに出向く必要がありますか。
How are you getting on with your work?	仕事のはかどり具合はどうですか。
I can not make out at all what you say.	君の言うことは全く分からない。
What is it that you want me to do?	君が私にやってほしいというのは何ですか。
It will not be long before he gets well.	もうすぐ彼はよくなるだろう。
He says he has been to Hawaii before.	ハワイにいった事があると彼が言う。
How did you get to know about her?	どのようにして彼女のことを知りましたか。
I would like to see Mr Terry Tate.	テリー・テイトさんにお会いしたいのです。
The days are getting longer and longer.	だんだん日が長くなっています。
You should have said so at that time.	その時あなたはそう言うべきでした。
How long will it take to get there?	そこへ着くのにどれぐらいかかりますか。
There is no one who wants to go there.	そこへ行きたがる人は誰もいない。
Oh, OK. Well, can you get me one?	そうですか、じゃ、取り寄せてもらえますか。
This is the very best way to do it.	これはそれを行うまさに最良の方法です。
Some say this, and others say that.	こう言う人もいれば、ああ言う人もいる。
What were you doing when she came?	あの子が来たとき、君が何をしているんだ。
How long have you been in Kushiro?	あなたはどのくらい長く釧路にいましたか。
When did you come back from Tokyo?	あなたはいつ東京から帰ってきたのですか。
"Is he right?" "I don't think so."	「彼は正しいですか」「そうは思いません」
I don't want to be better than him.	彼が常に上の存在であって欲しいと思います
It will not be long before she comes back.	彼女はまもなく戻るだろう。
He has got well, so that he can work now.	彼は全快したのでもう働ける。
Are you taking in all he is saying?	彼の言っていることがぜんぶ理解できるの？
We could all see it coming, couldn't we?	誰もが予想できたことじゃない？
For he knew what was in a man.	人について誰の証言も必要とされなかったからである。
I gave her just what she needed.	私は彼女がちょうど必要としているものを与えた。
I do not know when she can come.	私は彼女がいつ来ることができるかわかりません。
I can't make out what he was saying.	私は彼が言っていたことが理解できない。
I didn't know what to say to him.	私には彼に何といったら良いか分からなかった。
I don't know what you want to do.	私には、あなたが何をしたいのかわかりません。
At first, I didn't know what to do.	最初は私は何をしてよいかわからなかった。
What are you going to do this evening?	今夜あなたは何をするつもりですか。
He says he has been to Hawaii before.	ハワイに行ったことがあると彼は言う。
Do you know where Jim and Nancy are?	ジムとナンシーがどこにいるか知ってる？
Give me some time to think it over.	しばらく考えてみたいので時間をください。
All you have to do is to do your best.	あなたは全力を出しさえすればよい。
Who has made you what you are now?	あなたが今あるのはだれのおかげなのですか。
Do you think you could make it at 9:30?	９時３０分にしていただけますか。
"What do you think?" "Well, I'm for it."	「どう思う？」「いや、賛成だ」
You may come with us if you want to.	来たいのなら私達と一緒にきても良いです。
He used to come to see me on Sunday.	彼は日曜日には遊びに来るのが常であった。
He came to London by way of Siberia.	彼はシベリア経由でロンドンにやってきた。
The days are getting longer and longer.	日がだんだん長くなってきています。
I didn't know what to say to him.	私は彼になんて言ったらいいのかわからなかった。
I like Sachiko better than Akiko.	私は亜紀子さんよりも佐知子さんの方が好きです。
I can't make out what she wants.	私には彼女が何を欲しがっているのか理解できない。
I didn't know what to say to him.	私には彼になんて言ったら良いか分からなかった。
You've got it in one. That's right.	君はすぐに分かったんだね。そのとおりだよ。
Then who are you? Are you Elijah?	では、いったい誰ですか。あなたはエリヤですか。
I like her all the better for that.	それだからいっそう私は彼女のことが好きだ。
What time do we get to San Francisco?	サンフランシスコには何時に着きますか。
May I have this for two or three days?	これを二、三日貸していただけますか。
There's a Mr Kay wants to see you.	ケイさんという方がお目にかかりたいそうです。
I want you to be an Einstein.	あなたにアインシュタインのような人になってもらいたい。
It's OK with me if it's OK with you.	あなたさえよければ、私はかまいませんよ。
We got through the work just before ten.	１０時ちょっと前に仕事が済んだ。
Seven days of Saturday is all that I need.	毎日が土曜日だったらいいのに。
They did not know what to do first.	彼らは最初に何をしたらいいかわからなかった。
He should have been back by this time.	彼は今の時間には当然戻っているはずだ。
I don't have to go-I want to go.	私は行かなければならないのではない、行きたいのだ。
It will not be long before he gets well.	もうすぐ彼の病気は回復するだろう。
It won't be long before Mike gets well.	まもなくマイクは元気になるでしょう。
Henry wants to see you.	ヘンリーさんという方があなたにお目にかかりたいとおっしゃっています。
I need some butter. Do you have any?	バターが要るんだけど、いくらかありますか。
I do not know when she will come back.	彼女がいつ戻ってくるかは分かりません。
How long have you known Judy?	あなたはジュディさんと知り合ってどれぐらいになりますか。
"I know him well." "Oh, do you?"	「彼のことはよく知っていますよ」「ああそうですか」
She didn't know what to say to him.	彼女は彼に何を言ったらよいのか分からなかった。
He said he would come and he did come.	彼は来ると言ったが、その通りやって来た。
He took back what he had said about me.	彼は私について言ったことを取り消した。
It won't be a long time before he gets well.	彼は間もなく良くなるだろう。
I couldn't make out what he was saying.	彼が何を言っているのか殆どわからない。
I would not have you other than you are.	私はあなたには今のままでいてほしい。
Would you like to come and see us this evening?	今夜遊びにきませんか。
"What time is it now?" "It's 3:30."	「今は何時なんでしょう？」「３時３０分です。」
Ichiro will go to Nagoya for the first time.	一郎ははじめて名古屋へ行く。
He said he had been to Hawaii before.	以前ハワイに行ったことがあると彼はいった。
It will not be long before he gets better.	まもなく彼は快方に向かうだろう。
One way is not better than the other.	どちらかが他方よりいい、というのではない。
How should I know where he is?	どうして私が彼の居場所を知っていようか。知るはずがない。
I'll give you a day to think about it.	それについて考える時間を一日あげますよ。
I'll take you there one of these days.	そのうち君をそこに連れていってあげよう。
When and where did you come to know her?	いつ、どこで彼女と知り合ったんだい。
I can't make out what the man is saying.	あの男の言っていることが分からない。
I can't make out what the man is saying.	あの男が言っていることがわからない。
I thought you had better not go out.	あなたは外出しないほうがよい、と私は思った。
What is it that you want me to do now?	あなたが今、あたしにしてほしいことは何？
What do you think she is going to do?	彼女は何をしようとしているのだと思いますか。
If he had known about it, he would have come.	彼は知っていたら来ただろう。
I'll come and see you at 3:00 p.m. on Sunday.	日曜日の３時にうかがいます。
I couldn't make out what he was saying.	私は彼の言っている事が理解できなかった。
I couldn't make out what he was saying.	私は彼が言っている事を理解できなかった。
I am thinking of going to Los Angeles.	私はロサンゼルスに行こうかと考えています。
I think that you do know about that.	私はあなたが実際にそのことを知っていると思う。
As I see it, that is the best way.	私の見るところでは、それがいちばんよい方法である。
I wouldn't do that if I were you.	もし私があなたであるならそんなことはしないでしょう。
There's no way I can make it up to you.	どう埋め合わせしたら良いかわかりません。
And then the Romans came in 55 B. C.	それから、紀元前５５年にはローマ人が来ました。
If John had of come, I needn't have.	ジョンがきていたなら、私は来る必要はなかった。
Which do you like better, this or that?	あなたはこれとあれとどちらが好きですか。
Tom likes Mary and Mary likes Tom.	トムはメアリーが好きだし、メアリーもトムが好きだ。
"What are you thinking about?" "Nothin'..."	「何を考えてるの？」「別に・・・」
It will be some time before they come.	彼らが来るまでにはまだしばらくかかるだろう。
He took back what he had said about her.	彼は彼女について言ったことを取り消した。
He wants to be an Edison some day.	彼はいつかエジソンのような人になりたいと思っている。
It will be some time before he gets well.	彼がよくなるにはしばらくかかるだろう。
I don't think she will come back by five.	私は、彼女が５時までに戻らないと思う。
There's very little we can do now.	今となっては私たちができることはほとんどありません。
I can not make out at all what you say.	君の言うことは全く理解することができない。
What is it that makes you think that way?	君がそんな風に考えるのはどうしてだい。
By the way, what time will you go there?	ところで、何時にそこへ行くつもりですか。
How long have you known Jim Robinson?	ジム・ロビンソンとはいつからの知り合いですか。
I thought you had to get up by 7:30.	７時半には起きなければいけなかったんじゃないの。
She likes no one and no one likes her.	彼女は誰も好かないし、また誰も彼女を好かない。
He had, I thought, no right to do that.	彼はそんなことをする権利がないと私は思った。
Are you doing what you think is right?	君は、自分で正しいと思うことをやっているのか。
I didn't think you were going to make it.	間に合わないのではないかと心配していた。
There is a Mr Ito who wants to see you.	伊藤さんという人がお目にかかりたいそうです。
First came the Celts in 600 B.C.	まずやって来たのはケルト族で、紀元前６００年のことでした。
Don't you think Tanaka is the one who did it?	これをやった犯人は、田中君だね？
Did you go to Hawaii or Guam?	あなたはハワイへ行ったのですか、それともグアムへ行ったのですか。
"When do you get up?" "I get up at eight."	「あなたはいつ起きますか」「８時です」
He makes out that he has a right to say so.	彼はそう言う権利があると主張している。
We have to make the best of what we have.	私達は今あるもので我慢しなければならない。
I couldn't make out what he wanted to say.	私は彼が何を言いたいのか分からなかった。
You are the very man I want to see.	私が会いたいと思っているのはまさにあなたのような人だ。
I like it better now that I'm used to it.	慣れてみると、そのほうが好きになりました。
What do you think should be done about it?	その件についてどうすべきだと思いますか。
When and where did you come to know her?	いつ、どこで彼女を知るようになったのですか。
Which will you take, this one or that one?	あなたはこれとあれとどちらを選びますか。
I didn't know when Bob had come to Japan.	私はボブがいつ来日したのかを知らなかった。
She had, I thought, no right to do that.	彼女はそんなことをする権利がないと私は思った。
There is no way of knowing where he's gone.	彼がどこへ行ってしまったか知る由もない。
I took you for Roy when I first saw you.	初めて君に会った時、僕は君をロイとまちがえた。
We couldn't make out what she wanted.	私たちは彼女が何をほしがっているのかわからなかった。
You've got to go even if you don't want to.	行きたくなくても行かなければなりません。
You've got to go even if you don't want to.	行きたくなくても行かなくてはなりません。
We didn't want to go, but we had to.	我々は行きたくは無かったが、行かなければならなかった。
It won't be long before he is up and about.	まもなく彼は病気が治って動き出すだろう。
He came in just as I was going out.	ちょうど私が出かけようとしていたときに、彼が入ってきた。
Jim is not the man that you think him to be.	ジムは君が思っているような人ではない。
We will do our best so that we can have a meetup.	オフ会ができるように皆で頑張る
Should he come, what should I say to him?	万一彼が来たらなんと言ったらよいのでしょうか。
I don't know where to go or what to do.	私はどこへ行くべきかも、何をすべきかもわからない。
We worked on Saturdays, but now we don't.	私たちは土曜日に働きましたが、今はちがいます。
You will think it just that I should do so.	私がそうするのは当然だと君は思うでしょう。
It will be all better if you can come now.	今あなたに来てもらえるならなおよいのですが。
May I come to see you one of these days?	近いうちにあなたに会いに行ってもよろしいですか。
I will be gone by the time she comes back.	彼女が帰ってくるまでには、私はここを去ります。
He came to see me all the way from Pakistan.	彼ははるばるパキスタンから私に会いに来た。
It is not known when he came up to London.	彼がいつロンドンに出て来たかは知られていない。
I was about to go out when he came to see me.	出かけようとしている所へ彼が訪ねてきた。
We have to make the best of what we have.	私達は今あるもので我慢していかなければならない。
At first I did not like him, but now I do.	私は初めは彼が好きではなかったが、今は好きだ。
I'd like to go with you, but as it is I can't.	君と一緒に行きたいが実際には行けない。
I didn't like her at first, but now I do.	最初のうちは彼女を好きではなかったが今は好きです。
It will not be long before Scott gets well.	スコットが元気になるのもそう遠くないでしょう。
If you want it done well, I'm your man.	うまくそれをやらせたいと思うなら私こそその適任者です。
She came up to me and said "How are you?"	彼女が私に近づいてきて「おげんきですか」と言った。
I don't know if she will go there with me.	彼女が僕といっしょにそこへ行くかどうかわからない。
I'll get the work done by the time he gets back.	彼がもどってくるまでに仕事を終えよう。
You have to make do with what you've got.	自分で引き受けたことは自分で処理しなければならない。
I was thinking about what she had said to me.	私は彼女が私に言ったことについて考えていた。
I was about to go out, when he came to see me.	私が出かけようとしていると彼がやってきた。
At first I didn't like him, but I do now.	最初は彼のことが好きではなかったけれど今は好きです。
You needn't go there if you don't want to go.	行きたくなければ、そこへ行かなくてもいいよ。
Is this what you've wanted for a long time?	これですか、あなたが長い間欲しがっていたものは。
Who do you like better, Akiko or Sachiko?	あなたは亜紀子さんと佐知子さんとどちらが好きですか。
Do you come from Austria or Australia?	あなたはオーストリア出身ですか、オーストラリア出身ですか。
If you don't want to go, you don't need to.	あなたが行きたくないのなら行く必要はありません。
She said that she had seen such and such there.	彼女はそこでしかじかの人々を見たと言った。
I don't know her and I don't think I want to.	私は彼女を知らないしまた知りたいとも思わない。
Now you are sixteen, you should know better.	もう１６歳なのだから、もっと分別をもちなさいよ。
I want you to take back what you said just now.	たった今言ったことを取り消してもらいたい。
This is going to take a long time, said Tony.	これは長い時間かかりそうだ。とトニーは言った。
I don't want to go if you don't go with me.	もし君が私と一緒に行かないのなら、私は行きたくない。
If I had known it, I would have gone there.	もしそれを知っていたなら、私はそこへ行っただろうに。
Which do you like better, Denver or Montreal?	デンヴァーとモントリオールとどっちが好きですか。
By the time you come back, I'll be gone.	きみがもどって来るころには、ぼくは出かけてしまっているよ。
Who do you like better, Sachiko or Akiko?	あなたは佐知子さんとアキ子さんとではどちらが好きですか。
I don't know if she wants to go with me.	彼女が私といっしょに行きたがっているかどうか私は知りません。
He can do it well, and you can do it even better.	彼はそれをうまくやれる、君ならなおさらだ。
You will just have to do with what you've got.	手元にあるものでがまんしなければならないだろう。
At first, I couldn't make out what he was saying.	最初は彼の言っていることが分からなかった。
He is at work now, but will come back at seven.	彼は今仕事に行っていますが、７時には戻ってきます。
I didn't know where to go, or what to do.	私はどこへ行ったらよいのか、何をしたらよいのかわからなかった。
At first, I couldn't make out what he was saying.	最初私は彼が言っていることが理解できなかった。
How would you know an American from an Englishman?	アメリカ人と英国人はどのように見分けますか。
You should know better now you are eighteen.	あなたは１８になったのだから、もっと分別があっても良い。
All I know is that he came from China.	私の知っていることといえば、彼が中国からやってきたということだけです。
I am not the man I was when you knew me first.	今の私は、あなたと初めて会ったころの私ではありません。
If you could do it at all, I'd like you to do it.	せっかく君にそれがやれるなら、やってほしいんだが。
Not having seen her before, I did not know her.	以前会ったことがなかったので、私は彼女がわからなかった。
I'm thinking of taking you to see Mr Jenkins.	あなたをジャンキンズさんに会いにおつれしようと思っています。
I'm thinking of taking you to see Mr Jenkins.	あなたをジェンキンズさんに会いに連れてゆこうと思っています。
She knew him better than did all the others.	彼女は彼のことを、他のみんなが知っていたよりも、よく知っていた。
He came all the way from Kyushu to see the Mona Lisa.	彼はモナリザを見るためにはるばる九州から来た。
You will just have to do with what you've got.	あなたは自分の持っているもので満足しなければならないだろう。
When you can't do what you want, you do what you can.	したいことが出来なければ出来ることをしなさい。
I'm thinking of taking you to see Mr Jenkins.	私はあなたをジェンキンズさんに会いにお連れしようと思っています。
I don't think I can get through all this work by five.	この仕事を５時までに全部は終えられないと思う。
He would not say so if he didn't know about that.	もし彼がそのことについてしらなければそうは言わないだろう。
It took a long time to take in what she was saying.	彼女が言っている事を理解するのにずいぶんと時間がかかった。
He is not the man that he was when I first knew him.	彼は私が最初に知り合った頃の当時の彼ではなくなっている。
We'll go to Hong Kong first, and then we'll go to Singapore.	先ず香港に行ってそれからシンガポールに行きます。
It took him a long time to take in what she was saying.	彼女が言っていることを理解するのに彼には随分時間がかかった。
You have wanted to go there for a long time, haven't you?	あなたは以前からずっとそこへ行きたがっていましたからね。
It took him a long time to take in what she was saying.	彼女の言っていることを理解するのに彼にはずいぶん時間がかかった。
If I had had to do it, I would have done it at that time.	それをしなければならなかったのなら、その時にしていただろう。
I didn't want to work with him, but I made the best of it.	私は彼といっしょに仕事をしたくなかったが、なんとか我慢してやった。
They can come on Monday or Tuesday, but not on Wednesday or Thursday.	彼らは月曜日か火曜日に来てもよいが、水曜日と木曜日はだめだ。