I will give it to you.	それをお前にやろう。
I will give you what help I can.	できるだけの援助をいたしましょう。
I will go provided that the others go.	他の人が行くなら私も行きます。
I will have to help them.	彼らの手伝いをしなければならないだろう。
I will make up for it next time.	この次に償いをするよ。
I will part company with her.	私は彼女と別れるつもりだ。
I will show you the best 20.	ベスト２０を紹介します
I will use photos to show what it was like that day.	写真で当日の様子を紹介します
I work at this company.	私はこの会社で働いています。
I worked on Sunday, so I had Monday off.	日曜日に出社したので月曜日が代休だった。
I would like to go to a business school.	ビジネススクールに行きたいのです。
I would like to know her name.	彼女の名前を知りたい。
I would not have you other than you are.	私はあなたには今のままでいてほしい。
I wouldn't do it for the world.	どんなことがあっても私はやらない。
I'd like a city map.	市内地図がほしいのですが。
I'd like a map of the city.	市内地図をください。
I'd like a map of the city.	市内案内をください。
I'd like to buy a Picasso.	ピカソの絵を買いたいものだ。
I'd like to know which he likes.	彼はどちらがすきなのかぜひ知りたいものです。
I'd like to part with her if I could.	できれば彼女と別れたいのだが、を解雇したいのだが。
I'd like to see her.	彼女にお会いしたいのですが。
I'd like to see her.	彼女にお目にかかりたい。
I'd like to see her.	私は彼女に会いたい。
I'd like to take that out, please.	持ち帰りにして下さい。
I'll be back at ten.	１０時に帰ります。
I'll be free next Sunday.	来週の日曜なら空いてます。
I'll be seventeen next year.	来年で１７歳になるんだ。
I'll buy a Ford.	フォード車を買うつもりです。
I'll buy a new one.	新しいものを買おう。
I'll do the shopping for you.	私が買い物をしてあげましょう。
I'll get off here.	ここで降ります。
I'll get the work done by the time he gets back.	彼がもどってくるまでに仕事を終えよう。
I'll get you off from work.	君を仕事からはずすようにいってやろう。
I'll have worked here ten years next April.	来年の４月で１０年ここで働いたことになる。
I'll not be at home next Sunday.	私は今度の日曜日は家にいません。
I'll take them to Kate.	ケイトの所に持って行くんだ。
I'm getting high.	ほろ酔い気分ですよ。
I'm going to change and I'll be back.	着替えてきます。
I'm going to give Emi a new CD.	私は絵美に新しいＣＤをあげるつもりです。
I'm just looking.	ただ見ているだけです。
I'm looking for work.	私は仕事を探しています。
I'm looking for you.	私はあなたを探している。
I'm not going back.	私は帰らないわ。
I'm on top of the world.	幸福の絶頂にいる。
I'm pleased to see you.	お目にかかれてうれしく存じます。
I'm taking off now.	そろそろ行くわね。
I've been looking for you.	僕は君を捜していた。
I've been looking for you.	僕は君を探していたのだ。
I've given my best for the company.	私は会社のために精一杯やってきた。
I've given up on you!	君には愛想がつきたよ。
I've got little time for reading these days.	最近は読書の時間がほとんどない。
I've had a show.	おしるしが出ました。
If I had known it, I would have gone there.	もしそれを知っていたなら、私はそこへ行っただろうに。
If I were you, I'd buy that one.	私ならそれを買います。
If only I knew!	知っていればさえいればなぁ。
If only he had known!	彼が知っていてさえすればよかったのだがなあ。
If only he had known!	彼が知ってくれさえすればよかったのだがなあ。
Ikeda is my last name, and Kazuko is my first name.	池田が姓で和子が名です。
In 1998, he had reported that 〜.	〜と１９９８年に彼が報告している
Is there a photo shop in the hotel?	ホテルの中に写真屋はありますか。
Is this the last price?	これ以上まけられませんか。
It being Sunday, there was no school.	その日は日曜で授業がなかった。
It is Eve that sets Adam on.	アダムをそそのかしたのはイブだ。
It is all over with me. It can't be helped.	万事休すだ。もうどうしようもない。
It is better to give than to take.	もらうより与える方が良い。
It is good to do your best.	最善をつくすことはよいことである。
It is hers, is it not?	それは彼女のですね。
It is high time I was going.	もうまさに行く時間だ。
It is not as good as it looks.	それは見かけ倒しだ。
It is the only one there is in the shop.	店にあるのは、これ一つだけです。
It is time for her to go home.	もう彼女が帰る時間ですよ。
It is time to go to school.	もう学校に行く時間です。
It should be pleasing.	きっとお気に召していただけると思います。
It was here that I saw her.	私が彼女を見たのはここでした。
It was in London that I last saw her.	私がこの前彼女に会ったのはロンドンだった。
It will change little by little.	それが少しずつ姿を変えます
It's Sunday. He can't have gone to school.	日曜日だから、彼が学校に行ったはずはない。
It's about time to go to school.	もうそろそろ学校へ行く時間です。
It's all over for us.	もう我々はおしまいだ。
It's all over with her.	彼女はもうだめだ。
It's all over.	もうだめだ。
It's high time you got going.	君はもうとっくに出発していなければならない時間だ。
It's little known.	それがあまり多くの人には知られていない
It's the only one there is in the shop.	それは店にあるただ一つのものです。
It's time to go to school.	学校に行く時間よ。
It's unrivaled by any other companies.	それが全く他社の追随を許しません
It's up to you to get to school on time.	学校に定刻に着くのは君の責任です。
Jane is out shopping.	ジェーンは買い物に出かけている。
Jim can read Japanese.	ジムは日本語が読める。
John is having a good time.	ジョンは楽しい時を過ごしている。
Judy looked at me.	ジュディーさんは私を見た。
Ken has been looking for you.	ケンがあなたを探していましたよ。
Ken was in Japan last year.	健は去年日本にいました。
Ken will be fifteen next year.	健は来年で１５歳になります。
Know who you are.	己が誰なのか知れ。
Kobe is the city which I like best.	神戸は私がいちばん好きな町である。
Kobe is the city which I like best.	神戸は私が一番好きな街です。
Little help did I get.	少しの援助も私にはなかった。
Little help did he give me.	少しも彼は私の手助けをしてくれなかった。
Little is known about X.	Xについて知るところが少ない
Look about you.	君のまわりを見なさい。
Look about you.	周りを見てごらんなさい。
Look about you.	周りを見渡しなさい。
Look about you.	辺りをよく見なさい。
Look at me.	私を見なさい。
Look at the map on page 25.	二十五ページの地図を見なさい。
Look at the next page.	次のページを見なさい。
Look back!	後ろを見ろ。
Look me up next time you are in Kyoto.	この次、京都に来たら私を訪ねなさい。
Look out!	危ない！
Look. This is natto.	見て、これは納豆です。
Make good use of your time.	時間をうまく利用しなさい。
Make good use of your time.	時間をじょうずに利用しなさい。
Mary had to go to school.	メアリーは学校に行かねばなりませんでした。
Mary was looking for you at that time.	さっきメアリーが君を探していたよ。
May I have a program?	プログラムをいただけますか。
May I have your name, please?	あなたの名前は何ですか。
May I have your name, please?	お名前をお願いします。
May I have your name, please?	名前は何とおっしゃいますか。
May I have your name, please?	名前を教えていただけますか。
May I have your order, please?	ご注文をどうぞ。
May I take a message?	何か伝えておきましょうか。
May I take your order?	ご注文を承りましょうか。
Mayuko is good company.	マユコはつきあって愉快な子だ。
Might I have a look at this?	これを見せてもらってもかまいませんでしょうか。
Monday's not good.	月曜日は都合が悪いんです。
Mt. Asama is not as high as Mt. Fuji.	浅間山は富士山ほど高くない。
Mt. Fuji is about four times as high as Mt. Rokko.	富士山は六甲山のおよそ四倍の高さです。
Mt. Fuji is not as high as Mt. Everest.	富士山はエベレストほど高くはない。
Nancy likes music.	ナンシーは音楽が好きです。
No news is good news.	便りがないのは良い知らせ。
No news is good news.	無事に便りなし。
No, I changed it.	おかしくない。変更した。
No, I don't know.	いいえ、知りません。
No, but they might have them at our other store.	いいえ、でも、内の別の店にあるかもしれません。
Not that I know of.	私の知っている限りでは、そういうことはありませんね。
Not that I know of.	私の知る限りではないね。
Now that school is over, you can go home.	授業が終わったので帰ってもいい。
Now you are sixteen, you should know better.	もう１６歳なのだから、もっと分別をもちなさいよ。
Now, go have a good time.	さあ、楽しんでいらっしゃい。
OK, I'll order it.	じゃあ注文します。
Oh! Show me how.	あっ！教えてくれ。
Oh, off with you.	さあ、あっちへ行ってよ。
Order, please.	みなさん、どうか静粛に。
Other than that, I've been doing well.	そのほかは、万事順調です。
Our TV is out of order.	うちのテレビは調子が悪い。
Our work is all over now.	私たちに仕事はもうすっかり終わった。
Our work is all over now.	私達の仕事はもうすっかり終わった。
Please add my name to the list.	名簿に私の名前も追加してください。
Please back me up!	応援してね！
Please do not take photos here.	ここで写真を撮らないでください。
Please don't get up.	どうぞおたちにならないで下さい。
Please don't look at me like that.	そんなに見つめないでください。
Please get in.	乗ってください。
Please go and see who it is.	誰だか見に行ってください。
Please have some cookies.	どうぞ遠慮なくクッキーを召し上がってください。
Please help me with this.	ちょっと手伝ってください。
Please help me.	私を手伝ってください。
Please look at me.	私を見てください。
Please look for it.	探してください。
Please read page ninety-four.	９４ページを読んで下さい。
Please show me what to do next.	次はどうしたら良いか教えて下さい。
Please take one.	自由にお持ち下さい。
Please take some of them.	いくつかお取り下さい。
Prices are high these days.	近ごろは物価が高い。
Prices are high.	インフレが進んでいます。
Prices here are out of this world.	ここの値段はとても高いわ。
SOS, please help!	ＳＯＳ助けてくれ。
School is over at 3:30.	学校は三時半に終わる。
School is over now.	授業はもう終わりました。
Show me a better one.	もっと上等なのを見せてくれ。
Show me a list of your rates, please.	料金表を見せて下さい。
Show me how it works.	どういうふうに動くか見せてください。
Show me how to do it, please.	やり方を教えてください。
Show me how to do it.	その仕方を教えてください。
Show me some others.	何か他のものを見せてください。
Show me the photos, please.	それらの写真を見せて下さい。
Show me what you bought.	君が買った物を見せなさい。
So I can make music.	だから音楽を作り出すことができるのだ。
Steve goes to school with Kate.	スティーブはケートと一緒に学校に行く。
Take a look at this map.	ちょっとこの地図を見なさい。
Take your time over it.	時間をかけてゆっくりやりなさい。
Taking a little time off?	休みを取っているの？
That can't be good for your health, can it?	そんなの、身体にとっていいはずがないじゃありませんか。
That company is one of the best in the business.	その会社は一流企業です。
That didn't help them any.	それは少しも彼らの役に立たなかった。
That is my school.	あれが私の学校です。
That is our school.	あれは私達の学校です。
That isn't what I'm looking for.	僕の探しているのはそんなんじゃない。
That store gives good service.	あの店はサービスが良い。
That's $7.65, please.	７ドル６５セント、お願いします。
That's good news to me.	それは私にとっていい知らせだ。
That's how I got to know her.	そのようにして私は彼女と知り合った。
That's the part I liked best.	わたしはあそこが一番気に入ったわ。
That's what I'm looking for.	私が探しているのは、まさにそれだ。
The Hilton Hotel, please.	ヒルトン・ホテルまでお願い。
The Murais have gone back to Japan?	村井さん一家は日本に帰った？
The city was taken by the English in 1664.	その都市は１６６４年にイギリス人に占領された。
The group is made up of six members.	そのグループは６人のメンバーで成り立っている。
The group was made up by Dick.	そのグループはディックが作った。
The information you gave me is of little use.	君が僕に教えてくれた情報はあまり役に立たない。
The map shows business hotel information.	地図内には、ビジネスホテルの情報が表示されます
The music made the show.	音楽でそのショーは当たった。
The next day was Christmas Day.	次の日はクリスマスだった。
The prices are going up higher and higher.	物価はますます上昇しています。
The show is over.	その劇は終わった。
The site for the new school has been bought.	新設校の用地が出来ました。
The time when he did it was not known.	彼がそれをした時間は不明である。
The work has just been done.	仕事はちょうど今終わりました。
The world is not what it used to be.	世界は昔とは違う。
There is no change at all in X.	Xに全く変わりが無い
There is no knowing what he will do next.	彼が次に何をしでかすかわからない。
There is no need for her to work.	彼女が働く必要はない。
There is no one but knows it.	それを知らない人はない。
There was a message for me, wasn't there?	私の言付けがあったでしょうね。
There's no need to see them off.	彼らを見送る必要は無い。
They are going shopping.	彼らは、買い物に行く。
They are just going to the store over there.	あの人たちはちょうど向こうのお店まで行くところです。
They are looking to you for help.	彼らはあなたの援助を当てにしている。
They are of us, you know.	彼らは我々の仲間だ。
They are out shopping.	彼らはショッピングに出かけている。
They are pleased with your work.	彼らは君の仕事に満足している。
They are pleased with your work.	彼等は仕事に満足している。
They are well off.	彼らは暮らし向きがいい。
They changed the system.	彼らはその制度を改めた。
They did not know what to do first.	彼らは最初に何をしたらいいかわからなかった。
They didn't know what to do first.	彼らはまず何をすべきかわからなかった。
They do not know how to do it.	彼らはそれをどのようにするかを知らない。
They don't know my name.	彼らは私の名前を知りません。
They don't know that I'm Japanese.	私が日本人であることを彼らは知らない。
They gave it to me.	彼らはそれを私に与えた。
They know us.	彼らは私達を知っています。
They made her go.	彼らは彼女を行かせた。
They may not know about it.	彼らはそのことについて知らないかもしれない。
They set out for London.	彼らはロンドンに出発した。
They set out for New York.	彼らはニューヨークへ向け出発した。
They set up a new company in London.	彼らはロンドンで新会社を設立した。
They set up a school.	彼らは学校を設立した。
They were just in time.	彼らはちょうどまにあった。
They will have been in America for ten years next year.	来年彼らはアメリカに１０年いることになります。
They will set up a new company.	彼らは新しい会社を創設するつもりだ。
They'll give in to us some day.	彼らもいつか我々に折れてくるだろう。
They're going to Ishikawa.	彼らは、石川に行く。
This TV set is the best of all.	このテレビがすべてのうちで一番よい。
This hotel is better than that hotel.	このホテルはあのホテルより良い。
This is a map of the city of Osaka.	これは大阪市の地図です。
This is a map of the city of Sendai.	これは仙台市の地図です。
This is a map.	これは地図です。
This is all I can read.	これが私が読める限界です。
This is all I know.	これが私の知っているすべてです。
This is all I know.	私が知っているのはこれだけです。
This is all I need to know.	これさえ分かっていればいいよ。
This is as good as any.	これ以上のものはない。
This is the last order.	ご注文はこれで終わらせていただきます。
This is the last time.	これが最後だから。
This is to make up for the last time.	これはこの前のときの埋め合わせです。
This is what I bought in Spain.	これは私がスペインで買った物です。
This is what I have been looking for.	僕が捜していたのはこれなんです。
This isn't what I ordered.	これは注文したものと違っています。
This isn't what I ordered.	これは私が注文したものと違います。
This isn't what I ordered.	これは私が注文した物ではありません。
This offer is good for five days.	このオファーは５日間有効です。
This one is as good as that one.	これはあれと同じくらいよい。
This product is made in Italy.	この製品はイタリア製だ。
This would be better than that.	この方がまだしもあれよりよい。
To San Francisco, please.	サンフランシスコまで行ってください。
Tom didn't know what Mary's last name was.	トムはメアリーの苗字を知らなかった。
Tom is a good worker.	トムはよく働く。
Tony did not know their names.	トニーは名前を知りませんでした。
Was he in Hokkaido last year?	彼は昨年北海道にいましたか。
We are better off than we used to be.	私たちは以前より暮らし向きがよい。
We are getting on first-rate.	我々はとても仲良くやっている。
We are having a good time.	楽しく過ごしている。
We are looking to you for help.	我々はあなたに援助を求めています。
We buy CDs.	私たちは、ＣＤを買います。
We can see Mt. Fuji over there.	あちらに富士山が見えます。
We did our best to help them.	私達は彼らを助けるため全力をつくした。
We didn't know what to do next.	私たちは、次に何をしたらよいかわかりませんでした。
We didn't know what to do.	私たちはどうしていいかわからなかった。
We do business with that company.	我が社はあの会社と取り引きをしている。
We got a good price for that.	それは高く売れた。
We had some time off.	ゆっくり時間を過ごせました
We have been to see her off.	彼女を見送ってたところです。
We have been to see her off.	彼女を見送りに行ってきたところです。
We have good news.	いい知らせがあります。
We have known her for years.	私たちは彼女を何年も知っている。
We like music.	私たちは、音楽が好きです。
We looked about us.	我々は周りを見まわした。
We looked for her.	私達は彼女を探した。
We looked for it here and there.	我々はそれらをあちこちさがした。
We set out for home.	私たちは家路についた。
We were to have taken off at 4:30 p.m.	私たちは午後４時３０分に離陸するはずだったのだが。
We'd better go back a little.	少し戻ってみたらいいんじゃない。
We'll get to school soon; we are as good as there now.	もうじき学校に着くから、もう着いたも同じである。
We're goin' home.	やっと帰る気になったのさ。
We're goin' home.	家に帰るんだよ僕ら。
We're going to set off at four.	私たちは４時に出発するつもりです。
We're willing to help you.	私たちは喜んでお助けします。
Well, here we are at last!	やっと着いた。
Well, here we are at last.	ああやっと着いた。
Were you at school at that time?	その時あなたは学校にいましたか。
Were you to take it back?	君はそれを取り返すはずでしたか。
What about next Sunday?	今度の日曜日はどうですか。
What am I to do next?	次に何をしたらよいのですか。
What am I to do next?	次は何をしたらよいでしょうか。
What are you going to do next Sunday?	今度の日曜日には何をするつもりですか。
What are you into these days?	最近はどんな物に凝っているの？
What are you looking at?	何を見ているのか。
What are you looking at?	何を見ているのですか。
What are you looking at?	何を見てるの？
What are you looking at?	君は何を見ているのですか。
What are you looking for?	あなたは今何を探しているのですか。
What are you looking for?	あなたは何を捜しているのですか。
What are you looking for?	何を探しているの？
What are you looking for?	君は何を探しているのですか。
What are you reading?	何を読んでいるんですか。
What did he look up?	彼は何を見物したのか。
What did you buy it for?	何のためにそれを買ったのか。
What did you buy?	何を買ったのですか。
What did you do last Sunday?	先週の日曜日は何をしたの？
What do you like about her?	彼女のどこがいいのか。
What good will that do?	それが何の役に立つんだ。
What in the world are you doing?	いったいぜんたいあなたは何をしているのか。
What in the world are you doing?	いったい何をしているのか。
What in the world are you getting at?	一体君は何を言おうとしているんだい。
What in the world is this?	これはいったい何ですか。
What is over there?	何がそこにありますか。
What is the good of doing it?	そんなことをして何の役に立つのか。
What made her do so?	何が彼女をそうさせたのか。
What made her do so?	何で彼女はそんなことをしたのか。
What made her do so?	彼女はなぜそうしたのですか。
What price will you give for this?	いくらで買うか。
What school do you go to?	どこの学生ですか。
What shall I do next?	今度は何をしようか。
What shall I do next?	次に何をしましょうか。
What shall we do on your next days off?	今度のお休み何しようか。
What's that look for?	その顔は、どういう意味？
What's the good news?	何かいいことありませんか。
What's your day off?	店の休みの日はいつですか。
When are you going back to Italy?	イタリアへはいつ戻るのですか。
When are you off?	いつ出発するの？
When can I see you next time?	この次はいつ会えますか。
When did he get back?	彼はいつ帰ってきたのですか。
When did you buy it?	いつそれを買ったの。
When did you buy this video?	いつ、このビデオを買ったのですか。
When did you get back from London?	いつロンドンから戻りましたか。
When did you get back?	いつ帰って来たの？
When did you get back?	いつ戻ってきたの？
When did you see her last?	彼女を最後に見たのはいつですか。
When did you see her?	いつ彼女にあいましたか。
When did you see them first?	はじめて彼らに会ったのはいつですか。
When do you go back to Japan?	あなたはいつ日本へ戻られますか。
When is a good time for you?	いつが都合がいいですか。
When is school over?	学校はいつ終わりますか。
When will he be back?	いつ頃お戻りになりますか。
When will you be back?	あなたはいつ帰宅しますか。
When will you be back?	いつ帰ってくるの？
When will you be back?	何時お戻りになりますか。
When will you go back to Japan?	あなたはいつ日本へ帰られますか。
Which company do you work for?	どこの会社にお勤めですか。
Which company do you work for?	どちらの会社にお勤めですか。
Which do you like better, English or music?	あなたは英語と音楽とではどちらが好きですか。
Which do you like better, English or music?	英語と音楽どちらが君は好きですか。
Which do you like better, music or English?	あなたは音楽と英語のどちらが好きですか。
Which of the TV programs do you like best?	テレビの番組では何が一番お好きですか。
Which part of Boston are you going to?	ボストンのどこに行くのですか。
Who did you give it to?	君はそれを誰に上げたのですか。
Who helps her?	誰が彼女を手伝ってくれますか。
Who is it that you're working for?	誰のために働いているのか。
Who is this, please?	どちら様ですか。
Who knows that?	誰が知っているだろうか。
Who knows?	分からないよ。
Who knows?	誰が知るものか。
Who'd know that?	誰がそれを知ろうか。
Will you give me some?	少しくれませんか。
Will you go shopping with me?	私と一緒に買い物に行きませんか。
Will you go to America next year?	あなたは来年アメリカへ行くつもりですか。
Will you help them?	彼らを助けるつもりですか。
Will you look over my report?	私のレポートに目を通してくれませんか。
Will you please go there?	そこへ行っていただけませんか。
Will you please help me?	手伝っていただけませんか。
Will you please help me?	手伝ってもらえませんか。
Will you please help me?	私を手伝っていただけませんか。
Will you show me a map of the world?	世界地図を見せていただけませんか。
Will you show me on this map, please?	この地図で教えていただけますか。
Will you show me what you bought?	あなたが買ったものを見せてくれませんか。
Won't you go shopping with me?	一緒に買い物に行きませんか。
Won't you look in on us?	私たちのところに寄っていきませんか。
Would you like me to order it?	お取り寄せいたしましょうか。
Would you like to go shopping with me?	買い物一緒に行く？
Would you like to order?	ご注文なさいますか。
X is good for your health.	Xが体にやさしい
Yoko bought some of them.	洋子はそれらのいくつかを買った。
You are not going to make it in time for school.	学校に間に合わないよ。
You are only just in time.	かろうじて間に合いましたね。
You can find the page you are looking for.	お探しのページが見付かります
You can get a better look over here.	ここならもっとよく見えるよ。
You changed it?	変更した？
You don't go to school on Sunday, do you?	君は土曜日には学校へ行かないのですね。
You don't have to go to school on Sunday.	君は日曜日に学校に行く必要がない。
You don't know German, do you?	君はドイツ語を知らないんですね。
You don't like music.	あなたは音楽が好きではありません。
You go to school, don't you?	あなたは学校に行きますね。
You go to school.	あなたは学校へ行きます。
You have a message here.	伝言が届いております。
You haven't changed at all.	君はまったく変わっていないね。
You knew it wouldn't.	そんなの初めから分かってたじゃない。
You know I can't.	そんな事できないのあなた知ってでしょう。
You know about that, don't you?	御存知ですよね。
You know it better than me.	君のほうが私よりよく知っている。
You know some Japanese.	日本語が少し話せるからね。
You know what it is.	言わずもがなだ。
You know what?	聞いてよ。
You know who he is.	あなたは彼がだれだか知っている。
You may as well give up.	あきらめた方が良いのではないでしょうか。
You should have known better.	君はもっと分別を持つべきだったのに。
You should have seen the program on TV.	そのテレビを見るべきだったのに。
You should have seen the program on TV.	そのテレビ番組を見るべきだったのに。
You should know better now you are eighteen.	あなたは１８になったのだから、もっと分別があっても良い。
You should know better.	君はもっと分別をもちなさい。
You should know it.	自分でもわかってるくせに。
You should know what to read.	君たちは、何を読むべきかを知るべきです。
You should make good use of your time.	あなたは時間をうまく利用すべきです。
You should make good use of your time.	自分の時間をうまく使いなさい。
You should take a day off.	君は１日休暇をとった方がいい。
You shouldn't go to school.	学校は休んでください。
You were going to the school.	私は学校に行ってきました。
You were taken in by her.	君は彼女にだまされたのだ。
You will be taken to the product information/order page.	該当商品の紹介・購入ページへ移動します
You will have to go to England next year.	あなたは来年はイギリスへ行かなければならないでしょう。
You will just have to do with what you've got.	あなたは自分の持っているもので満足しなければならないだろう。
You will just have to do with what you've got.	手元にあるものでがまんしなければならないだろう。
You won't be in time for school.	あなたは学校に間に合わないでしょう。
You won't be in time for school.	君は授業に間に合いませんよ。
You'd better back off.	手を引いた方がいいよ。
You'd better go back home now.	もう家に帰ったほうがいいよ。
You'd better not see her now.	君は今は彼女と会わないほうがいいよ。
You'd better not see her now.	君は今彼女と会わない方がいいよ。
You're doing good work there.	君、ええ仕事をしてるな。
You're just on time.	時間どおりです。
You're looking good!	元気そうだね。
You're out of it.	お前、何だかボーっとしてるよ。
You're the only one who can do it.	君しかそれをできない。
You're the only one who can help me.	あなたしか僕を助けられる人はいないんだ。
You've changed.	君変わったね。
You've got to see her home.	彼女を家まで送らなきゃ。
Your Japanese is good.	日本語がお上手ですね。
Your o's look like a's.	君が書くｏはａに見えるね。
Yours is over there.	あなたのは向こうにあります。