I came to Japan to see Kyoto.	私が日本に来た目的は、京都を見物することです。
I'll show you the way.	私が道を教えましょう。
She had just come home when I called.	私が電話したとき、彼女はちょうど帰宅したところだった。
I was about to go out, when he came to see me.	私が出かけようとしていると彼がやってきた。
All I have is books.	私が持っているのは本だけです。
Ken was reading when I came home.	私が帰宅したとき、ケンは読書をしていた。
He came when I was out.	私が外出していたとき彼がやってきた。
You are the very man I want to see.	私が会いたいと思っているのはまさにあなたのような人だ。
You will think it just that I should do so.	私がそうするのは当然だと君は思うでしょう。
It took me three days to read this book.	この本を読むのに３日かかった。
Is there any mail for me?	私あてに手紙は来てますか。
Do your very best.	死力をつくしなさい。
Thought is free.	思想は自由だ。
I think he is a good man.	思うに彼は善人だ。
Have your own way.	思い通りにしなさい。
You can use my car, if you want to.	使いたければ私の車を使ってくれていい。
Are you through with your work?	仕事を終えましたか。
When I get through with my work, I'll call you.	仕事を終えたら電話します。
Have you got through with your work?	仕事を仕上げましたか。
I am through with my work.	仕事は終わりました。
Are you through with your work?	仕事は終わった?
I see you're doing very well in your business.	仕事でご活躍ですね。
Mr Yamada, you are wanted on the phone.	山田さんお電話です。
A Mr Sakaki has come to see you.	榊さんとかいう方がお見えになりました。
It was Jane who came first.	最初に来たのはジェインだった。
It was I that came here first.	最初にここに来たのは私です。
Sawako wants to go to France.	佐和子はフランスに行きたい。
Mr Sato called at eleven.	佐藤さんから１１時に電話がありました。
Don't phone her now.	今彼女には電話しないで。
To this day we call them Indians.	今日まで彼らはインディアンと呼ばれている。
Next time you come to see me, I will show you the book.	今度遊びに来たときに、君にその本を見せましょう。
What are you going to play?	今度は何を弾いてくれるんだ。
If you start now, you will get there in time.	今出発すれば、時間に間に合うようにそこにつくでしょう。
Start now, and you will get there in time.	今出発しなさい、そうすればそこに間に合って着くでしょう。
What are you learning at school?	今授業で何を習っていますか。
She will be there by now.	今頃彼女はそこにいるだろう。
May I come and see you now?	今君に会いに行ってもいいですか。
Where do you live now?	今何処に住んでいますか。
Where have you been?	今までどこに行っていたの？
Where have you been up to now?	今までどこにいたの。
Where have you been all this time?	今までずっとどこにいたの。
I have been reading this book.	今までこの本を読んでいたのだ。
I am not the man I was when you knew me first.	今の私は、あなたと初めて会ったころの私ではありません。
There's very little we can do now.	今となっては私たちができることはほとんどありません。
Not now, then when?	今でなければ一体いつだ？
I'm coming to you just now.	今すぐ、あなたのところへ行きますよ。
I have just read this book.	今この本を読んでしまったところだ。
I have just come here.	今ここに来たところだ。
It will be all better if you can come now.	今あなたに来てもらえるならなおよいのですが。
What if he comes back now?	今、彼が戻って来たらどうなるだろう？
I'm coming.	今、行くわ。
You had a phone call from Mr Takakura.	高倉さんから電話があったわよ。
You needn't go there if you don't want to go.	行きたくなければ、そこへ行かなくてもいいよ。
Don't go if you don't want to.	行きたくないのなら、行くな。
Go when you want.	行きたいときに行きなさい。
Do you want to go?	行きたいですか。
I'll think it over.	考え直してみるわ。
I'll have to think about it.	考えとくよ。
I'll think about it and get back to you.	考えて返事します。
Think about it.	考えてください。
I'll think about it.	考えておくよ。
There is less time than I thought.	考えていたほど時間はない。
I want to think about it.	考えさせて下さい。
I am from Hiroshima, but now I live in Tokyo.	広島の出身ですが、今住んでいるのは東京です。
You may come and go at will.	好きなように行き来していいですよ。
You can call me any time.	好きなときに電話してきていいよ。
Where do you come from?	御出身はどちらですか。
Would you come with me?	御案内しましょう。
The sale will be over in two days.	後二日でバーゲンがなくなる。
Come on out with it.	言っちゃえよ。
Where do you live now?	現在はどちらにお住まいですか。
In the end, he did not come.	結局、彼は来なかった。
How did it come out?	結果はどうなりましたか。
Shall I come for you?	迎えにきましょうか。
I had a very good time at Karuizawa.	軽井沢ではとても楽しかった。
I had to give up my plan.	計画をやめなければならなかった。
Our plan is made.	計画はできた。
The plan has worked well.	計画はうまくいった。
You needn't have come.	君は来なくてもよかったのに。
You are not coming, are you?	君は来ないんだね。
You are in my way.	君は僕の邪魔をしている。
You are to come with me.	君は僕と一緒に来るのだ。
You have to come with me.	君は僕と一緒に行かなければならないよ。
You'll come to like her.	君は彼女が好きになるだろう。
Do you live here?	君は当地に住んでいるのか。
It is high time you started a new business.	君は新しい仕事を始める時期だ。
It's time for you to buy a new car.	君は新しい車を買う時期ですよ。
You may use my new car.	君は私の新しい車を使ってもよい。
You're coming with us now.	君は今私たちと一緒に来るのだ。
You'd better start now.	君は今でかけた方がよい。
You had better call off your plan.	君は計画を中止したほうがよい。
You had better call off your plan.	君は計画を取りやめたほうがよい。
What do you learn?	君は何を学びますか。
What do you want to be?	君は何になりたいの。
You will have your own way.	君は何としても我を通そうとする。
What do you want?	君は何がほしい。
What a man you are!	君はなんという男だ。
Where do you live?	君はどこに住んでいるのですか。
Where were you?	君はどこにいたの？
How did you come to know her?	君はどうして彼女と知り合うようになったのか。
How did you come to know her?	君はどうして彼女と知り合いになったんだい。
You will have your own way.	君はどうしても自分の思いどおりにしたがる。
What have you come here for?	君はどうしてここへ来たのか。
You need not have bought the book.	君はその本を買う必要がなかったのに。
Did you do this on your own?	君はこれを自分一人でやったの。
Where did you go last Sunday?	君はこの前の日曜日にはどこへ行きましたか。
You can use this car.	君はこの車を使ってもいい。
You have only to come here.	君はここへ来さえすればよい。
Where are you from in Canada?	君はカナダのどこ出身なの？
You have done very well.	君はうまくやったよ。
When did you come to Japan?	君はいつ日本に来たのですか。
You have some books.	君はいくつかの本をもっています。
May I use your phone?	君の電話を借りていいか。
Where do you live?	君の住まいはどこですか。
What have you done with your car?	君の車どうしたんだい？
Where do you come from?	君の国はどこですか。
Where is your school?	君の学校はどこにありますか。
There's a phone call for you from Akemi.	君に明美から電話があったよ。
I want you to read this book.	君に本を読んでもらいたい。
You are wanted on the phone.	君に電話です。
I want you to go.	君に行ってもらいたい。
I wanted to show it to you.	君に見せてあげたかったよ。
I would like you to come with me.	君に一緒に来て欲しいのですが。
I want you to be the next Soseki.	君には第２の漱石になってほしいね。
What do you learn at school?	君たちは学校で何を学びますか。
Which of you came here first?	君たちのうち誰が最初にここに来たのですか。
Which of you came here first?	君たちのうち誰がはじめにここに来たのですか。
You are the man I've been looking for.	君こそ私が探していた人だ。
What is it that you want?	君が欲しいのはいったい何だ。
I want you.	君が欲しい。
What is it that you want me to do?	君が私にやってほしいというのは何ですか。
What is it that makes you think that way?	君がそんな風に考えるのはどうしてだい。
You wrote this book?	君がこの本を書いたって？
You come here.	君、ここへきなさい。
I'd like you to come at nine.	九時に来ていただきたいのですが。
I'll come and see you one of these days.	近いうちにお訪ねします。
I would like to call on you one of these days.	近いうちにお訪ねしたいと思います。
May I come to see you one of these days?	近いうちにあなたに会いに行ってもよろしいですか。
You have three cars.	貴方は、三台車を持っています。
I'd like some information about your new computers.	貴社の新しいコンピューターについての情報を、いくつかいただきたいのですが。
I would like to come and see you.	貴社にお伺いしたいと思います。
Look out! There's a car coming.	気を付けろ。車が来ているぞ。
Look out! There's a car coming.	気を付けろ！車が来るぞ。
In the car on the way home, he was making plans for the next day.	帰宅途中の車のなかで、彼は翌日の計画を立てた。
I may have to come home late; if I do, I'll call you.	帰宅が遅くなるかもしれない。その場合は電話する。
Can you find your way home?	帰り道は分かりますか。
Come on, Shougo. You can do it.	頑張るのよ省吾、あなたなら出来るわ。
Korea is now up and coming.	韓国は今や活気づいている。
I didn't think you were going to make it.	間に合わないのではないかと心配していた。
Do you think we can get there in time?	間に合うと思いますか。
I have lived in Kamakura for twelve years.	鎌倉に住んで１２年になる。
He was very learned, but he didn't know it.	学識があるにもかかわらず彼はそれを知らなかった。
School starts next Monday.	学校は今度の月曜に始まる。
Where do you go to school?	学校はどちらですか。
School starts in April.	学校が始まるのは４月です。
I have just come back from school.	学校から帰ってきたところだ。
When she saw that they had no schools, she started one.	学校がないのを知ると自分で学校を開いた。
Come off it!	格好つけるな。
May I go out to play?	外に遊びに行ってもいいですか。
We're on our way home.	懐かしい家に帰るんだ。
My company is sending us all to Hakone this year.	会社の慰安旅行で箱根に行きます。
We learn to read and write.	我々は読み書きをならう。
We work for our living.	我々は生活のかてを得るために働く。
We didn't want to go, but we had to.	我々は行きたくは無かったが、行かなければならなかった。
We ordered some new books from England.	我々は何冊かの新しい本を英国に注文した。
We all had such a good time.	我々はみんなとても楽しく過ごした。
There has been a change of plans.	我々の計画に変更があった。
I'll give you a call when I get home.	家に着いたら君に電話するよ。
I did some shopping for Christmas on my way home.	家に帰る途中でクリスマスのための買い物をした。
Come over!	家においでよ。
I live in Kakogawa.	加古川に住んでいます。
Who do you think you are?	何様だと思ってるんだ。
What make of computer do you use?	何社製のコンピューターをお使いですか。
What time can you come?	何時に来れますか。
When will you come home?	何時に帰ってくるの。
What time shall I come?	何時にお伺いいたしましょうか。
I ordered some new books from America.	何冊かの新刊書をアメリカに注文した。
What do you think you're doing?	何を考えてんだ？
What are you thinking about?	何を考えているの？
What shall we play?	何をして遊ぼうか。
What do you want to do?	何をしたいんですか？
What do you do for a living?	何の仕事をしているのですか。
What do you want?	何の用だ。
What do you learn English for?	何のために英語を学ぶのですか。
What have you come here for?	何のためにここに来たのですか。
What do you want?	何のご用ですか。
What's my book doing here?	何だって私の本がこんなところにあるんだろう。
Have you thought of any good plans?	何か良い計画を思い付きましたか。
What do you want?	何が欲しいですか。
Have you got any plans?	何か予定はあるの？
I thought you had come on business.	何か用事でおいでになったかと思いました。
What do you want me to do?	何か御用ですか。
Do you have a plan?	何か計画がありますか。
What do you want to do?	何がしたい？
What made you come here?	何があなたをここに来させたのか。
I am a man.	俺は人間だ。
I'm a free man.	俺は自由な男。
I'm living in the city.	俺は今、都会に住んでいる。
I think it's OK.	俺はいいと思う。
I'd like to see a play. Do you have any information?	演劇がみたいのですが情報をください。
What do you think is the best way to learn English?	英語を身につける最良の方法は何だと思いますか。
What is the best way to learn English?	英語を学ぶ最良の方法は何ですか。
The best way to learn English is to go to America.	英語を学ぶのはアメリカへ行くのが一番よい。
I don't think that there is any better way to learn English than by living in America.	英語を学ぶにはアメリカに住むのが一番だと思う。
You should read books written in English.	英語で書かれた本を読みなさい。
Do you have a book written in English?	英語で書かれた本を持っていますか。
Learn a little at a time.	一度に少しずつ学びなさい。
Won't you come with me?	一緒に来ませんか。
You can come with me.	一緒に来てもいいよ。
Come with me, will you?	一緒に来てくれませんか。
Would you play with me?	一緒に遊ばない？
Won't you come with me?	一緒に行きませんか。
I'm coming with you.	一緒に行きます。
Where there's a will, there's a way.	意志のあるところに道あり。
Where there's a will, there's a way.	意志のあるところには道がある。
Where there's a will, there's a way.	意志があるところに道は開ける。
Where there's a will, there's a way.	意志ある所に道あり。
There is a Mr Ito who wants to see you.	伊藤さんという人がお目にかかりたいそうです。
Show me the way, will you?	案内してくれますか。
I want to go with you.	一緒に行きたいな。
I would be very pleased to go with you.	わたしはほんとうにごいっしょに行きたいと思います。
I'm learning how to type.	わたしはタイプの打ち方を習っている。
I wanted to go there.	わたしはそこへ行きたかった。
I took it that you would come.	わたしはあなたが来るものと考えていた。
It is the car that we have wanted.	わたしがずっと欲しがっていたのは、その車です。
How good of you to come all the way to see me off!	わざわざのお見送り本当にありがとう。
I ordered a book from London.	ロンドンから本を注文した。
Last call!	ラスト・オーダーは締め切らせていただきました。
You may come if you like.	よろしかったら来てもいいですよ。
School starts in September in Europe.	ヨーロッパでは学校は９月に始まる。
Where there's a will, there's a way.	やる気があれば方法は見つかるもの。
You should have started by now.	もっと早くはじめるべきだったのに。
If you can, come with us.	もし来れたら、私たちと一緒に来なさい。
If she'd set off now, she would make it on time.	もし彼女が今出発するなら、間に合うのですが。
You may take the book if you can read it.	もし読めるのなら、その本を持っていってよろしい。
If I had known about it, I would have changed my plan.	もし私がその事を知っていたら、計画を変更していただろう。
If I had known about it, I would have changed my plan.	もし私がそのことを知ったら、計画を変更していただろうに。
Were I free from work, I could read these books.	もし仕事がなく暇なら、私はこれらの本を読めるのだが。
You can go if you want to.	もし行きたければ行ってもよろしい。
I don't want to go if you don't go with me.	もし君が私と一緒に行かないのなら、私は行きたくない。
You may go home if you want to.	もし帰宅したければ帰ってよい。
If he has time, he will come.	もしひまがあれば、彼は来るでしょう。
I should be very pleased if you could come.	もしあなたが来ることができればうれしいのですが。
I'll think about it.	もう少し考えてみます。
I'd better be on my way.	もう帰らなくてはなりません。
Have you got any plans?	もう何か予定がはいっているのかい。
It's about time to start.	もうそろそろ出発の時間です。
There's no other way than this now.	もうこれよりほかに手はない。
I'm through with you.	もうお前なんか相手にしないぞ。
Mary is such a worrywart.	メアリーは本当に心配症ね。
Mary came up to me when she saw me.	メアリーは私を見ると近づいてきた。
Mary has just come home.	メアリーはただいま戻ったところです。
I'm through with Mary.	メアリーとはもう終わったんだ。
In came Mary.	メアリーが入ってきた。
All of us are working on the case.	みんなでその事件に当たっている。
A Mr. Marconi wants to see you.	マルコーニさんとかいう人がご面会です。
Mayuko called me back.	マユコは私を呼び戻した。
Mac knows how to use this computer.	マックはこのコンピューターの使い方を知っている。
Oh, come on.	またそんなこと言って。
I'll call you some other time.	またいつか電話します。
First of all, I have to call on Jim.	まず第一に私はジムを訪ねなければならない。
To start with, who is that man?	まず第一に、あの男性は誰ですか。
First came the Celts in 600 B.C.	まずやって来たのはケルト族で、紀元前６００年のことでした。
Where would you like to go first?	まずどこに行きたいですか。
Write your name, first of all.	まず、第一に名前を書きなさい。
First of all, you have to read this book.	まず、初めに、この本を読まなければならない。
Masao won't come here, will he?	まさおはここに来ないでしょうね。
You are wanted on the phone, Mike. It's Jane.	マイク、電話ですよ。ジェインからですよ。
Oh, come off it.	まぁ、そんなに格好つけるのやめとけよ。
I'll give it some thought.	ま、考えときましょう。
Hong Myong Bo is a great player.	ホンミョンボはすばらしいプレイヤーです。
The price of books is getting higher these days.	ほんの値段が近頃上がってきている。
Here she is!	ほら彼女がいますよ。
Here he comes.	ほら彼がこちらに来るよ。
There she comes.	ほら、彼女がやってくるよ。
It's starting now.	ほら、始まるわよ。
Here comes Jane. Do you know her?	ほら、ジェーンが来る。彼女を知っているか。
Bob wasn't in on the plan.	ボブはその計画には関与しなかった。
Bob came here, didn't he?	ボブはここに来たんですね。
I don't know when Bob came to Japan.	ボブがいつ来日したか分からない。
Where's the information center for hotels?	ホテルの案内カウンターは、どこですか。
Is there a book store in the hotel?	ホテルに本屋はありますか。
You can come with me.	僕と一緒に来てもいいよ。
No other man could do my work.	ほかの人は私のやっていることが出来ないだろう。
Henry wants to see you.	ヘンリーさんという方があなたにお目にかかりたいとおっしゃっています。
Helen came to Japan last year.	ヘレンは昨年日本に来た。
Fred took a liking to Jane and started dating her.	フレッドはジェーンが好きになり、彼女と付き合い始めた。
She might not know that we are here.	ひょっとすると彼女は私たちがここにいることを知らないのかもしれない。
How do you like living on your own?	ひとり暮しはどうですか。
I'm thinking of going to Paris.	パリへ行ってみようかなと思っています。
Where is Paris?	パリはどこにありますか。
Paris is the center of the world, in a way.	パリはある意味で、世界の中心である。
Who wrote Hamlet?	ハムレットは誰が書いたのですか。
Play the part of Hamlet.	ハムレットの役を演じろ。
Ned comes from the state of Utah.	ネッドはユタ州の出身。
Nancy did some shopping on the way.	ナンシーは途中で買い物をした。
I don't think so.	ないと思うけど。
Any book will do.	どんな本でも結構です。
What line of work are you in?	どんな職業に就いていますか。
Come what may, you should go your own way.	どんな事があろうとも、君は自分の思いどおりにやるべきだ。
Which is your book?	どれが君の本ですか。
Tom wants to go to Japan.	トムは日本に行きたがっている。
Tom came home just now.	トムはたった今帰宅したところだ。
Tom lived in Japan for ten years.	トムは１０年間日本に住んだ。
How do you want them?	どのように両替いたしましょうか。
How did it come about?	どのようにしてそれは起こったの。
How did you come here?	どのようにしてここに来たのですか。
What would you like to be called?	どのようにお呼びしたらよろしいでしょうか。
In any case, it's no business of yours.	とにかく、君の知った事じゃない。
In any case, you should come up to Tokyo.	とにかく、きみは上京すべきだ。
Tony is playing.	トニー君は遊んでいます。
Tony lives in Kobe.	トニー君は神戸に住んでいます。
Where is Tony playing?	トニー君はどこで遊んでいますか。
Where was Tony playing then?	トニー君はその時どこで遊んでいましたか。
Where's Tony?	トニーはどこだ。
You've been very good to me.	とても親切にしていただきました。
It's very good.	とてもいいよ。
Which way shall we go now?	どっちの方に行くとよいかな。
Who is calling, please?	どちら様でしょうか。
Which way should I go?	どちらへ行けばよいですか。
Where would you like to go?	どちらへ行きたいですか。
Which book is better?	どちらの本がよいですか。
Which book is yours?	どちらの本があなたのものですか。
Which way will you take?	どちらの道を行きますか。
Do you know which way to take?	どちらの道に行くべきかわかりますか。
Where do you come from?	どちらのご出身ですか？
Where are you going?	どちらに行くのですか。
Where do you live?	どちらにお住まいですか。
Where are you going?	どちらが先に行くのですか。
One way is not better than the other.	どちらかが他方よりいい、というのではない。
Which is your book, this one or that one?	どちらがあなたの本ですか、この本それともあの本。
By the way, where are you from?	ところであなたはどこの出身ですか。
By the way, where do you live?	ところで、君はどこに住んでいるの。
By the way, what time will you go there?	ところで、何時にそこへ行くつもりですか。
By the way, where do you live?	ところで、お住まいはどちらですか。
By the way, what do you do?	ところで、あなたの仕事は何ですか。
Where have you been?	どこへ行っていたのですか。
I don't know where to go.	どこへ行ったらよいのかわからない。
Where are you going?	どこへ行くの？
Where do you want to go?	どこへ行きたいの？
Where do you come from?	どこのご出身ですか。
Where do you live?	どこに住んでいるんですか。
Where can I get some help?	どこに行ったら助けてもらえますか。
Where are you going?	どこに行きますか。
Where should we go?	どこに行きましょう？
Where do you want to go?	どこに行きたいの？
Where are you going?	どことどこへ行く予定ですか。
Where would I find books?	どこで本が買えますか。
Where did you get to know her?	どこで彼女と知り合いになったのか。
Where do you work?	どこで働いてるの？
Where did you get it?	どこでそれを手に入れたのですか。
Where did you find it, at school or at home?	どこでそれを見つけたの、学校、それとも家で？
Where would I find CDs?	どこでＣＤが買えますか。
Where did you come from?	どこから来られましたか。
Please write to me from time to time.	ときどきは手紙を書いてね。
Now and then, we go to London on business.	ときどき、私たちは商用でロンドンへ行く。
There's no way I can make it up to you.	どう埋め合わせしたら良いかわかりません。
Now, what do you think?	どう思う？
How did you come to know her?	どうゆうふうにして彼女と知り合ったのですか。
How did he come here?	どうやって彼はここに来たのですか。
How did you come to school?	どうやって学校に来ましたか。
How do you plan to get home?	どうやって家に着くつもりですか。
How did you come here?	どうやってここへ来られましたか。
Please come in one by one.	どうぞ一人ずつお入りください。
Please come in.	どうぞなかへおとおりください。
Please come this way.	どうぞこちらへおいで下さい。
Please get into the car.	どうぞお乗り下さい。
Please think about it.	どうぞお考え下さい。
Please come in.	どうぞ、お入り下さい。
How did you come to know her?	どうして彼女と知り合いになったのかい。
How come you aren't taking me?	どうして私をつれていってくれないの。
How should I know where he is?	どうして私が彼の居場所を知っていようか。知るはずがない。
How should I know where he is?	どうして私が彼の居場所を知っていようか。
How did you come to know it?	どうして君はそれを知るようになったのですか。
How come you are here?	どうして君がここにいるの？
How come you don't know this?	どうして君、このことを知らないのかね？
I do want to go to Italy.	どうしてもイタリアへ行きたい。
What makes you think that way?	どうしてそんな風に考えるのですか。
What makes you think so?	どうしてそのように考えられるのですか。
What do you learn Spanish for?	どうしてスペイン語を学ぶのですか。
What did you come here for?	どうしてここへ来たのですか。
How did you end up on your own?	どうしてあなたは一人になったの？
What made you think so?	どうしてあなたはそう考えたのですか。
Do come in, please.	どうか、ぜひお入りになってください。
When did you come back from Germany?	ドイツからいつ帰国しましたか。
Terry was very pleased with the news.	テリーはその知らせに大変喜びました。
Oh, but this is great.	でも素敵だわ。
But we're just on our way home.	でもこれから帰るところさ。
But you will write, won't you?	でも、手紙を書いてよね。
Then who?	では誰ですか。
Then who are you? Are you Elijah?	では、いったい誰ですか。あなたはエリヤですか。
I am come to offer what service may be in my power.	できるだけお役に立ちたいと思ってやってきました。
Who started Disneyland?	ディズニーランドをはじめたのは誰ですか。
At last he came to.	ついに彼は息を吹き返した。
At last, he came.	ついに彼はやって来た。
At last, he got the car.	ついに彼はその車を手にいれた。
Come over and help out.	ちょっと来て手伝って。
Come here.	ちょっと来て。
I would like to make a phone call.	ちょっと電話をかけたいのですが。
Do you want to look into it?	ちょっとのぞいてみないかい。
I was about to start.	ちょうど出発しようとしていた。
He came in just as I was going out.	ちょうど私が出かけようとしていたときに、彼が入ってきた。
This is the very book you wanted.	ちょうど君が欲しがっていた本だ。
Just then she was called to the phone.	ちょうどその時彼女は電話に呼ばれた。
Dan bought a new computer.	ダンは新しいコンピューターを買った。
Dan came for Julie at six.	ダンは６時にジュリーを迎えに来た。
No one man could do it.	だれでも一人でそれはできないだろう。
Who wrote this book?	だれがこの本を書いたのですか。
Who made this plan?	だれがこの計画を立てたのですか。
They live there.	だって２人ともそこに住んでいるんですもの。
I've just come back.	たった今帰ったところだ。
Have you read the article about Asia in Time?	タイム誌のアジアについての記事を読んだかい？
You can type, can't you?	タイプは打てますね。
Do not read such a book.	そんな本読むな。
That's how I came to know her.	そんな風にして私は彼女と知り合ったのだ。
Don't look at me that way.	そんなふうに私を見ないでください。
It's about time to start.	そろそろ出発時間だ。
Send it by mail.	それを郵便で送ってくれ。
Will you send it by mail?	それを郵送してくれますか。
Where did you get this?	それを何処で手に入れたの。
Get them out of the way.	それらを邪魔にならないところに置いてください。
They aren't my books.	それらは私の本ではない。
They are our cars.	それらは私たちの車です。
It is a book.	それは本です。
It is of great use.	それは非常に役に立つ。
That was of great help to me.	それは大いに私の役に立った。
That is not the case.	それは真相ではない。
That's not the case.	それは事実とは違う。
That is not my line.	それは私の得意ではない。
I think it's the best way.	それは最高の方法だと思う。
That is the other way about.	それは逆だ。
Isn't that an English book?	それは英語の本ではありませんか。
How did it all come about?	それは一体どうして起きたの。
It was just as I thought.	それはまったく私が考えたとおりだ。
How did it come about?	それはどのようにして起こったのか。
That was so good a book that I read it three times.	それはとても良い本だったので、私は３回読みました。
How did it come about?	それはどうして起こったのですか。
It came about in this way.	それはこのようにして起こった。
This is how it all came about.	それはこのようにして起きた。
That's what we call an "otoshidama".	それはいわゆる「お年玉」でした。
What do you think of it?	それの感想は？
They learned all there was to know about it.	それについて知っておくべきことの全てを彼らは学んだ。
I'll give you a day to think about it.	それについて考える時間を一日あげますよ。
She had no way to know about it.	それについては知る由もなかった。
What do you think about it?	それについてはどうお考えですか。
What'll they think of next?	それって、すごいじゃないの。
It is all I want to do.	それだけがわたしの望み。
That was the time when he came.	それが彼がきた時間だ。
That is what I want to know.	それが知りたい。
I do want it.	それが是非欲しい。
That is the way of the world.	それが世の習いです。
That's what we want to know.	それが私達の知りたいことです。
That's the best way we can do now.	それが私たちが今できる最善の方法だ。
That is what I have wanted to buy.	それが私が買いたかったものです。
That is how I learned English.	それが私が英語を学んだ方法です。
I think it's the best way.	それが最善の方法だと思う。
That's the way it is.	それが現実だ。
What did you do then?	それから君はどうしたのか。
And then the Romans came in 55 B. C.	それから、紀元前５５年にはローマ人が来ました。
That is just her way.	それがまさに彼女の癖です。
I don't know where it is.	それがどこにあるのか私は知りません。
There! She comes!	そら、彼女が来るよ。
Please send the book by mail.	その本を郵便で送ってください。
I'll send the book by mail.	その本を郵便でお送りします。
You've read through the book, haven't you?	その本を読んでしまったのでしょう。
Please read that book.	その本を読みなさい。
Didn't you read the book?	その本を読まなかったのですか。
Did you order the book?	その本を注文しましたか。
You may take the book.	その本を持っていってよい。
Give the book back to the owner.	その本を持ち主に返しなさい。
Give me the book.	その本をとってくれ。
Where did you buy that book?	その本をどこで買ったのですか。
Are you through with the book?	その本は読み終えましたか。
Who was the book written by?	その本は誰によって書かれましたか。
Have you done with the book?	その本はもう読み終えたのかい。
I have not read all the books.	その本はどれも読んでない。
Where is the book?	その本はどこにありますか。
The price of the book was $5.	その本の値段は５ドルでした。
What do you think about the book?	その本についてどう思いますか。
That day shall come.	その日はやってくるであろう。
I'm just living from day to day.	その日その日を生き抜くのがやっとだ。
I can not get the message through to her.	その伝言を彼女にわからせなかった。
That's the way.	その調子だよ。
Where can I get the map?	その地図はどこで手に入りますか。
But for the map, we could not have found the way.	その地図がなかったら、私たちは道が分からなかっただろう。
The man's name was Francisco Pizzaro.	その男の名前はフランシスコ・ピサロだった。
The man looked at me.	その男の人は私を見た。
The new product is on sale.	その新製品は発売中だ。
The new car is hers.	その新しい車は彼女の物です。
The information is in a file in my computer.	その情報は私のコンピューターのファイルに入っている。
The car looked good as new.	その車は新品同然にみえた。
What was he up to then?	その時彼は何をたくらんでいたのか。
I was at home then.	その時私は家に居ました。
I didn't know what to do then.	その時はどうすべきかわかりませんでした。
See you then.	その時に会いましょう。
What were you doing then?	その時あなたは何をしていたのですか。
What were you doing then?	その時あなたたちは何をしていたのですか。
What were you doing then?	その時あなたたちはいったい何をしていたのですか。
Are you through with the work?	その仕事をもう終えましたか。
The work was well done in a way.	その仕事はある意味では立派に成された。
What do you think should be done about it?	その件についてどうすべきだと思いますか。
I'm thinking of the plan.	私はその計画を考えています。
How will the plan work out?	その計画はどうなるだろう？
The plan will work out.	その計画はうまくいくだろう。
Would you take part in the project?	その計画に参加して頂けませんか。
Would you take part in the project?	その計画に参加させてもらえませんか。
Read through the article.	その記事を最後まで読みなさい。
Don't look at me that way.	そのように僕を見つめないでくれ。
There are such shops about.	そのような店はあちらこちらにある。
I was eighteen then.	そのとき私は１８歳だった。
I am very pleased at the news.	そのしらせでとてもうれしい。
The system is working very well now.	そのシステムは現在とてもうまく動いている。
The computer is of great use.	そのコンピューターは非常に役立つ。
The computer is new.	そのコンピューターは新しいです。
The computer is up to date.	そのコンピューターは最新式だ。
You will learn how to do it in time.	そのうちやり方がわかるよ。
Which of the two books did you like better?	その２冊の本の中でどちらの方が好きでしたか。
And so the man came in.	そして、そこでその男は入ってきました。
There is no one who wants to go there.	そこへ行きたがる人は誰もいない。
Call me up when you get there.	そこに着いたら私に電話をしなさい。
Call me up when you get there.	そこについたら私に電話しなさい。
Don't you think so?	そう思わない？
Do you think so?	そう思うかい？
Don't you think so?	そう思いませんか。
Some do think so.	そう考える人もたしかにいる。
I can not but think so.	そう考えざるを得ない。
That is how she learns English.	そうやって彼女は英語を学んでいる。
No, I don't think so.	そうは思えないねえ。
I don't think we should do that.	そうするべきではないと思う。
Such being the case, I can not go with you.	そういうわけで、ご一緒できません。
Such being the case, I can't go with you.	そういうわけだから、私は君と一緒に行けないのだ。
Mr Smith has lived in Kyoto for three years.	スミスは３年間京都に住んでいる。
Mr Smith lives in Kyoto now.	スミスさんは今京都に住んでいる。
A Mr Smith has come to see you.	スミスさんとか言う方が見えています。
Mr. Smith has come.	スミスさんが来ました。
Not all books are good books.	すべての本が良い本というわけではない。
It all started in Montgomery, Alabama, on December 1, 1955.	すべての発端は、１９５５年１２月１日、アラバマ州モントゴメリーで起こった事件であった。
Steve did not come home.	スティーブは帰宅しなかった。
I've been thinking about it.	ずっと考えてたの。
I'm coming.	すぐ参ります。
John has a car made in Japan.	ジョンは日本製の車をもっている。
John started the car.	ジョンは車のエンジンをかけた。
John called me names.	ジョンは私に悪態をついた。
John lives in New York.	ジョンはニューヨークに住んでいる。
Is John available now?	ジョンとお話したいのですが。
John and Ann like each other.	ジョンとアンは互いに好意を持っている。
If John had of come, I needn't have.	ジョンがきていたなら、私は来る必要はなかった。
I'll call on you, John.	ジョン、君にあてよう。
Where's the shopping center?	ショッピングセンターはどこですか。
Joe was pleased at the thought of going to New York.	ジョーはニューヨークに行くことを考えると嬉しかった。
George has two cousins; one lives in Germany and the other in Switzerland.	ジョージにはいとこが２人います。１人はドイツに、もう１人はスイスに住んでいます。
I don't know if George is coming.	ジョージが来るかどうか知りません。
Then what?	じゃあ何？
Jack has been living in New York for six years.	ジャックは６年前からニューヨークに住んでいます。
See you then.	じゃあその時に。
All but Jim came.	ジム以外全員が来た。
Jim has learned to like Japan.	ジムは日本が好きになった。
Where is Jim?	ジムはどこ？
Do you know where Jim and Nancy are?	ジムとナンシーがどこにいるか知ってる？
Give me some time to think it over.	しばらく考えてみたいので時間をください。
But no man could help me.	しかし誰も私を助けてくれなかった。
But I want a car.	しかし、車は欲しい。
But now I live in Tokyo.	しかし、今住んでいるのは東京です。
Jane comes from Australia.	ジェーンはオーストラリアの出身だ。
You come here, Jane, and you go over there, Jim.	ジェーン、君はここに来い、そしてジム、君はあそこへ行け。
I want to go to Seattle.	シアトルに行きたい。
Now there was a man of the Pharisees named Nicodemus.	さて、パリサイ人の中にニコデモという人がいた。
Come on, Ken.	さあ行こう、ケン。
Do come in!	さあどうぞお入りください。
Come on! I will best you.	さあこい！負かしてやる。
Come on in!	さあ、入って入って。
Come on, get up.	さあ、起きなさい。
Come on, Tony.	さあ、トニー。
Please call me up if you want me.	ご用のときはお電話ください。
Do come if you can!	ご都合がつけばぜひ来て下さい。
What line of work are you in?	ご商売は何ですか。
Where are you from?	ご出身はどこですか。
Computers are used to send messages by e-mail.	コンピューターは電子メールでメッセージを送るのに使われる。
Computers are of great use.	コンピューターはとても役に立ちます。
What is the good of reading such books?	こんな本を読んで何になるのか。
It is no use reading such a book.	こんな本は読んでも無駄だ。
Do it this way.	こんな風におやりなさい。
Will I make it through?	こんな自分から抜け出せるのか。
I haven't had such a good time in years.	こんなに楽しいことは数年無かった。
You have all these books!	こんなにたくさん本を持っているのか。
I would be very pleased if you did this for me.	これを私のかわりにしていただけたらとてもありがたいのですが。
This we can call a work of art.	これを私たちは芸術品と呼ぶ。
Don't you think Tanaka is the one who did it?	これをやった犯人は、田中君だね？
Will you type this, please?	これをタイプしてくれませんか。
These are our books.	これらは私達の本です。
These are my books.	これらは私の本です。
What good books these are.	これらは、なんと良い本なのだろう。
Read these books, or at any rate this one.	これらの本を読みなさい、少なくともこの本は。
How did you come by these books?	これらの本をどうやって手にいれたのですか。
These books are new.	これらの本は新しい。
These books are my books.	これらの本は私の本です。
Are these books Kenji's?	これらの本は健二のものですか。
These books can be had at that store.	これらの本はあの店で買えます。
Do you want any of these books?	これらの本のうちで欲しいものはありますか。
These articles are not for sale.	これらの品物は非売品です。
These new cars are on sale.	これらの新車は売り出し中です。
These goods are available to members only.	これらの商品は会員だけが利用できる。
These cars are made in Japan.	これらの車は日本で作られています。
These photos have come out very well.	これらの写真は、たいへんよく出来上がりました。
This is a book.	これは本です。
This isn't for sale.	これは非売品です。
This is her book.	これは彼女の本です。
This is the car made in Japan.	これは日本で作られた日本製の車です。
This is a book to read.	これは読むべき本だ。
How did all this come about?	これは全てどのようにして起こったのですか。
This is my book.	これは私の本です。
This is just the way I like it done.	これは私の好みにぴったりです。
This is what I wanted.	これは私が欲しいと思った物です。
This is the book I've been looking for.	これは私が探していた本だ。
This is the very video I have been looking for.	これは私が探していたまさにそのビデオです。
This is a book about England.	これは英国についての本です。
This is a good book, but that one is better.	これはよい本ですが、あの本の方が良いです。
This is the very book that I wanted to read.	これはまさに私が読みたかった本だ。
This is Tony's book.	これはトニーの本です。
This is very good.	これはとても美味しい。
This is a very new book.	これはとても新しい本です。
This is just what I wanted.	これはちょうど私がほしいと思っていたものです。
This is the very best way to do it.	これはそれを行うまさに最良の方法です。
Is this your car?	これはきみの車ですか。
Is this your book?	これはあなたの本ですか。
This is your book.	これはあなたの本です。
Is this your car?	これはあなたの車ですか。
This is the end.	これで終わりです。
This is what I want.	これこそ私の欲しいものです。
This is the very book that I want to read.	これこそ私の読みたい本である。
This is the very book I have been looking for.	これこそ私が探していた本だ。
This is the very CD I've been looking for.	これこそ私が探していたCDです。
This is the very book for you to read.	これこそ君達が読むべき本だ。
That's just what I wanted.	これこそ求めていたものですよ。
This is the very video I wanted to see.	これこそまさに私の見たかったビデオだ。
This is the very book I have been looking for.	これこそまさに私が探していた本です。
This is the very book I have been looking for.	これこそまさしく私がさがしていた本です。
This is the very book I have been looking for.	これこそが私が捜していた本だ。
This will be the book he is looking for.	これが彼の探している本だろう。
This is the way he learned English.	これが彼が英語を覚えた方法である。
Can you get this, man?	これが届くと思うか。
This is a new type of car.	これが新型の車です。
This is what we want to know.	これが私達の知りたいことである。
This is my car.	これが私の車です。
This is what I thought.	これが私の考えたことです。
This is what we want to know.	これが私たちの知りたい事です。
This is the book which you are looking for.	これが君の探している本です。
This is how I learned English.	これがわたしが、勉強をした方法だ。
This is just what I wanted.	これがまさに私の欲しかったものです。
This is just the type of car I want.	これがちょうど私の欲しい型の車だ。
This is just what I wanted.	これがちょうど私が欲しかったものです。
This is what we call "tempura".	これがいわゆる「天ぷら」というものです。
This will be the book you are looking for.	これがあなたのさがしている本でしょう。
This is how I learned English.	これが、私が英語を勉強した方法だ。
Is this your book, Mike?	これ、あなたの本なの、マイク？
You can read this book.	この本を読んでもいい。
May I go out to play when I have read this book?	この本を読んでしまったら遊びに行っていい？
It took me three days to read through this book.	この本を読み終えるのに私は３日かかった。
Read this book.	この本を読みなさい。
It took me three days to read through this book.	この本を読みあげるのに３日かかった。
Please buy me this book.	この本を私に買って下さい。
Please give me this book.	この本を私に下さい。
I bought this book at Kakuzen's.	この本を角善で買った。
May I have this book?	この本をいただいてもいいですか。
I will give you this book.	この本をあなたにあげましょう。
This book will be printed next year.	この本は来年印刷されるでしょう。
This book is hers.	この本は彼女の物です。
This book is not for sale.	この本は売り物ではありません。
This book is not available in Japan.	この本は日本では手に入らない。
You had better not read this book.	この本は読まないほうがよい。
This book was new.	この本は新しかった。
This book is new.	この本は新しい。
This book will be of great use to us.	この本は私たちにとても役立つだろう。
Is this book Takeo's?	この本は健夫のものですか。
Is this book yours?	この本は君のですか。
This book is of great use to us.	この本は我々に役にたつ。
What is the book about?	この本は何について書いてあるのですか。
This book was printed in England.	この本は英国で印刷された。
This book is written in English.	この本は英語で書かれています。
I bought this book for less.	この本はもっと安い値で買った。
Are you through with this book?	この本はもうお済みですか。
Are all these books yours?	この本はみなあなたの物ですか。
This book was written by Haley.	この本はヘイリーが書いた。
This book is Tony's.	この本はトニーの物です。
This book is very new.	この本はとても新しいです。
This book is a little out of date.	この本はちょっと時代おくれだ。
This book is available at one shop only.	この本はただ一軒の店でだけ入手できる。
This book is of great use.	この本はたいへん有益である。
This book is yours.	この本はきみのだよ。
Do you need this book?	この本はいりますか。
Is this book yours?	この本はあなたの物ですか。
This book will be of great use to you.	この本はあなたに大いに役立つだろう。
What is written in the book?	この本には何が書いてあるのですか。
It's this book.	この本です。
This book will do.	この本でいいよ。
I would like this book.	この本がいただきたいのですが。
Do you know this part of the city very well?	この辺はよくごぞんじですか。
This article is for sale.	この品物は売り物です。
This city is called the Japanese Denmark.	この都市は日本のデンマークと呼ばれている。
What is the area of this city?	この都市の面積はどれくらいか。
This order has just come in over the phone.	この注文は今電話で入ったところです。
This used car is for sale.	この中古車は売り物です。
This used car is as good as new.	この中古車は新車同様である。
She looked well when I last saw her.	この前会った時彼女は健康そうだった。
The last time I saw Kent, he was very well.	この前ケントに会ったとき、彼はとても元気でした。
Where is the end of this line?	この線の終点はどこですか。
What will come?	この先どうなるの。
This system will work well in nine cases out of ten.	この制度は十中八九うまくいくだろう。
When did the world come into being?	この世界は何時生じたのか。
We don't know when this world came into being.	この世がいつ出現したのかわかってない。
Can you mail these for me?	この手紙を出していただけますか。
The car is at your service.	この車を自由にお使い下さい。
This car is made in Japan.	この車は日本製です。
This car was made in Japan.	この車は日本で作られました。
This car won't start.	この車は動かない。
This car is as good as new.	この車は新品同様だ。
This car is like new.	この車は新車同様だ。
This car is out of date.	この車は時代遅れです。
The price of this car is very high.	この車の価格はとても高い。
How did you come to know this?	この事をどのようにして知ったのか。
I've been in that line of work for five years.	この仕事を５年ほどやっています。
I don't think I can get through all this work by five.	この仕事を５時までに全部は終えられないと思う。
This play has ended.	この公演はもう終わりました。
What do you think of this plan?	この計画をどう思いますか。
What do you think of this plan?	この計画はどう思いますか。
This plan is good in some ways.	この計画はいくつかの点でよい。
What do you think about this plan?	この計画についてどうお考えですか。
Who do you think will take over the company?	この会社は誰が引き継ぐと思う？
Monday through Friday are work-days in this company.	この会社では、月曜日から金曜日まで仕事をします。
I'd like to send these to Japan.	この荷物を日本まで送りたいのですが。
This is how we've got to know each other.	このようにして僕たちは互いに知り合うようになった。
Please do it this way.	このようにして、それをやって下さい。
Don't read such a book as this.	このような本を読んではだめだ。
This is incomparably great.	このほうが比べものにならないほど優れている。
I have been learning English these four years.	この４年間英語をずっと勉強している。
She has been out of work these two years.	この２年間彼女は失業している。
Come here and have a look at it.	こっちへ来てこれを見てごらん。
Come here.	こちらに来なさい。
Come here, and I'll show you.	こちらに来なさい、そうすれば見せてあげます。
We'll call Dr. Shiegal for you.	こちらからシーガル先生に電話しておきます。
Come here, John.	ここへ来なさい、ジョン。
Do not come here.	ここへ来てはいけません。
Come here and help me.	ここへ来てそして私を手伝ってよ。
How did you come here?	ここへどうやって来たのですか。
Where is this?	ここは何処ですか。
The price of books is getting higher these days.	ここのところ書籍の価格が上がっている。
Here is a book.	ここに本がある。
Here is the book you are looking for.	ここに君の探している本がある。
Here is a book.	ここに一冊の本があります。
How did you come here?	ここになんで来たの？
Did you use to live here?	ここにかつて住んでいたのですか。
Would you please write your name here?	ここにあなたの名前をかいてくれませんか。
Don't play here.	ここで遊んではいけない。
There may be two cases here.	ここで２つのケースがある。
This is just what I wanted.	こういうものが欲しいと思ってました。
Such books as this are of no use to us.	こういう本は私達には少しも役に立たない。
Shall I call Ken back?	ケンにあとでこちらから電話しましょうか。
Ken came up to me.	ケンが、私のところにやってきた。
Kate was made to read the book.	ケイトはその本を読まされた。
There's a Mr Kay wants to see you.	ケイさんという方がお目にかかりたいそうです。
Kim is living with Ken.	キムはケンと同居している。
Where do you live?	きみはどこに住んでいますか。
You needn't have bought that book.	きみはその本を買わなくてもよかったのに。
By the time you come back, I'll be gone.	きみがもどって来るころには、ぼくは出かけてしまっているよ。
You, come here.	きみ！こっちに来なさい。
Where are you from, Karen?	カレンさんはご出身はどちらですか。
I do not know when she will come back.	彼女がいつ戻ってくるかは分かりません。
At one time they lived in Nagoya.	かつて彼らは名古屋にすんでいた。
May I use your phone?	お電話をお借りしてもよろしいですか。
Do you know each other?	お知り合いなんですか？
You shall have my car.	お前には私の車をあげよう。
I am pleased at your coming.	お出で下さってうれしい。
Please come and see me if you have time.	お時間があれば、どうぞ私に会いに来て下さい。
You called?	お呼びですか。
Do come and see us when you are free.	お暇の折にはぜひ遊びに来てください。
I will make a man of you.	おまえを一人前の男にしてやろう。
Get back to where you started.	おまえがもといた故郷へ。
What do they live on in Egypt?	エジプトでは何を食べて生活していますか。
Uh.....yes, I think so.	ええっと、そうだと思います。
If you want it done well, I'm your man.	うまくそれをやらせたいと思うなら私こそその適任者です。
I'd like to change my image.	イメージチェンジをしたい。
Are there any stores with "going out of business" sales?	いま閉店前のセールをやっているとこがありますか。
I'm coming.	いま行くよ。
I was just about to get started any-how.	いまやろうと思ったのに。
I am coming.	いま、行きます。
When are you coming back?	いつ戻ってきますか。
When did you come to know her?	いつ彼女と知り合ったのですか。
I'd like to know when you can send it out.	いつ発送してもらえるのか知りたいのです。
When did you come to Japan?	いつ日本にいらっしゃったんですか。
When will you get through with work?	いつ仕事が終わる予定ですか。
When do you want to go?	いつ行きたいのですか。
When will you come home?	いつ帰宅しますか。
What time did you come home?	いつ帰宅したのですか。
When did you come to Paris?	いつパリに来たのですか。
Please come and see me any time.	いつでも遊びに来て下さい。
Come and see me any time you like.	いつでも遊びにいらっしゃい。
Please call me at any time.	いつでも電話をしてください。
Come on any day you like.	いつでも好きな日に来なさい。
Come at any time you like.	いつでも好きなときに来なさい。
You can use this computer any time.	いつでもこのコンピューターを使っていいよ。
What in the world do you want to do?	いったい何がしたいのか。
Come with us.	いっしょに来なさい。
Some day I want to go to New York.	いつか私はニューヨークへいきたい。
I want to go to America some day.	いつかアメリカに行きたいと思っている。
I want to go to America some day.	いつかアメリカに行きたいんだ。
May I call on you some day?	いつかあなたを訪問してもいいですか。
When shall I come for you?	いつお迎えにまいりましょうか。
When will you get through with work?	いつあなたは仕事を終えますか。
When and where did you come to know her?	いつ、どこで彼女を知るようになったのですか。
When and where did you come to know her?	いつ、どこで彼女と知り合ったんだい。
I don't like her in some ways.	いくつかの点で私は彼女が気に入らない。
I come from England.	イギリスから来ました。
It's not a good car, but it's a car.	いい車ではないが、車であることに変わりはない。
No, she didn't.	いいえ、書きませんでした。
No, she didn't.	いいえ、行きませんでした。
I was looking for Andy. Do you know where he is?	アンディを探していたのだ。彼が何所にいるかしっているか。
Oh, and Andy Dillon called...	アンディ・ディロンさんからお電話がありまして・・・。
You came when I was thirty.	アンタは私が三〇才のときの子だよ。
What are you lining up for?	あんた、なぜに並んでいるのだい。
That is the shop where I used to work.	あれは私が昔働いていた店だ。
That is just what I wanted.	あれはちょうど僕が欲しかったものだ。
That is your book.	あれはあなたの本です。
Oh, please call me Angela.	あら、アンジェラと呼んでください。
I was getting used to living in America.	アメリカの生活にだんだん慣れてきました。
Give that book back to me.	あの本を返してくれ。
That book is a new book.	あの本は新しい本です。
That book is of no use.	あの本は何の役にも立たない。
Don't go into that area.	あの地域には入るな。
Who is that man?	あの男性は誰ですか。
Who is that man?	あの男の人は誰ですか。
Who is that man?	あの人誰？
Who is that man?	あの人は誰ですか。
He may be a good man for all I know.	あの人は案外いい人かもしれない。
I don't know who that man is.	あの人が誰か分からない。
I don't know who the man is.	あの人が誰か私は知らない。
That car is hers.	あの車は彼女のです。
What were you doing when she came?	あの子が来たとき、君が何をしているんだ。
We're on our way home.	あの故郷へ帰るんだ。
How did you come to know each other?	あなた方はどのようにしてお互いに知り合ったのですか。
I will make a man of you.	あなたを一人前の男にしてあげよう。
Can I call you Bob?	あなたをボブと呼んでもいいですか。
I'm thinking of taking you to see Mr Jenkins.	あなたをジャンキンズさんに会いにおつれしようと思っています。
I'm thinking of taking you to see Mr Jenkins.	あなたをジェンキンズさんに会いに連れてゆこうと思っています。
You will be called Cephas.	あなたをケパと呼ぶことにします。
You should have come with us.	あなたも一緒に来ればよかったのに。
Will you live in Sasayama next year?	あなたは来年篠山に住むつもりですか。
When will you live in Sanda next year?	あなたは来年のいつに三田に住むつもりですか。
You needn't have come.	あなたは来る必要はなかったのに。
You needn't come.	あなたは来るにはおよばない。
What do you want to buy for her?	あなたは彼女に何を買ってあげたいのですか。
Who do you think he is?	あなたは彼が誰だと思いますか。
Do you know where he lives?	あなたは彼がどこに住んでいるか知っていますか。
Do you have two books?	あなたは二冊の本を持っていますか。
You have two books.	あなたは二冊の本を持っています。
You live in Tokyo, don't you?	あなたは東京に住んでいますね。
How did you make a living in Tokyo?	あなたは東京でどのようにして生計を立てていたのですか。
Do you live in the city?	あなたは都市に住んでいますか。
It's time for you to buy a new car.	あなたは新車を買うべきだ。
Do you have a car?	あなたは車を持っていますか。
Do you live in Sasayama?	あなたは篠山に住んでいますか。
You may as well come with me.	あなたは私といっしょに来た方がいい。
Do you know where I live?	あなたは私がどこに住んでいるのか知っていますか。
Are you through with your work?	あなたは仕事をやり終えましたか。
Are you through with your work?	あなたは仕事をもう終えましたか。
Did you live in Sasayama last year?	あなたは去年篠山に住んでいましたか。
Where did you live last year?	あなたは去年どこに住んでいましたか。
I thought you had better not go out.	あなたは外出しないほうがよい、と私は思った。
Where do you come from?	あなたは何処から来ましたか。
What are you thinking about?	あなたは何を考えているのですか。
What do you want to do?	あなたは何をしたいですか。
What do you want to be?	あなたは何になりたいの？
You're looking very well.	あなたはとても元気そうですね。
Where do you come from?	あなたはどちらの出身ですか。
Where were you going?	あなたはどこに行くところでしたか。
Where did you learn English?	あなたはどこで英語を学びましたか。
Where do you live?	あなたはどこにお住まいですか。
Where did you see Nancy?	あなたはどこでナンシーを見かけましたか。
What do you think?	あなたはどう思いますか。
How do you come to school?	あなたはどうやって学校へ来るのか。
How did you come here?	あなたはどうやってここへ来たのですか。
You will have your own way.	あなたはどうしても自分の思いどおりにしたがる。
You will have your own way.	あなたはどうしても意地を張るのだね。
How did you come here?	あなたはどういう風にしてここへ来ましたか。
Do you need the book?	あなたはその本が必要ですか。
Are you going to buy the car?	あなたはその車を買うつもりですか。
Were you reading a book at that time?	あなたはその時本を読んでいましたか。
Would you take part in the project?	あなたはその計画に参加しますか。
You may read this book.	あなたはこの本を読んでもいい。
Have you read this article?	あなたはこの記事を読みましたか。
You do not have to come here.	あなたはここへくる必要はない。
You have only to come here.	あなたはここに来さえすればよい。
Do you come from Austria or Australia?	あなたはオーストリア出身ですか、オーストラリア出身ですか。
When did you come to Japan?	あなたはいつ日本に来ましたか。
When did you come back from Tokyo?	あなたはいつ東京から帰ってきたのですか。
When are you going to call me?	あなたはいつ私に電話してくれるつもりですか。
When do you come and see me?	あなたはいつ私に会いに来ますか。
When do you start for Sado?	あなたはいつ佐渡にたちますか。
When will you come back to school?	あなたはいつ学校に戻ってきますか。
What did you do with that car?	あなたはあの車をどう処理したのですか？
You came home at 5:00.	あなたは５時に帰宅した。
Come and write your name.	あなたの名前を書きに来なさい。
Which is your book?	あなたの本はどちらですか。
Here is your book.	あなたの本です。
When is your book coming out?	あなたの本はいつ発売されるのですか。
May I use your phone?	あなたの電話を使ってもいいですか。
What line of work are you in?	あなたの職業は何ですか。
Are you through with your work?	あなたの仕事を終えましたか。
You can have any you want.	あなたの好きなものは何でもあげます。
Your plan is not in line with our policy.	あなたの計画は私たちの方針と一致していない。
I want to be in your plan.	あなたの計画に一枚加わりたい。
I'm all for your plan.	あなたの計画には大賛成です。
Where do you go to school?	あなたの学校はどこにありますか。
Please write about your home.	あなたの家庭のことを書いて下さい。
I want to be a good player like you.	あなたのように上手になりたい。
I think I should do it for you.	あなたのためにそれをすべきだと思うのです。
What should I call you?	あなたのことをなんとお呼びしたらいいでしょうか。
I'll give you a book.	あなたに本をあげましょう。
You're wanted on the phone. It's from Tom.	あなたに電話ですよ。トムからですよ。
I will show you my new car.	あなたに私の新車を見せてあげましょう。
Where did you get this photo taken?	あなたはこの写真をどこで撮ってもらったのですか。
It looks very good on you.	あなたにとてもよく合います。
I'd like you to read this book.	あなたにこの本を読んでもらいたい。
I want you to be an Einstein.	あなたにアインシュタインのような人になってもらいたい。
You and I are men.	あなたと私は男です。
I'm very pleased to come with you.	あなたと一緒に行けてとてもうれしい。
I want to go with you.	あなたと一緒に行きたいな。
I'm the one who wants to be with you.	あなたと一緒にいたいのは私だ。
I will come with you.	あなたといっしょに参ります。
You're so set in your ways!	あなたって本当に頑固ね。
Who is going to play the part in your play?	あなたたちの劇でその役を演じるのは誰ですか。
Where did you get this photo taken?	あなたこの写真をどこで撮ってもらったのですか。
I will go if you come.	あなたが来れば私は行きます。
What was it that you wanted?	あなたが欲しかったものは何だったのか。
I thought you were Japanese.	あなたが日本人だと私は思っていた。
It's a better line than when you used to call me from the university.	あなたが大学から電話してきたときより、よく聞こえるわ。
What is it that you want me to do now?	あなたが今、あたしにしてほしいことは何？
If you don't want to go, you don't need to.	あなたが行きたくないのなら行く必要はありません。
Is it the case that you have done it?	あなたがやったというのは本当か。
What do you want?	あなたがたは何を求めているのですか。
Where is your school?	あなたがたの学校はどこにありますか。
Oh, here they come!	あっ、彼等が来る。
Please write to me when you get there.	あちらに着いたら手紙をください。
Oh! I know the man.	あぁ、私はその男を知っています。
Oh, by the way, do you know where she lives now?	ああ、ところで彼女が今どこに住んでいるか知ってるかしら。
Can you come at nine?	９時はいかがですか。
Do you think you could make it at 9:30?	９時３０分にしていただけますか。
I thought you had to get up by 7:30.	７時半には起きなければいけなかったんじゃないの。
I'll call you at seven.	７時に電話します。
I will call for you at seven.	７時にきみを迎えに行くよ。
Please call me at about 7:30.	７時３０分ごろに電話をください。
I will start working on July the first.	７月１日から仕事を始めます。
Come home by 6:30.	６時半までには帰ってきてね。
We're all booked up at 6:00.	６時は満席です。
If we are to be there at six, we will have to start now.	６時に着くつもりならば、今出発しなければならない。
I'll call for you at six.	６時にお迎えに上がります。
Please come in three days.	３日後に来てください。
There were three men.	３人の男性がいた。
Call her up at three.	３時に彼女に電話しなさい。
I'll call for you at three.	３時にあなたを迎えに行きます。
I can come at three.	３時で結構です。
3 to the third power is 27.	３の３乗は２７である。
I'd like two prints of each.	２枚ずつやいてください。
One lives in Fukuoka, and the others live in Niigata.	１人は福岡に住んでいて、残りは新潟に住んでいます。
I'll come by 10.	１０時までに来ます。
"She likes music." "So do I."	「彼女は音楽が好きだ」「私もそうだ」
"Is he coming?" "No, I think not."	「彼は来ますか」「来ないと思います」
"Is he by the car?" "No, he is in the car."	「彼は車のそばにいますか」「いいえ、車の中にいます」
"Who is in the car?" "Tom is."	「誰か車の中にいるのですか」「トムがいます」
"Who wrote this book?" "John did."	「誰がこの本を書いたのですか」「ジョンです」
"I've seen that play." "So have I."	「私はその劇を見たことがあります」「私もあります」
What do you call "yuri" in English?	「ユリ」を英語で何といいますか。
I didn't know when Bob had come to Japan.	私はボブがいつ来日したのかを知らなかった。
Do you have any books to read?	読む本がありますか。
Do your work in your own way.	君なりのやり方で仕事しなさい。
She is eight.	彼女は８才だ。
That day shall come.	その日は必ずやってくる。
I'd like to live in New York.	私はニューヨークに住みたい。
This will be the book you're looking for.	これが御探しの本でしょう。
"Who is that man?" "Mr Kato."	「あの人は誰なんでしょうか」「加藤さんですよ」
"Where do you live?" "I live in Tokyo."	「あなたはどこに住んでるのですか」「東京です」
"What make is your car?" "It is a Ford."	「あなたの自動車はどこの製品ですか」「フォード社のです」
Shall we start?	始めましょうか。
What do you think about it?	それについてどう思いますか。
I want to go back now.	今日はもう帰りたい。
Start by doing the books.	まず帳簿をつけることからはじめなさい。
When you can't do what you want, you do what you can.	したいことが出来なければ出来ることをしなさい。
He wants to go to America.	彼はアメリカに行きたがっている。
She lives in New York.	彼女はニューヨークで暮らしている。
She is from France.	彼女はフランス出身です。
"What do you think?" "Well, I'm for it."	「どう思う？」「いや、賛成だ」
Well? Will you come?	どう？来ない？
That's my line!	それは私の台詞だよ！
Did Tom call?	トムから電話があった？
I don't know what Tom is planning to do.	トムが何を目論んでいるのか分からない。
We think that he will come.	彼は来ると思います。
What do you think?	どう思われますか？
She liked it.	彼女はそれが好きでした。
Did you call Tom?	トムに電話した？