I study from eight to eleven.	私は八時から十一時まで勉強します。
I am pleased with my new house.	私は新しい家が気に入っている。
I have a little money with me.	私は少しは金の持ち合わせがある。
I have a little money with me.	私は手持ちのお金が少しあります。
I save what money I got.	私は手に入るわずかばかりの金をすべて蓄えた。
I loved my life and my money.	私は自分の人生とお金を愛していた。
I am very pleased with my job.	私は自分の仕事が気に入っている。
I worked my way through college.	私は苦学して大学を卒業した。
I didn't know what to say.	私は何といってよいのか解りませんでした。
I know what's in the box.	私は何がこの箱の中にあるのか知っています。
I am not experienced in driving.	私は運転の経験がありません。
I have visited Kyoto before.	私は以前京都を訪れたことがあります。
I want to join Joe's group.	私はジョーのグループに加わりたいです。
I have read this book before.	私はこの本を前に読んだことがある。
I don't have any money on me.	私はお金の持ち合わせが少しもない。
I visited many parts of England.	私はイギリス各地を見物した。
I study from eight to eleven.	私は８時から１１時まで勉強します。
I have been learning a science.	私は、ずっと科学を習っている。
My friends set off to America.	私の友達はアメリカへと出発した。
My friend will be our guide.	私の友人が、私たちを案内してくれる。
My family are all in good health.	私の家族はみんな健康です。
It is no use asking me for money.	私に金をせがんでもむだだ。
We want to have a large family.	私たちは子供がたくさんほしい。
We have a party this evening.	私たちは今晩パーティーを開きます。
All of us like you very much.	私たちはみな、あなたが大好きなの。
We are both in the same class.	私たちは２人とも同じクラスです。
Our school is fifty years old.	私たちの学校は創立して５０年だ。
We still have masses of work.	私たちにまだたくさんの仕事がある。
It is Paris that I want to visit.	私が訪れたいのはパリです。
Will you take your hand off me?	私から手を離してくださらない？
I will pay the money to you.	私があなたにそのお金を払いましょう。
I'll show you around the city.	市内をぐるっとご案内しましょう。
We're having a party this evening.	今晩パーティーをします。
I'll look around the city today.	今日、町を見物するつもりだ。
I am not content with what I am.	今の自分には満足していない。
Could you come over right now?	今すぐ来ていただけるでしょうか。
You had better do it right now.	今すぐそれをしたほうがいいよ。
Two blacks do not make a white.	黒に黒をたしても白にはならぬ。
You should read between the lines.	行間を読むべきなんだよ。
You must do as you are told.	言いつけどおりにしなければならない。
You shouldn't look down on him.	君は彼を軽蔑するべきではない。
You must do as I tell you.	君は私の言うとおりにしなければならない。
You'd better not go out today.	君は今日は外出しないほうがよい。
How long have you been in Japan?	君はどれほど日本にいますか。
You're the best man for the job.	君こそその仕事に最適任だよ。
Kasai was credited with 30 saves.	葛西は３０セーブをあげた。
Kabuki is an old Japanese art.	歌舞伎は古くからの日本の芸術だ。
All the family got out of the car.	家族は全員車から降りた。
Could you please drive me home?	家まで送ってくださいませんか。
What time should I check in?	何時にチェックインすればいいですか。
When should we check out?	何時にチェックアウトしなければならないの？
What time will be right for you?	何時がご都合よいでしょうか。
I must save her at all costs.	何としても彼女を救わねばならない。
How many days are there in a week?	一週間は何日ありますか。
The party started for New York.	一行はニューヨークへ向かった。
In a word, she isn't any use.	一言で言えば彼女は役立たずなのだ。
I saw him at one time or another.	以前彼に会ったことがある。
Don't bother to call on him.	わざわざ彼を訪ねて行かなくてもよい。
I visited Paris in Europe.	ヨーロッパにいる間に僕はパリをたずねた。
I will help you, of course.	もちろん、あなたを手伝ってあげますよ。
Perry visited Uraga in 1853.	ペリーは浦賀に１８５３年に来航した。
Fred's house has five rooms.	フレッドの家には部屋が５つあります。
Why don't you study French?	フランス語を勉強してみてはどうですか。
Tell her which one to take.	どれに乗ったらよいか彼女に教えなさい。
Tom showed me around the park.	トムは私に公園を案内してくれた。
How do you make your money?	どのようにすればお金が手に入りますか。
Which credit cards can I use?	どのクレジットカードが使えますか。
How long will it take to get well?	どのくらいで治りますか。
Say which one you would like.	どちらが欲しいか言ってご覧なさい。
Tell him where he should go.	どこに行ったらよいか彼に聞きなさい。
It looks as if you're right.	どうやら君の言うことが正しいようだ。
Read as many books as you can.	できるだけ多くの本を読みなさい。
Don't keep company with such a man.	そんな男とつきあうな。
Have you been here since?	それ以来こちらに来られたことがありますか。
Tell me when it came about.	それはいつ起こったのか話してください。
I haven't seen her since then.	それいらい彼女に会っていません。
I have read the book before.	その本は以前に読んだことがあります。
Is there an index to the book?	その本には索引がついていますか。
We are all one on that point.	その点では皆の意見が一致している。
The man has no house to live in.	その男には住むべき家がない。
The library has many books.	その図書館は多くの書物を所蔵している。
The people are on the team.	その人たちは同じチームに所属している。
How about going to see the game?	その試合を見に行きませんか。
The play was not well acted.	その戯曲はうまく舞台にのらなかった。
Please think no more about it.	そのことはもう考えないで下さい。
I'd like to keep the car there.	そこに車をおいておきたいのだ。
I want to be with him all the way.	ずっと彼と一緒にいたい。
There is a post office close by.	すぐ近くに郵便局があるんだ。
I think this is a case in point.	これは適切な例だと思います。
Do you have this in my size?	これで、私に合うサイズはありますか。
This book is still copyrighted.	この本はまだ版権が生きている。
How long can I keep this book?	この本はどのくらい借りれますか。
This report isn't to the point.	この報告書は要領をえていない。
What time do you start boarding?	この便は定刻に出発しますか。
There are many stores in this area.	この地域は商店が多い。
Please take me to this address.	この住所まで、行ってください。
This car is bigger than that one.	この車はあの車より大きい。
I didn't ask for a table here.	このテーブルを頼んだのではない。
I want you to keep up with me.	こちらの調子に合わせてください。
Here's a big map of Germany.	ここにドイツの大きな地図があります。
What a big house you have!	きみは何と大きい家を持っているんだろう。
Do you have any money with you?	お金の持ちあわせがありますか。
The Netherlands is a small country.	オランダは狭い国です。
When did you change your address?	いつ住所を変えたのですか。
Please tell me when to go.	いつ行ったらいいのか私に教えてください。
When do we hand in the report?	いつレポートを提出するのですか。
Why should you think so?	いったいどうしてあなたはそう考えるのですか。
I think we could be good friends.	いい友達になれそうですね。
Ann has a little money with her.	アンはお金を少し持っている。
Don't go down before such a man.	あんな男にまけてはいけない。
That is the house where he lives.	あれは彼が住んでいる家だ。
One day I found a box there.	ある日、私はそこで箱を見つけました。
I gave her all the money I had.	ありったけの金を彼女に与えた。
That old book is a real find.	あの古本はまったくの掘り出し物だ。
What shall we buy with that money?	あのお金で何を買おうか。
What do you have in your hand?	あなたは手に何を持っていますか。
You shouldn't say it.	あなたはそのことを言わないままにしておく方がよい。
Are you the owner of this house?	あなたはこの家の主人ですか。
Can you see that small house?	あなたはあの小さな家が見えますか。
Tell me all about your plan.	あなたの計画をすべて話してください。
You have no right to go there.	あなたにはそこに行く権利がない。
He will come if you call him.	あなたが呼べば、彼は来るでしょう。
There are many people in Asia.	アジアにはたくさんの民族がいる。
I'm going to check out at eight.	８時にチェックアウトします。
She was in America last month.	彼女は先月アメリカに行ってきた。
He studied English with me/them.	彼が一緒に英語の勉強をしました
Some people used it in that way.	ある人が、そういう使い方をした
That had a ninety-year history.	それが９０年もの歴史を持っていた
He uses Internet only for X.	彼がXのみにインターネットを使っている
He had a bigger problem than that.	彼がそれ以前の問題に悩んだ
Japanese cars are right hand drive.	日本車は右ハンドルです。
You will keep your word, won't you?	約束を守って下さるわね。
The book was given to him by me.	本は私から彼に与えられました。
Please tell me how to take a book.	本の借り方を教えて下さい。
I studied my part in the play.	僕は芝居の自分の役の台詞を覚えた。
Hokkaido is to the north of Honshu.	北海道は本州の北にある。
The time has come when we must part.	別れる時がやって来た。
There is more money than is needed.	必要以上のお金がかかる。
She led the old man into the room.	彼女は老人を部屋に導いた。
She told me where to go.	彼女は私に何処に行けばいいのかを教えてくれた。
She used to address me as Tom.	彼女は私にトムと言って話しかける。
She will get well in a week.	彼女は一週間もすればよくなるでしょう。
She found the money gone.	彼女はその金がなくなっているのに気がついた。
She found the money gone.	彼女はその金がなくなっていることに気付いた。
I thought she was 30 at most.	彼女はせいぜい３０歳だと僕は思った。
She lives in a two-story house.	彼女は２階建ての家に住んでいる。
Ask her when she will come back.	彼女に何時帰るか聞いてごらん。
I still have some feelings for her.	彼女にはまだ未練がある。
Shall I have him go with you?	彼をあなたと一緒に行かせましょうか。
You'd better do what they say.	彼らの言うとおりにしたほうがいい。
He doesn't come here every day.	彼は毎日ここへ来るわけではない。
He read the book from cover to cover.	彼は本を読み通した。
He asked if I like Chinese food.	彼は中華料理がすきかたずねた。
He found a job with a food company.	彼は食品会社に就職した。
He is older than I by two years.	彼は私よりも２歳も年上である。
He asked me which way to go.	彼は私にどっちへ行けばいいのか尋ねた。
He asked me what I had bought.	彼は私に、何を買ったのかと尋ねた。
He did it as he had been told.	彼は言われたとおりにそれをやった。
He bought a small house in Kyoto.	彼は京都に小さな家を買った。
It was not long before he got well.	彼は間もなくよくなった。
He has a family to provide for.	彼は家族を養わなければならない。
He doesn't know French at all.	彼はフランス語はぜんぜん知らない。
He didn't show up at the party.	彼はパーティーに出席しなかった。
He did not know what to say.	彼はなんと言ってよいかわからなかった。
He made good use of the money.	彼はその金をうまく生かして使った。
He kept on working all the while.	彼はその間ずっと働き続けた。
Is he any better today?	彼はきょうは少しは具合がよくなっているのですか。
He checked in at a good hotel.	彼はいいホテルにチェックインした。
He has not seen much of the world.	彼はあまり世間を知らない。
He was asking about your health.	彼はあなたの安否を尋ねていた。
You have made him what he is.	彼の今日あるのはあなたのおかげです。
I asked what he was going to do.	彼に何をするつもりかたずねた。
Tell him where he should go.	彼にどこへ行ったらよいかを告げなさい。
Tell him where he should go.	彼にどこに行ったらよいかを告げなさい。
How long have you known him?	彼と知り合ってどのくらいになりますか。
If he doesn't come, we won't go.	彼が来なければ私達は行かない。
Tell me how he got it.	彼がどのようにしてそれを手に入れたかを教えてくれ。
Can I call my friend in Japan?	日本の友達にかけられるでしょうか。
How long have you been here?	当地に来てからどのくらいになりますか。
Tokyo is one of the biggest cities.	東京は大都市の１つです。
What's the local time in Tokyo now?	東京は今何時でしょうか。
The store closed down for good.	店はたたまれ、それっきりだった。
It was long before he knew it.	長い間たってから彼はそれを知った。
It's been ages since I saw you last.	大変お久しぶりですね。
It's the best job in the world!	世界でいちばんいい仕事だものね。
Are you through with the paper?	新聞はもうおすみになりましたか。
Will you hand the papers around?	書類を回してくださいませんか。
Try and do better next time.	次回はもっとうまくやるようにしなさい。
Time is up. Hand in your papers.	時間です。答案を出して下さい。
We must keep up with the time.	私達は時間を守らなければならない。
We're going to have a test today.	私達は今日テストがあります。
I can't do without her help.	私は彼女の助けなしではやっていけない。
I could not find him out.	私は彼の正体を見破ることは出来ませんでした。
I don't like living in the country.	私は田舎に住むのは嫌だ。
I have a little money with me.	私は少しはお金の持ち合わせがある。
I do not know how to drive a car.	私は車の運転方法を知らない。
I can't help loving my country.	私は自国を愛さずにはいられない。
I'd better drive you home.	私は君を車でお宅までお送りしたほうがよい。
I told him what I had told you.	私は君に話したことを彼に話した。
I didn't know what to say.	私は何と言ってよいのか分かりませんでした。
I was called on in English class.	私は英語の時間に当てられた。
I don't have any money on me.	私はまったくお金の持ち合わせがない。
I still have some money in hand.	私はまだ少し手持ちの金がある。
I have not seen him since then.	私はその時以来彼にあっていない。
I don't like this type of house.	私はこの型の家は好きではない。
I have no money with me now.	私はいまお金の持ち合わせがありません。
I have no other friend than you.	私はあなた以外に友達がいない。
I will tell you about Japan.	私はあなたに日本について話しましょう。
I have lived here since 1990.	私は１９９０年からここに住んでいる。
I have been to the store before.	私は、以前、そのお店に行った。
I have no more than ten books.	私は、１０冊しか本を持っていない。
Write to him for me, Jan.	私の代わりに彼に手紙を書いて下さい、ジャン。
Please give me a hand with my job.	私の仕事を手伝って下さい。
There are four people in my family.	私の家族は４人家族です。
There are four members in my family.	私の家族は４人います。
I have no family to provide for.	私に養うべき家族がありません。
I have some friends to help.	私には助けなければならない友達がいる。
What size do you think I take?	私にはどのサイズが合うでしょうか。
Will you sell your car to me?	私にあなたの車を売ってくれませんか。
We are getting older day by day.	私たちは日毎に年をとっていく。
We acted the story of Columbus.	私たちはコロンブスの話を演じた。
We visited Yokohama on business.	私たちは、仕事で横浜を訪れた。
There is a library in our city.	私たちの町には図書館があります。
Would you like to join our team?	私たちのチームに入りませんか。
We still have masses of work.	私たちにはまだたくさんの仕事がある。
I'll show you that I am right.	私が間違っていない事を証明しよう。
I will show you around the city.	市内をぐるっと案内しましょう。
How does the first article run?	最初の条項には何と書いてあるか。
I have some work to do this evening.	今晩は仕事があります。
I've been pressed for time today!	今日は時間に追われていてね。
For a full day from today please.	今日から丸１日お願いします。
This time you must go there.	今度は君がそこにいかなければならない。
I have done much writing this week.	今週は大いに書きました。
Where have you been this week?	今週はどちらにいらしゃいましたか。
Is there any food you don't like?	嫌いな食べ物ってありますか？
Do you have a room of your own?	君は自分の部屋を持っていますか。
You have to go to the party.	君はパーティーに出なくてはならないよ。
Haven't you got any money?	君はお金をいくらかお持ちではありませんか。
You're the best man for the job.	君こそその仕事に最も適任だよ。
Kyoto has many places to see.	京都には見るべき場所がたくさんある。
I haven't seen you for a long time.	久しく会っていませんね。
The company was in want of money.	会社はお金を必要としていた。
There was much food in the house.	家には食物がたくさんあった。
I've studied English for five years.	英語を５年習いました。
I would like a week off with pay.	一週間の有給休暇をください。
Inoue doesn't like computers.	井上さんはコンピューターが嫌いです。
Would you care for more cookies?	もっとクッキーはいかがですか。
I think we should do some more.	もう少しやった方がいいと思うわ。
Mary is studying in her room.	メアリーは自分の部屋で勉強している。
Mary and I are in the same class.	メアリーと私は同じクラスだ。
It was not long before he knew it.	まもなく彼はそれを知った。
Please get me hotel security.	ホテルの保安係りにつないでください。
France is to the south of England.	フランスは英国の南にある。
I'd like to travel first-class.	ファーストクラスでお願いします。
Take any two cards you like.	どれでも好きなカードを２枚取りなさい。
How long have you been in Japan?	どのくらい日本にいるんですか。
How did you get to know him?	どうして彼を知るようになったのですか。
Dan likes to make model cars.	ダンは模型自動車を作ることが好きだ。
There are many books, aren't there?	たくさん本がありますね。
About how much will it cost?	だいたいどのくらいの値段でいけますか。
Their sizes are much the same.	それらの大きさはほとんど同じです。
There were not many present.	その場に居合わせた人は多くはなかった。
I haven't seen her since then.	その時以来私は彼女に会っていない。
The family love one another.	その家族の者はお互いに愛し合っている。
The hotel is noted for its food.	そのホテルは食事で有名である。
Tell me how to play the game.	そのゲームの遊び方を教えてください。
Boarding will be at six-forty.	ご搭乗は６時４０分になる予定です。
Learn these words, one by one.	これらの単語を一つずつ覚えなさい。
This is what I've long wanted.	これは私が長い間欲しかったものだ。
Can you tell me what this is?	これがどんなものか説明してください。
You are free to use this room.	この部屋を自由に使っていいですよ。
This word is not in current use.	この語は現在用いられていない。
How would you take these words?	このことばを君はどう考えますか。
Please keep this money for me.	このお金を預かっておいてください。
How long have you lived here?	ここに住んでどのくらいになりますか。
Ken has more books than you.	ケンは君よりたくさんの本を持っている。
Just give me your name and address.	お名前とご住所をどうぞ。
How is it going with your family?	お宅の皆さんはいかがですか。
Do you have much money with you?	お金の持ち合わせは多いですか。
Oedipus thought for a long while.	オイデイプスは長い間考えた。
Call at my office at any time.	いつでも私のオフィスを訪ねなさい。
Don't do the job just any old way.	いいかげんに仕事をするな。
Ann had no friends to play with.	アンには遊び友達がいなかった。
Tell me what that man is like.	あの人はどんな人物か教えて下さい？
Two families live in that house.	あの家には２家族が住んでいる。
What did you do with that money?	あのお金をどう処理しましたか。
He said that you need not go.	あなたは行く必要はないと彼は言った。
You must think of your family.	あなたは家族の事を考えるべきです。
Access to A is available from B.	ＡへはＢから近接ことができる。
"I have to see him." "What for?"	「彼に会わなくては」「なぜ？」
"May I join you?" "Why not?"	「一緒にいいかい」「もちろんいいとも」
"Festiva" is a Ford, right?	「フェスティバ」ってフォードの車でしょ？
If I knew it, I would tell you.	知っていたら、お話したのですが。
She said 'I love you' to me.	彼女は僕に「あなたが好きだ」と言った。
I don't know what I should say.	何と言ったら良いか分かりません。
He looks for a temp job in Kyoto.	彼が京都で人材派遣の仕事を探す
Today, I got an e-mail at my office.	今日、会社にメールが来た
He told X to the people around him.	彼がXを周りの人に話します
The records are still right on hand.	記録が手元にしっかり残る
He didn't see that many people.	彼があまり多くの人には会わなかった
He will uncheck the check box.	彼がチェックボックスのチェックを外す
X is needed in today's companies.	Xが今の企業に要求されています
He will play the game 100 times.	彼がゲームを１００回プレーします
The history class starts at nine.	歴史の授業は９時に始まります。
The price does not include the box.	料金には箱代は含みません。
I've just been to the post office.	郵便局へ行ってきたところだ。
Friends should help one another.	友人は助け合わなければいけない。
I'll keep Thursday open for you.	木曜日、君のためにあけとくから。
It's no use asking me for money.	僕に金をせびろうとしても無駄だ。
Hokkaido is to the north of Sendai.	北海道は仙台の北方にある。
He got a job at the Law Library.	法学部の図書館で仕事を見つけた。
Can I change the date of return?	返却日を変更する事ができますか。
The light doesn't come on in my room.	部屋の電気がつかない。
There isn't a table in the room.	部屋の中にテーブルはありません。
You must not go there with them.	彼等とそこへ行ってはいけません。
She is three years older than I am.	彼女は私よりも三つ年上だ。
She didn't pay me the money.	彼女は私にそのお金を払ってくれなかった。
She was on the point of going out.	彼女は外出しようとしていた。
She paid a visit to Laurie's house.	彼女はローリの家を訪れた。
She doesn't live there any more.	彼女はもうそこに住んでいません。
She will come back before long.	彼女はまもなく戻ってくるでしょう。
She will come here before long.	彼女はまもなくここへ来るでしょう。
She is very free with her money.	彼女はとても気前よくお金を出す。
She has some money of her own.	彼女はちょっとした資産を持っている。
She has to pay for the book.	彼女はその本の代金を支払わねばならない。
They came to John and told him.	彼らはヨハネのところに来て言った。
They acted on the information.	彼らはその知らせに基づいて行動した。
They give presents to one another.	彼らはお互いに贈り物をする。
Don't give way to their request.	彼らの要求に屈してはいけません。
They had no house in which to live.	彼らには住む家がなかった。
I don't care about what they say.	彼らが何を言おうと気にしない。
I don't care about what they say.	彼らが何と言おうときにしない。
He does not come here every day.	彼は毎日ここへくるとは限らない。
He was made to go out of the room.	彼は部屋から出て行かされた。
He asked her if she knew him.	彼は彼女に自分を知っているかと尋ねた。
He asked her where she lived.	彼は彼女にどこに住んでいるかを尋ねた。
He asked her if she was Jane.	彼は彼女にあなたはジェーンかと尋ねた。
He had to work even on Sunday.	彼は日曜でさえ働かねばならなかった。
He's looking for a place to live.	彼は住むところを探しています。
He has come back from the office.	彼は事務所から帰ったばかりだ。
He asked me what my name was.	彼は私に何という名前ですかとたずねた。
He asked me what I needed.	彼は私に、私が何を必要としているかを尋ねた。
He told me that you were right.	彼は私に、あなたが正しいと言った。
He did not know what to say.	彼は何と言ってよいのやらわからなかった。
He signed on for another year.	彼はもう一年仕事を続ける契約をした。
He does not live there any more.	彼はもうそこには住んでいません。
He has acted on TV many times.	彼はテレビの劇に何度も出演してきた。
He asked the man to help him.	彼はその男に助けてくれるように頼んだ。
He made money from that business.	彼はその商売でお金をもうけた。
He is an old hand at that work.	彼はその仕事にかけては老練な人だ。
He is pleased with the present.	彼はそのプレゼントを喜んでいます。
He took part in the Olympic Games.	彼はオリンピックに参加した。
He is what is called a man of action.	彼はいわゆる行動派だ。
He lives in that house over there.	彼はあそこの家に住んでいる。
If you ask him, he will help you.	彼に頼めば助けてくれるだろう。
He has no family to support.	彼には養わなければならない家族はいない。
I have known him for two years.	彼と知り合ってから二年になります。
What do you say to going shopping?	買い物に行くのはどうですか。
Sunday is the last day of the week.	日曜日は週の最後の日です。
What do you think of Japanese food?	日本料理をどう思いますか。
The day is getting longer and longer.	日はだんだん長くなる。
Tokyo is the largest city in Japan.	東京は日本最大の都市です。
The fourth month is called April.	第４番目の月は四月と呼ばれる。
I'd like a room with a good view.	眺めのよい部屋をお願いします。
It was not long before she came.	待つほどもなく彼女はやって来た。
Living standards should be higher.	生活水準は上がるべきである。
She took the book back to the library.	図書館に本を返した。
People must love one another.	人々は互いに愛し合わなければならない。
Can I use my credit card?	診察費の支払いにクレジットカードは使えますか。
Could you please make room for me?	場所を空けて下さいませんか。
Tell me what you did in Shounan.	湘南で何をしたか教えてください。
A small car takes little room.	小さい車は、あまり場所をとりません。
Katsuko leads her class in English.	勝子は英語でクラス一番だ。
This is all the money I have.	手元にはこれだけしかお金がありません。
When should I return the car?	車はいつかえしたらよろしいでしょうか。
Time is up. Hand in your papers.	時間です。答案を提出して下さい。
The more I get, the more I want.	持てば持つほどもっと欲しくなる。
I have been to the post office.	私は郵便局へ行ってきたところです。
I can't make out what she said.	私は彼女の言うことを理解できない。
I don't want to see him at all.	私は彼に絶対に会いたくありません。
I used to go to school with him.	私は彼と学校に行くのが常でした。
I know that it was done by him.	私は彼がそれをしたのを知っている。
I don't have any money on hand.	私は持ち合わせのお金がありません。
I am in the second year of high school.	私は高校2年生だ。
I can't allow you to do that.	私は君にそれをさせるわけにはいかない。
I have read this book before.	私は以前この本を読んだことがあります。
I would like to visit New York.	私はニューヨークを訪れたいものだ。
I bought it at a department store.	私はそれをデパートで買った。
I could reply to all of them.	私はそれらすべてに答えることができた。
I want to travel to Australia.	オーストラリア旅行に行きたいんだよ。
I can give you a long life.	私はあなたに長い命を与えることができます。
I have been in Kobe since 1980.	私は１９８０年以来、神戸にいます。
Didn't I give you some money?	私のお金を少しあげたじゃありませんか。
I have no family to provide for.	私には養うべき家族がありません。
I don't have any family to support.	私には扶養家族はいません。
I can't do as he told me to.	私には彼がしろと言ったようにはできない。
I have no other friend than you.	私には君よりほかに友達がいない。
We must keep law and order.	私たちは法と秩序を維持しなければならない。
We should help people in need.	私たちは困っている人を助けるべきだ。
We parted the best of friends.	私が別れたときは最も仲良しであった。
Don't think I'm made of money.	私が大金持ちだと思ってくれては困る。
How much more work do you have?	仕事はあとどれだけ残っていますか。
He told me that he had gone there.	昨日ここに来たと彼は言った。
I've been on the go all this week.	今週はずっと働きづめだった。
Today week I'll be in England.	来週の今日、私は英国にいるでしょう。
I am not content with what I am.	今の自分には私は満足していない。
The people set up a new government.	国民は新しい政府を作った。
How is it going with your family?	御家族はいかがお過ごしですか。
We need no more men at present.	現在はこれ以上の人手はいりません。
Do you have a room of your own?	君は自分用の部屋を持っていますか。
You are to do as I tell you.	君は私の言うとおりにしなくてはいけない。
You don't like love stories.	君はラブストーリーが好きじゃないんだね。
You should have come home before.	君はもっと早く帰るべきだった。
How many are there in your class?	君のクラスの生徒は何人ですか。
The end of money is the end of love.	金の切れ目が縁の切れ目。
I made the best of my small room.	狭い部屋をせいぜい広く使った。
Does school start at eight-thirty?	学校は８時半に始まりますか。
What time do you start check-in?	何時からチェックインできますか。
How many times do I have to tell you?	何回言ったらわかるの？
I must think about what to do.	何をすべきか、考えなければならない。
I'm going to Europe next week.	来週ヨーロッパへ行くつもりなんです。
Don't bother to call me.	わざわざ電話をかけてくださらなくてけっこうです。
Have you been to London before?	ロンドンへ行ったことがありますか。
Before long he came into the room.	やがて彼が部屋に入ってきた。
Do you have any smaller sizes?	もっと小さいサイズの物はありますか。
If he comes, so much the better.	もし彼がきてくれればさらにいい。
If I had money, I could buy it.	もし金があれば、それが買えるのに。
Do you have one a little smaller?	もう少し小さいのはありますか。
Now I must go about my work.	もう仕事にとりかからなければなりません。
Mary and I became good friends.	メアリーと私は仲良しになりました。
It will not be long before he comes.	まもなく彼がくるだろう。
She must still be in her twenties.	彼女はまだ２０代に違いない。
Who designed the White House?	ホワイトハウスを設計したのは誰ですか。
In a word, he is a flatterer.	ひとことで言えば、彼はおべっか使いだ。
Tell me what you did in Hawaii.	ハワイで何をしたか教えてください。
Can you quote a line of Hamlet?	ハムレットから１行引用できますか。
I had to call off the party.	パーティーを中止しなければならなかった。
Why did she ask for our help?	なぜ彼女は我々の助けを求めたのだろう。
I gave him what little money I had.	なけなしの金を彼にあげた。
What do you say to playing cards?	トランプをするのはどうですか。
Tom need not go to school today.	トムは今日学校にいかなくてよい。
By the way, where does he live?	ところで彼は何処に住んでいますか。
Please tell me where to go.	どこへ行ったらいいか私に知らせてください。
How did you come by this money?	どうやってこの金を手に入れたのか。
As I had seen him before.	というのも、以前彼に会ったことがあったからだ。
But we call him Tony at home.	でも家ではトニーと呼んでいるのですよ。
You can do better on your tests.	テストでもっといい成績がとれる。
Don't park your books on the table.	テーブルの上に本を置くな。
The team is up for the game.	チームは試合に向けて気合いが入っている。
About how long will it take?	だいたいどのくらいの時間がかかりますか。
I like him all the better for it.	それだからいっそう彼が好きだ。
He was playing with a lighter.	その子はライターで火遊びをしていた。
I'm not schooled in that subject.	その件については勉強不足です。
When will the party take place?	そのパーティーはいつ行われますか。
The table doesn't take much room.	そのテーブルは場所を取らない。
We didn't have TV in those days.	そのころ家にはテレビがなかった。
The money has not been used up.	そのお金は使い果たしてはいません。
As for the money, it is all right.	そのお金に関しては大丈夫だ。
Two can play at that game.	そっちがその手でくるならこっちにも手がある。
I haven't seen you for ages.	ずいぶん長い間お目にかかりませんでした。
I have known John since 1976.	ジョンは１９７６年以来の知り合いです。
May I present Mr Johnson to you?	ジョンソン氏をご紹介いたします。
Mr Johnson's was a large room.	ジョンソン氏の部屋は広い部屋だった。
Good day. How are you today?	こんにちは、今日のご機嫌はいかがですか。
This is the same car as I have.	これは私が持っているのと同じ車だ。
Can you tell me what size this is?	これ、サイズはいくつですか。
This is the American way of life.	これがアメリカ風の生活様式だ。
This is much the better of the two.	これが２つの中で断然良い。
This book is older than that one.	この本の方があの本よりも古い。
You are free to use this room.	この部屋を使うのはあなたの自由です。
Shall I help you with this box?	この箱を運ぶのを手伝いましょうか。
When did you visit Kyoto last?	この前京都を訪れたのはいつでしたか。
I don't have a care in the world.	この世に思い煩らうことはない。
Experience will tell in this case.	この場合は経験がものを言う。
This car is as big as that car.	この車はあの車と同じくらい大きい。
This project may not pay off.	この企画は採算が取れないかもしれない。
It's a long way from here to school.	ここから学校は遠いんだ。
Kate is running in the field now.	ケイトは今運動場で走っている。
Christmas is only two weeks off.	クリスマスはほんの２週間先です。
Chris didn't have a car to drive.	クリスは運転する車がなかった。
I will show you around in return.	お返しに案内してあげましょう。
How would you like to pay for it?	お支払いはどのようにしますか。
I'll try Jane for some money.	お金のことはジェーンにあたってみるよ。
Ann will not come to our party.	アンはパーティーには来ないだろう。
How many cars does Alex have?	アレックスは何台クルマを持っているの？
I'll have to find a part-time job.	アルバイトを見つけなくては。
That box is bigger than this one.	あの箱はこの箱ほど小さくない。
Were you in America last month?	あなたは先月アメリカにいましたか。
He said that you had better go.	あなたは行く方がよいと彼は言った。
When did you visit New York?	あなたはいつニューヨークを訪れましたか。
When do you plan to check out?	あなたのチェックアウトはいつですか。
You can make 4, 6 or 12 payments.	４回、６回、１２回があります。
I haven't seen Tom since 1988.	１９８８年以来トムに会っていません。
The year 1932 found him in Paris.	１９３２年には彼はパリにいた。
Tom and I go to the same high school.	トムとは同じ高校です。
He right clicks on the photo.	彼が写真の上でマウスの右ボタンを押します
X is supporting the current research.	Xが今の研究活動を支える
What goes around comes around.	汚い行為の報いは必ず自分に返ってくる。
I didn't request you to do that.	そんなことリクエストしていません。
I will go to New York next week.	来週ニューヨークに行くつもりです。
I have been to see my friend off.	友人を見送りに行ってきた所です。
A book can be compared to a friend.	本は友人みたいなものである。
I can't make out what she said.	僕は彼女が言ったことが理解できない。
I want to make friends with Nancy.	僕はナンシーと仲良くなりたい。
You should set your room in order.	部屋の整理をしたほうがいいよ。
She is looked up to by her friends.	彼女は友達に尊敬されている。
She must have seen better days.	彼女は昔羽振りが良かったに違いない。
She is traveling around the world.	彼女は世界一周旅行をしている。
She looked about in her room.	彼女は自分の部屋の中をぐるりと見回した。
Not a word did she say to me.	彼女は私にただのひとこともいわなかった。
She knew that John loved her.	彼女はジョンが愛しているのを知っていた。
It is no use asking for her help.	彼女の援助を求めても無駄である。
You'd better not make light of him.	彼を軽く見ないほうがいいよ。
They come from the south of France.	彼らはフランス南部の出身だ。
They are looking into the problem.	彼らはその事件を調査している。
They have been here since 1989.	彼らは１９８９年以来、ここにいます。
He has a large family to support.	彼は養うべき大家族を持っている。
He has more money than is needed.	彼は必要以上もお金を持っている。
He works every day save Sundays.	彼は日曜日を除いて毎日働いている。
He doesn't know much about Japan.	彼は日本について良く知りません。
He will return if only a little.	彼は少したったら帰ってくるだろう。
He gave me what money he had.	彼は私に彼が持っているお金を全部くれた。
He doesn't know both of us.	彼は私たちを二人とも知っているわけではない。
He asked me if I had found it.	彼は私がそれを見つけたかどうか聞いた。
He is studying in the library now.	彼は今図書館で勉強しています。
He has little money with him.	彼は今ほとんどお金を持ち合わせていない。
He returned home by way of Hong Kong.	彼は香港経由で帰国した。
He is much older than he looks.	彼は見かけよりずっと年をとっている。
He has more money than he can use.	彼は金がうんとあって使えない。
He returned home by way of Europe.	彼はヨーロッパ経由で帰国した。
He's two years older than Mary is.	彼はメアリーより二歳年上です。
Why did he ask for so much money?	彼はなぜそんな大金を求めたのか。
He didn't say a word about it.	彼はそれについては一言も言わなかった。
What has become of him since then?	彼はそれからどうなりましたか。
He wrote a paper on the subject.	彼はその問題について論文を書いた。
He visited many countries in Asia.	彼はアジアの多くの国を訪れた。
He is older than you by eight years.	彼は８歳君より年上である。
I took note of what he was saying.	彼の言っていることに注目した。
That is all I know about him.	彼について、知っているのはそれだけです。
Get him to help you with the work.	彼にその仕事を手伝わせなさい。
I used to go to school with him.	彼と一緒に学校に行くのが常だった。
He is the right man for the post.	彼こそその地位にふさわしい人だ。
I don't know what has become of him.	彼がどうなったか知らない。
Which is larger, Tokyo or Kobe?	東京と神戸ではどちらが大きいですか。
Do you like to live in the country?	田舎に住むことは好きですか。
I have long wanted that car.	長いことずっとあの車が欲しいと思っている。
A man is known by the company he keeps.	人は善悪の友による。
I have a little money with me now.	少しは手持ちのお金があります。
Do you have small change with you?	小銭の持ち合わせはありますか。
How much money do you have with you?	所持金はいくらありますか。
Please tell us what to do next.	次に何をしたらいいか教えてください。
We have a 20% share of the market.	私達の市場シェアは２０％です。
There are 30 classes in our school.	私達の学校には３０学級ある。
Please come to my room to help me.	私を手伝いに部屋に来て下さい。
I look on her as my best friend.	私は彼女を一番の親友と考えている。
I haven't seen him for a long time.	私は長い間彼に会っていない。
I have lived here for a long time.	私は長い間ここに住んでいます。
I have loved her for a long time.	私は長いあいだ彼女を愛してきた。
I didn't go to school last month.	私は先月学校に行きませんでした。
I want to travel all over the world.	世界中を旅行をしたいんだ。
I'm saving up to buy a new car.	私は新車を買うために貯金をしている。
I go to the same school as Kenji.	私は健次と同じ学校に通っている。
I am pleased with your present.	私は君のプレゼントが気に入っている。
I'll help you as much as I can.	私はできる限りあなたの援助をします。
I look on you as my best friend.	私はあなたを親友だと思っています。
I was asked to give you a message.	私はあなたへの伝言を頼まれた。
I saw you driving your new car.	あなたが新車を運転しているのを見た。
I will be at your house at eight.	私は８時にきみの家にいるだろう。
My name and address are on it.	私の名前と住所はこれに書いてあります。
My house is covered by insurance.	私の家には火災保険がかけてある。
Would you like to come to my party?	私のパーティーに来ませんか。
I can't make out what he says.	私には彼が何を言っているのか解らない。
I have some American friends.	私には何人かのアメリカ人の友達がいます。
We should look into the problem.	私たちはその問題を調査するべきだ。
I'll help you as long as I live.	私が生きている間は援助しましょう。
It is two years since I came here.	私がここへ来てから二年になる。
The best of friends must part.	最愛の友人たちにも分かれのときがくる。
What are you doing this evening?	今晩あなたは何をするつもりですか。
Are you pleased with your new job?	今度の仕事は気に入っています。
Where have you been all this while?	今までずっとどこにいたのだ？
Can I come to your office now?	今すぐ事務所に行ってもいいでしょうか。
It is not good, to say the least.	控え目に言ってもこれは良くない。
What do your words add up to?	結局お言葉はどういう意味になるのですか。
How long have you been dating?	君達はいつからつきあっているのですか。
Why did you use up all the money?	君はなぜお金を使い果たしたのか。
Did you buy it on the black market?	君はそれをヤミで買ったのか。
You must return the book to him.	君はその本を彼に返さねばならない。
You have many caring friends.	君には心配してくれる友達がたくさんいる。
Tell me when you will call me.	君がたずねて来る時間を教えてください。
I can't allow you to do that.	君がそうすることを許すわけには行かない。
We'll visit you one of these days.	近いうちにお宅にうかがいます。
Our class has increased in size.	我々のクラスは規模が大きくなった。
There were hundreds of people there.	何百人もの人がそこにいた。
How many people are there in your family?	何人家族ですか。
How many people are in this room?	何人の人々がこの部屋にいますか。
What time does it open and close?	何時に開いて何時に閉まりますか。
Just tell me what you'd like me to do.	何なりと言って下さい。
Romeo is the man Juliet loves.	ロメオはジュリエットが愛している男だ。
Well, but what about the money?	よろしい、でもお金はどうなるんだい。
You are doing very well. Keep it up.	よくやっているよ。続けて。
In time, Tom came to love her.	やがてトムは彼女を愛するようになった。
Do you have better quality ones?	もっと品質の良いものはありますか。
If you care to, come with us.	もし来たければ、私たちと一緒にきなさい。
There is no more room for a TV set.	もうテレビを置く場所がない。
I have another year at high school.	もう１年高校が残っています。
Take as many cookies as you want.	ほしいだけクッキーを取りなさい。
It doesn't pay to play video games.	ビデオゲームは割に合わない。
You've run through all the butter?	バターを全部使ってしまったの？
Personal computers are of great use.	パソコンはとても役に立つ。
Is there a Percy in your class?	パーシーという人が君の組にいますか。
Where can you get a part-time job?	どんな所でアルバイトできるの。
What do you say to going for a drive?	ドライブに行くのはどう。
What do you say to going for a drive?	ドライブに行きませんか。
It's a problem any way you look at it.	ともかく困ったことだ。
Tom has no friends to play with.	トムには一緒に遊ぶ友達がいません。
By the way, what is your address?	ところで、君の住所はどこですか。
I'll support you as much as I can.	できるだけあなたを支持します。
How many cars does the Tsubasa have?	つばさの客車は何両ですか。
How did you come by such a job?	そんな仕事をどうやった手に入れたの。
All you have to do is write it down.	それを書き取るだけでよい。
Tell me what to do with it.	それをどう処理したらいいか私に教えて下さい。
It is reported in the local news.	それは地方のニュースに出ている。
It is at best a second-rate hotel.	それはせいぜい二流のホテルだ。
Please think about the problem.	その問題について考えてみてください。
The store is close to my house.	その店は私の家から目と鼻の先にある。
It is very good of you to say so.	そういって下さるとはご親切です。
Said John, and he was right.	ジョンは言いましたが、彼の言う通りでした。
Jim, don't run about in the room.	ジム、部屋の中を走り回らないで。
Haven't I seen you before?	これまでにお会いしたことがありませんでしたか。
This is the house in which he lives.	これは彼が住んでいる家だ。
This is the house that he lives in.	これが彼が住んでいる家です。
This book is smaller than that one.	この本はあの本よりも小さい。
How long can I keep this book?	この本どのくらいお借りしていいですか。
Do you know how to open this box?	この箱のあけ方を知っていますか。
This article comes with a free gift.	この商品にはおまけが付く。
Could you send it to this address?	この宛先に送ってもらえますか？
This is a business section of Tokyo.	ここは東京のビジネス街だ。
How long has Ken lived in Kobe?	ケンはどれくらい神戸に住んでいるの。
You must make good use of money.	お金は上手に使わなければならない。
I can't do it for want of money.	お金が足りなくて、それが出来ない。
When will this be returned to me?	いつこれを返していただけますか。
No, you need not go right now.	いいえ、今すぐに行く必要はありません。
Those houses are 500 years old.	あの建物は建ててから５００年になる。
I asked for a table over there.	あのテーブルをお願いしたいのですが。
How many of you are there?	あなた達の中のどれくらいの人がそこにいるのか。
What time do you get up every day?	あなたは毎日何時に起きますか。
Do you study English every day?	あなたは毎日英語を勉強していますか。
Do you have a room of your own?	あなたは自分の部屋をもっていますか。
You must do as you are told.	あなたは言われた通りにしなくてはならない。
I want to see you before you go.	あなたが出かける前にお会いしたい。
I'd like to join your group.	あなたがたのグループにはいりたいんですが。
We covered three states in two days.	２日で３つの州を走破した。
He will get better in two weeks.	２週間ほどで彼は回復するでしょう。
What is the area of this house?	この家の広さはどのくらいありますか。
There is no information on the website.	サイトに情報が全く無い
Every author comes out with a book.	１人の作家が１冊ずつの本を出す
We sell products at local prices.	商品を現地価格で皆様にお届けします
The site will open on the 20th!	いよいよサイトが２０日にオープンします
He will be off from work for a while.	彼がしばらく仕事を休みます
You can't have it both ways.	両天びんにかけようたってそうはいきませんよ。
He said he would see me the next day.	翌日私に会うと彼はいった。
What do your friends call you?	友達はあなたのことをなんて呼ぶのですか。
I have two gifts for friends.	友人のためのプレゼントを２つ持っています。
I have got your name from my friend.	友人からお名前を知りました。
The problem is what to do next.	問題は次に何をすべきかだということだ。
Four points need to be made.	明確にしなければならないのは次の４点である。
I asked her to send us the book.	本を送ってくれるように彼女に言った。
I love her and she loves me.	僕は彼女を愛してるし、彼女も僕を愛してます。
Would you please show me another one?	別のを見せてくれませんか。
How about the last part of the story?	物語の結末はどうでしたか。
Please don't run about the room.	部屋の中を走り回らないでちょうだい。
She is booked up all next week.	彼女は来週はずっと先約がつまっている。
She tried to make friends with him.	彼女は彼と友達になろうとした。
She acted in a play for the first time.	彼女は初めて劇に出た。
She has many friends in Hong Kong.	彼女は香港に友人がいっぱいいる。
She won't even look at the offer.	彼女はその申し出に見向きもしない。
She has a good many friends here.	彼女はここにたくさんの友人がいる。
How long have you known her?	彼女と知り合ってからどれくらいになりますか。
He took a room at the Yaesu Hotel.	彼は八重洲ホテルに一室をとった。
They may be playing in the park.	彼らは公園で遊んでいるかもしれない。
He will go to New York next month.	彼は来月ニューヨークへ行きます。
He looked through the evening paper.	彼は夕刊にさっと目を通した。
He told her that she was right.	彼は彼女に君は間違っていないと言った。
He's saving up to go to college.	彼は大学に行けるように貯金している。
He was running and calling for help.	彼は走りながら助けを求めた。
He is different from what he used to be.	彼は昔の彼とは違う。
He knew little about the people.	彼は人々についてあまり知らなかった。
He has a new car and an old car.	彼は新しい車と古い車を持っています。
He has a car which I gave to him.	彼は私があげた車を一台もっている。
He came to Tokyo at the age of three.	彼は三才のとき東京に来た。
He works for the good of the country.	彼は国のために働いている。
He is studying at Kyoto University.	彼は京都大学で学んでおります。
He is now better off than before.	彼は以前より今の方が金回りがよい。
He is studying law at Harvard.	彼はハーバード大学で法律を専攻している。
He is thinking about the problem.	彼はその問題について考えています。
How did he come by this money?	彼はこのお金をどうやって手に入れたのか。
He will return to Japan some day.	彼はいつか日本に戻ってくるだろう。
He uses the same books as you use.	彼はあなたと同じ本を使っている。
You must not come in contact with him.	彼と接触してはいけない。
Tell him so, when he comes back.	彼が戻っていたら、そう伝えて下さい。
What do you think has become of him?	彼がどうなったと思いますか。
Please tell me when he'll be back.	彼がいつ戻るのか教えてください。
Ask her when he will come back.	彼がいつ帰るのか彼女に尋ねてみなさい。
The days are getting longer every day.	日が長くなってきました。
Naoko lives in that white house.	直子さんはあの白い家に住んでいます。
Do you have a guide map of the city?	都市の観光地図はありますか。
Make the most of your college life.	大学生活を有効に過ごしなさい。
What do you want to study at college?	大学では何を勉強したいの？
What are you going to do in college?	大学で何をするつもりですか。
May I share this table with you?	相席させていただいてよろしいですか。
He visited her house the other day.	先日、彼は彼女の家を訪問した。
You don't have to buy water, do you?	水を買う必要がないですよね。
But for water, no man could live.	水がなければ、人間は生きられない。
Have you got through with the paper?	新聞はおすみになりましたか。
You must make the most of your time.	時間は最大限に活用すべきだ。
I told him that I would do my best.	私は彼に最善を尽くすと言った。
I have not seen him for a long time.	私は彼に久しく会っていない。
I gave him what little money I had.	私は彼になけなしの金をやった。
I do not have to study Japanese.	私は日本語を勉強しなくてもよいです。
I have been in Japan for two months.	私は日本に来て２か月になる。
I have to support a large family.	私は大家族を養わなければならない。
I have a large family to provide for.	私は大家族を養っています。
I'd like to travel around the world.	世界一周の旅をしたいんです。
I was told the news by Hashimoto.	私は橋本君からその知らせを受けた。
I am a member of the sales department.	私は営業部門の一員です。
I have another friend in China.	私はもうひとり中国の友達を持っている。
I'm not going to go to the party.	私はパーティーに出席する気はない。
I had a good time at the party.	私はパーティーで楽しい時間を過ごした。
I don't care what will become of me.	私はどうなっても構いません。
I have much to say about it.	私はそれについて言いたいことがたくさんある。
I read the book from cover to cover.	私はその本全編残らず読んだ。
I have a friend who lives in England.	私はイギリスに友人がいる。
I want to know about your country.	私はあなたの国について知りたい。
I'll help you as long as I live.	私の生きている限り、君を援助しよう。
We must provide for our old age.	私たちは老後に備えなければならない。
The man that I visited was Mr. Doi.	私が訪ねた人は土井さんでした。
That's 486-2435, area code 213.	市外局番２１３の４８６ー２４３５です。
You can't keep a good man down.	才能ある者を抑えておくことはできない。
Who do you think I ran into today?	今日誰に出くわしたと思いますか。
What time will you be home this evening?	今日は何時に帰るの？
Today, I bought ten books in all.	今日、私は全部で十冊の本を買った。
Not words but action is needed now.	今は言葉ではなく行動が必要だ。
I'd like to check out right now.	今すぐチェックアウトしたいのですが。
There are many people in the park.	公園にはたくさんの人々がいます。
You must read between the lines.	言外の意味読みとらなければいけない。
Why do you want to buy this book?	君はなぜこの本を買いたいのですか。
I can't think of life without you.	君なしの生活なんて考えられない。
What would you do in my place?	君が僕の場合だったらどうするつもりだい。
It is right that you should write it.	君がそれを書くのは正しい。
I'll give you as many as you like.	幾つでも好きなだけ上げましょう。
It was not long before the news came.	間もなくその知らせが来た。
We haven't known each other long.	我々は知り合ってからまだ日が浅い。
We live in the age of technology.	我々は科学技術の時代に住んでいる。
We've been living here since July.	我々はここに７月以来住んでいる。
If you are free, come around to see me.	暇なら遊びにおいでよ。
There was little water in the well.	井戸にはほとんど水がなかった。
I've been to Hokkaido before.	以前、ぼくは北海道に行ったことがあります。
Most of our money goes for food.	われわれの金のほとんどが食費になる。
I'll be sixteen years old next month.	私は来月16歳になります。
Do not bother to come to my home.	わざわざ家に来なくてもいいですよ。
Is room service still available?	ルームサービスはまだやっていますか。
I will tell you more about Japan.	もっと日本の話をしようと思います。
Why don't you give it another try?	もう一度それにトライしてみたら。
I will be back in another two weeks.	もう２週間たったら帰ります。
Did I tell you what Melissa said?	メリッサが言ったこと話したかしら？
It was not long before she came back.	まもなく彼女が帰って来た。
Mike and Tom are in the same class.	マイクとトムは同じクラスです。
"Come and see", said Philip.	ピリポは「来て、そして、見なさい」と言った。
We'll run into her at the party.	パーティーで彼女に会うかもしれない。
How long have you been in Japan?	どのくらい日本にいらっしゃいますか。
Please tell me which to take.	どちらをとったら言いか私に教えてください。
I asked him where he lived.	どこに住んでいるのですか、と私は彼にたずねた。
Would you please tell me the way?	どうぞ道を教えてくださいませんか。
It's time to get down to business.	そろそろ話の本筋に入るべきです。
That's just what I was going to say.	それを私はいいたかったんだ。
I had bought it the week before.	それはその前の週に買ったものでした。
You may take my word for it.	それについては私の言葉を信用してもいいです。
The news was told to me by Ito.	その知らせは伊藤君が私に伝えてくれた。
The experience will do you good.	その経験はあなたのためになるだろう。
We didn't have TV in those days.	そのころ、うちにはテレビがなかった。
We would love to work with you.	ぜひ取引させていただきたいと思います。
John's older than I thought.	ジョンさんは私が思ったよりは年をとっている。
This is the same book as I have.	これは私が持っているのと同じ本です。
This is a story written in English.	これは英語で書かれた物語です。
This is the house in which he lived.	これが彼の住んでいた家です。
Look at this large map of America.	この大きなアメリカの地図を見て。
How long have you had this problem?	この症状が出たのはいつですか。
This old table is still in use.	この古いテーブルは今でも使われている。
The title of this play is "Othello".	この劇の題は「オセロ」です。
Please take me to this address.	このアドレスのところに行ってください。
These persons run this country.	こういう人たちが我が国を動かしている。
I'd like to pay by credit card.	クレジットカードで支払いたいのですが。
Kim is older than I am by four years.	キムは私よりも４歳年上だ。
How much money do you have with you?	お金はいくら持っていますか。
Please write down your home address.	お客様の住所を書いて下さい。
Olivier acted the part of Hamlet.	オリビアがハムレットの役を務めた。
When to start is the main problem.	いつ出発するかが大きな問題です。
They are longing for city life.	あの人達は都会の生活にあこがれている。
I bought that record in this store.	あのレコードはこの店で買った。
How long have you been here?	あなたはどれぐらいの時間ここにいるのですか。
How much money do you have with you?	いくらお金をもっていますか。
She will come if you ask her.	あなたが頼めば、彼女はやってくるでしょう。
Which of you will try first?	あなたがたのうちどちらが先にやってみますか。
That is the office where he works.	あそこが彼の働いている会社です。
She returned the book to the library.	彼女は図書館に本を返した。
He is learning how to drive a car.	彼は車の運転の仕方を習っている。
I don't know what to say to Tom.	トムに何と言えばいいのか分からない。
It has been six months as of today. 	今日でちょうど半年を迎えました
Now, another CD has been released.	今、もう一枚のＣＤが発売されました
He has completed a four-year course.	彼が四年間の課程を修了しました
Which is the best way to travel?	旅行方法としてはどれが一番良いですか。
Akiko has some friends in France.	明子はフランスに何人かの友達がいる。
Nagoya is between Tokyo and Osaka.	名古屋は東京と大阪の間にあります。
She did not so much as look at me.	彼女は私を見ることさえしなかった。
She asked me where I was going.	彼女は私にどこに行くのですか、と尋ねた。
She knows the art of making money.	彼女は金もうけのこつを知っている。
She was asked to go out with him.	彼女はデートしてくれと彼に誘われた。
She didn't say a word about it.	彼女はそれについては一言も言わなかった。
She must care for the old man.	彼女はその老人の世話をしなければならない。
I should think she is under thirty.	彼女は３０歳未満だと思いますが。
I can't make out what she is saying.	彼女が言ってる事がわからない。
It's you that she loves, not me.	彼女が愛しているのは僕じゃない、君だ。
I bought them each a present.	彼らひとりひとりにプレゼントをかってやった。
He knows the art of making friends.	彼は友達を作るコツを知っている。
He has been to Switzerland before.	彼は前にスイスへ行ったことがある。
He does not know how to drive a car.	彼は車の運転の仕方を知らない。
He asked me where she lived.	彼は私に、彼女はどこに住んでいるのかと尋ねた。
He said that I must go there.	彼は私がそこへ行かなければならないと言った。
He still comes to see me now and then.	彼は今でも時折訪ねてくる。
He told me where to shop.	彼はどこで買い物をしたらよいか私に教えてくれました。
He would not take the money.	彼はどうしてもその金を受け取ろうとしなかった。
He found the box under the table.	彼はテーブルの下にその箱を見つけた。
He got into the car and drove off.	彼はその車に乗って行ってしまった。
He had no money with him then.	彼はそのとき、お金の持ちあわせがなかった。
He told me about it in private.	彼はそのことを私にこっそり話してくれた。
He's at home in all the sciences.	彼はあらゆる科学について知っている。
He returned from Holland in June.	彼は６月にオランダから帰国しました。
He came to Tokyo at the age of three.	彼は３歳のときに東京に来た。
I don't like the house in which he lives.	彼のいる家は嫌いだ。
He has a large family to provide for.	彼には養うべき大家族がある。
I haven't seen him for a long time.	彼には随分長いこと会っていない。
Have you known him for a long time?	彼と知り合ってもう長いのですか。
Sunday is the first day of the week.	日曜日が一週間の最初の日です。
Tokyo is the largest city in Japan.	東京は日本で最も大きな都市です。
Tokyo is the largest city in Japan.	東京は日本で一番大きい都市です。
The store is open from nine to six.	店は９時から６時まで開いている。
Who could take the place of him?	誰が彼のかわりをすることが出来ようか。
Most signs are written in English.	大部分の標識は英語で書かれている。
We shouldn't look down on other people.	他人を軽蔑すべきでない。
The government provided us with food.	政府は我々に食糧を供給した。
The government provided us with food.	政府は我々に食糧を提供した。
Some people are working in the fields.	数人の人が畑で働いている。
Please visit us in our new office.	新しい事務所にお立ち寄りください。
We have four French classes a week.	週に４回フランス語の授業がある。
As it is, I can not pay you.	実際のところは、私はあなたにお金を払えません。
Time will tell which is right.	時がたてばどちらが正しいかわかるでしょう。
The more you have, the more you want.	持てば持つほど、欲しくなる。
We tried to come up to the standard.	私達は標準に到達しようとした。
We set the time and date for the game.	私達は試合の日時を決めた。
We have different ways of thinking.	私達は違った考え方を持っている。
I will be sixteen years old next year.	私は来年１６歳になります。
I told her to be home by nine.	私は彼女に９時までに帰宅するように言った。
I took note of what he was saying.	私は彼の言っていることに注意した。
I asked him if he would help me.	私は彼に助けてくれるかどうかたずねた。
I asked him to drive me home.	私は彼に車で家まで送ってくれるように頼んだ。
I've got as much money as he has.	私は彼と同じくらいお金を持っている。
I don't know every one of you.	私は諸君のすべてを知っているわけではない。
I am studying English in my room.	私は自分の部屋で英語を勉強している。
I go to the library from time to time.	私は時々図書館に出かける。
I will call on him one of these days.	私は近日中に彼を訪問しよう。
I have a friend who lives in Kyoto.	私は京都に住んでいる友達がいる。
I visited Kushiro for the first time.	私ははじめて釧路を訪問した。
I know some friends of Nancy's.	私はナンシーの友人を何人か知っています。
I got the information at first hand.	私はその情報を直接手に入れた。
I'm not going to take it any more.	私はこれ以上がまんしないつもりだ。
I was given this present by Ann.	私はこのプレゼントをアンからもらった。
I want to see my friends in Canada.	私はカナダにいる友達に会いたい。
I have just returned from Britain.	私はイギリスから戻ったところです。
I do not have much money on hand.	私はあまりお金を持ち合わせていない。
I have an account at that book shop.	私はあの書店ではつけで買える。
I will show you around the city.	私はあなたに町を案内してあげましょう。
I own 1,000 shares of NTT stock.	私はＮＴＴの株を１０００株持っている。
I have visited Kyoto three times.	私は３回京都を訪れたことがあります。
I gave him what little money I had.	私は、なけなしの金を彼にあげた。
I asked him if he knew my name.	私の名前を知っていますかと彼にたずねた。
Please tell me what you know about it.	私にそれを知らせて下さい。
We returned to Osaka on April 2.	私たちは４月２日に大阪から帰ってきた。
I should ask him if I were you.	私がもし君だったら彼に尋ねるでしょうに。
Note down what I'm going to say.	私がこれから言うことを書き留めなさい。
Will you please call me this evening?	今夜電話して下さいませんか。
Not words but action is needed now.	今必要なのは言葉ではなく行動だ。
I must hand in the report today.	今日レポートを提出しなければならない。
On no account must you go out today.	今日は絶対外に出てはいけない。
What have you been doing this week?	今週あなたは何をしていましたか。
I think you had better call on him.	君は彼を訪問した方がよいと思う。
You had better not see her today.	君は今日は彼女に会わないほうがいい。
How did you come by this money?	君はこのお金をどうやって手に入れたのか。
I want you to go to the post office.	君に郵便局へ行ってもらいたい。
We traveled around the country by car.	我々は国中を車で旅行した。
Thousands of people visited the city.	何千もの人がその町を訪れた。
Who are you to tell me to get out?	何の権限で私に出て行けと言うのだ。
You must study English every day.	英語は毎日勉強しなければなりません。
How many English words do you know?	英語の単語を何語知っていますか。
He told us to come on time.	われわれは時間どおりに来るように彼から言われた。
Don't bother to come to my house.	わざわざおいでにならなくて結構です。
It won't be long before we can start.	まもなく出発できるでしょう。
Can I pay for the book by check?	本の代金を小切手で払ってもいいですか。
There! That wasn't long, was it?	ほらごらんなさい。長くなかったでしょ。
Bob and Mary play the recorder.	ボブとメアリーはリコーダーを演奏します。
Don't you want to go to the party?	パーティーに行きたくないのですか。
How did you come to love her?	どんなふうにして彼女を好きになったのですか。
How long does Tony run every day?	トニー君は毎日どれぐらい走りますか。
Can you tell me the time, please?	どうか私に時間を教えてくれませんか。
It is time you get down to work.	そろそろ本気で仕事に取り組むころだよ。
It's about time for him to get here.	そろそろ彼がやってくる時刻だ。
That is why I could not come here.	それが私がこられなかった理由です。
You'll find the book in the library.	その本は図書館にあるでしょう。
The store was not a big one, was it?	その店は大きくなかったですね。
The man asked me for some money.	その男が私にいくらか金をくれと言った。
The new model clicked with the public.	その新型車は大衆にうけた。
The work must be done by Tom.	その仕事はトムによってなさなければならない。
The house gave no sign of life.	その家には人の住んでいる形跡はなかった。
I'll ask how to get there.	そこへ行くにはどうすればよいかを聞いてみましょう。
Now that you say it, I think you're right.	そう言えばそうだ。
How long have you known Jack?	ジャックと知り合ってどのくらいになりますか。
Will you look over these papers?	これらの書類を調べてみてくれませんか。
This is the book about which I told you.	これが君に話した本だ。
This book is as small as that one.	この本はあの本と同じくらい小さい。
This box is not as big as that one.	この箱はあの箱ほど大きくはない。
Will you type this paper for me?	この書類をタイプで打ってくれませんか。
Will you look over these papers?	この書類に目を通しておいてくれますか。
Will you guide me around the city?	この市を案内していただけませんか。
This work can be done within a week.	この仕事は１週間以内にできる。
There are many cities in this country.	この国には多くの市がある。
Is there a post office around here?	このあたりに郵便局はありますか。
How long have you been working here?	ここで働いてどれくらいですか。
Ken has no more than ten books.	ケンはわずか１０冊しか本を持っていない。
Would you like some of those cookies?	クッキーを少しいかがですか。
You had to join that project.	きみはその計画に参加しなければならなかった。
The guide led us to the hotel.	ガイドが私たちをホテルまで案内してくれた。
I will come to your country some day.	いつかあなたの国へ行きます。
When will you return the money to me?	いつお金を返してくれますか。
At your age you should know better.	いい年してそんな馬鹿なまねよせ。
Anne will not come to our party.	アンは私たちのパーティーには来ません。
One evening a man came to my house.	ある夕方、一人の男がやってきた。
He told me he was going to America.	アメリカに行くと彼は私に言った。
That house is much better than this.	あの家はこれよりもずっと良い。
What do you know about him?	あなたは彼についてどういうことを知っていますか。
Did you give it to him last year?	あなたは去年彼にそれをあげましたか。
How long have you been in Japan?	あなたはどのくらい日本においでですか。
How much money do you have with you?	いくら持ち合わせがありますか。
Try to make good use of your time.	あなたの時間をうまく利用しなさい。
I asked for a table over there.	あそこのテーブルをお願いしたいのですが。
It was a week before she got well.	１週間してやっと彼女は良くなった。
No one is so old but he can learn.	年をとりすぎて学べない人はいない。
The page returns to the previous page.	ページが前のページに戻ります
I made more friends before I knew it.	知らぬ間にどんどん仲間が増える
There are eighty thousand items here.	ここには８万ものアイテムが揃う
He tries to get more information.	彼がより多くの情報を入手しようとします
Well done is better than well said.	よき言葉より、よき行いの方が勝る。
Won't you come and see me next week?	来週はうちへいらしゃいませんか。
Mahjong is a game four people play.	麻雀は普通、四人で遊ぶゲームです。
Can I pay for the book by check?	本の代金を小切手で支払ってもよいですか。
Could you show me another one, please?	別のを見せてもらえませんか。
She is reading a book in the library.	彼女は図書館で本を読んでいる。
She gave all her time to the study.	彼女は時間を全部その研究に注いだ。
She said good-by to me for good.	彼女は私にそれを最後にさよならを言った。
She asked me where I was going.	彼女は私に、どこへ行くのですか、と尋ねた。
She worked at the cost of her health.	彼女は健康を犠牲にして働いた。
She needn't have paid the money.	彼女はそのお金を払う必要はなかったのに。
She had returned home long before.	彼女はずっと前に家に帰っていました。
I don't think she cares very much.	彼女はあまり気にかけていないと思う。
They had gone there two days before.	彼らは二日前にそこへ行っていた。
They will be taken good care of.	彼らはちゃんと面倒見てもらえるでしょう。
They are looking into the problem.	彼らはその事件のことを調査している。
They have no house to live in at all.	彼らにはまったく住む家がない。
How much money does he make a month?	彼は毎月お金をいくら稼ぎますか。
He took a job with an insurance company.	彼は保険会社に就職した。
He is older than she is by three years.	彼は彼女より３つ年上です。
He's studying history at university.	彼は大学で歴史を勉強しています。
He is studying law at the university.	彼は大学で法律を勉強している。
He has a large house and two cars.	彼は大きな家と２台の車をもっている。
He gave me food and money as well.	彼は食べ物と、その上にお金もくれた。
I thought he was my special friend.	彼は私の特別な友人だと思っていた。
He came here before school was over.	彼は学校が終わる前にここに来た。
He has visited France three times.	彼はフランスを３回訪れたことがある。
He is the only person that can do it.	彼はそれができる唯一の人です。
He read the story five times over.	彼はその物語を５回繰り返して読んだ。
He is the very man for the job.	彼はその仕事をするのにうってつけの人です。
He's only two years older than Jane.	彼はジェーンより２歳だけ年上だ。
He wrote three books in as many years.	彼は３年間に３冊本を書いた。
He has lived here for one week.	彼は１週間前からずっとここに住んでいます。
Philip found Nathanael and told him.	彼は、ナタナエル見つけていった。
I called him up, but he wasn't there.	彼に電話をかけたがいなかった。
Will you tell him I called?	彼に私から電話があったことをお伝えいただけますか。
He has a large family to provide for.	彼には扶養すべき大家族がある。
He is the only person for the job.	彼こそその仕事にうってつけの人物だ。
Ask him about it when he comes.	彼が来た時、彼にそれについてたずねなさい。
He didn't live to say another word.	彼から２度と言葉は聞かれなかった。
No one could tell where he was.	彼がどこにいるのか、わかる者はいなかった。
Who knows what has become of him?	彼がどうなったかだれがしっていようか。
Do you know what has become of him?	彼がどうしているか知っているかい？
He comes back from Sydney today.	彼がシドニーから戻ってくるのは今日です。
I'll tell him so when he comes here.	彼がここにきたら、そういいます。
Please check on when he will return.	彼がいつ帰るか確かめてください。
"You'd better come in," the man said.	入りなさい、とその男は言った。
Is Sunday the first day of the week?	日曜日が１週間の最初の日ですか。
The money will do for the time being.	当分はその金で間に合うだろう。
The cost of living is very high in Tokyo.	東京での生活費は高い。
You could be here for a long while.	長い間いることになるかもしれない。
Tell me the name of the ninth month.	第９番目の月の名を言ってごらん。
The more you have, the more you want.	多く持てば持つほど欲しくなる。
Mr Murata, this is my friend Lisa.	村田さん、これが僕の友達のリサです。
As many as a thousand people were there.	千人もの人がそこにいた。
You have to buy one at the office.	切符売り場で買わなければなりません。
There used to be a large park here.	昔はここに広い公園があったものだ。
And the world was made through him.	そして世はこの方によって造られた。
The more one has, the more one wants.	人はもてばもつほど欲しくなる。
How long have you been in Kobe?	神戸にはもうどれくらいいらっしゃいますか。
December is the last month of the year.	十二月は一年の最後の月だ。
We have four French classes a week.	週に四回フランスの授業があります。
Please tell me where to go next.	次にどこへ行ったらいいか教えてください。
Try to make good use of your time.	時間を上手く利用するようにしなさい。
Try to make good use of your time.	時間を十分に利用するようにしなさい。
The more you have, the more you want.	持てば持つほど、欲張りになる。
We made the best of our small room.	私達は狭い部屋を最大限に利用した。
I took my place at the end of the line.	私は列の一番後ろに立った。
I work from nine to five every day.	私は毎日９時から５時まで働きます。
I did so with a view to pleasing him.	私は彼を喜ばすためにそうした。
I tried to get him to learn to drive.	私は彼に運転を習わそうとした。
I asked him where he was going.	私は彼にどこへ行くところなのかとたずねた。
I asked him where he was going.	私は彼にどこは行くところなのかとたずねた。
I asked him to be here by six.	私は彼にここに６時までにいてくれとたのんだ。
I come here every Fourth of July.	私は独立記念日にはいつもここに来るの。
I haven't seen her since last month.	私は先月から彼女に会っていない。
I can drive a car, but Tom can't.	私は車を運転できるが、トムはできない。
I go to Hiroshima three times a month.	私は月に３回広島へ行きます。
I ordered those books from Germany.	私はそれらの本をドイツに注文した。
I have no money to buy the book with.	私はその本を買えるお金がない。
I know every word on this page.	私はこのページのすべての単語を知っている。
I have not been studying for two days.	私は２日間勉強していません。
I can only tell you what I know.	私は、知っていることしかお話できません。
I have not more than ten books.	私は、せいぜい１０冊しか本を持っていない。
There are many books in my room.	私の部屋には、たくさんの本があるんです。
Any phone calls for me while I was out?	私の外出中に電話はあった？
My family goes to Italy every year.	私の家族は毎年イタリアに行きます。
I have a friend living in London.	私にはロンドンに住んでいる友人がいる。
We have been to Tokyo many times.	私たちは東京へ何度も行ったことがある。
We must keep up with the times.	私たちは時流とともに進まなければならない。
We were all present at the party.	私たちはみなパーティーに出席していた。
We checked out of the hotel at ten.	私たちはそのホテルを１０時に出た。
Why don't you go to school with us?	私たちといっしょに学校に行かない。
Every time I call on you, you're out.	私が訪ねるたびあなたは留守だ。
As I love her, so she loved me.	私が彼女を愛したように、彼女も私を愛した。
Please tell John that I called.	私から電話があったとジョンに伝えて下さい。
I will go there in place of you.	私があなたの代わりにそこに行きましょう。
Make it a person-to-person call, please.	指名通話でお願いします。
Plan your work before you start it.	始める前に仕事の計画を立てなさい。
Today, we're going to have a good time!	今日は楽しくやりましょう。
Won't you come to my house next Sunday?	今度の日曜日うちへ来ない？
She will care for you from now on.	今から彼女があなたのお世話をします。
Hiromi goes to school five days a week.	広美は週に５日学校に行く。
Please return it by 10 a.m. Monday.	月曜日の１０時までにお返し下さい。
Must you go to the post office?	君は郵便局へ行かなければならないのですか。
All you have to do is try your best.	君は全力を尽くしさえすればよい。
Why did you not go to the office?	君はなぜ事務所へ行かなかったのですか。
Why did you use up all the money?	君はなぜお金をすべて使い果たしたのか。
All you have to do is to join us.	君はただ私たちと一緒に来ればよいのだ。
Do you know what you're asking?	君の求めてるものがどんなものかしってるか。
Does he know that you love him?	君が彼を愛している事を彼は知っていますか。
We returned to Honolulu on April 2.	我々は四月二日にホノルルへ戻った。
The price does not include the case.	価格には箱代は含まれていません。
English is studied all over the world.	英語は世界中で学ばれている。
English is used by many people.	英語はたくさんの人々によって使われている。
The first month of the year is January.	一年の最初の月は一月です。
I will give you back the CD in a week.	一週間後にそのＣＤを返すよ。
We have five English classes a week.	一週間に英語の授業が五回もある。
January is the first month of the year.	一月は年の一番目の月です。
One is new, and the other is old.	一つは新しく、もう一つは古いものです。
There used to be a store right here.	以前ちょうどここに商店があった。
Ricky, this is my friend Suzuki.	リッキー、こちらが私の友人の鈴木君です。
It will not be long before I come back.	まもなく私は戻って来ます。
Mr White wanted to help them.	ホワイト氏は彼らを助けてあげたいと思いました。
Why didn't you note down the points?	なぜ要点を書き留めなかったのか。
The longest day must have an end.	どんなに長い日でも終わりがあるはずだ。
Tom has a house which has two rooms.	トムは２部屋ある家をもっている。
What time do we have to check out?	チェックアウト・タイムは何時ですか。
The library is eighty years old.	その図書館は建てられてから８０年になる。
How many cars has that company bought?	その会社は車を何台買ったか。
I don't know because I wasn't there.	そこにいなかったから知らないよ。
John came running into the room.	ジョンは走りながら部屋の中へ入ってきた。
This will do us for the present.	さしあたり、我々にはこれで間に合います。
How's it going with your family?	ご家族のみなさんはうまくいっていますか。
This is the biggest car in the world.	これは世界で一番大きい車です。
Place this book back where it was.	この本をもとあった場所に戻しなさい。
There is a good market for these articles.	この品は販路が広い。
Their food was great last time.	この前に食べたときはとてもおいしかったよ。
There isn't much money in this business.	この商売は儲かりません。
I had a Nissan before this one.	この車の前は、ニッサン車に乗っていました。
This house is registered in my name.	この家は私の名前で登記してある。
There are no more than six persons here.	ここには６人しかいない。
On no account must you go out today.	今日は絶対に外へ出てはいけない。
Write your name and address, please.	お名前とご住所をお書きください。
I shouldn't have told you nothin'.	おまえなんかに話すんじゃなかったよ。
Not words but action is needed now.	いま必要なのは言葉ではなく行動だ。
How long have you been looking for it?	いつからそれをお探しですか。
They sell good foods at that shop.	あの店では良質の食料品を売っている。
He's the man that was here last week.	あの人は先週ここにいた人です。
How long have you lived in Sanda?	あなたはいつから三田に住んでいますか。
What time did your friend go home?	あなたの友達は何時に帰宅しましたか。
Please tell me your present address.	あなたの現住所を教えてください。
April is the fourth month of the year.	四月は一年の４番目の月です。
Two families live in the same house.	２つの家族が同じ家に住んでいる。
I was allowed to take a week off.	１週間の休暇を取っても良い事になった。
You said so the other day, didn't you?	この間きみはそう言ったよね。
I'm trying mah-jong for the first time.	初めて麻雀にトライします。
I'm getting longsighted as I get older.	老眼になってきたようです。
First, get an international card.	まず、インターナショナルカードを作ります
He learns about the history of that time.	彼が当時の歴史を学びます
That accounted for 45.4% of the total.	それが全体の４５．４％を占めた
She was in the house before I knew it.	彼女がいつの間にか家の中に居る
He gets the most out of the information.	彼がこれらの情報を活用する
He checked out a book from the library.	彼が図書館で１冊の本を借りた
I keep a record of news reports every day.	ニュースを毎日記録する
I drive out to go shopping every day.	私が毎日、買い物に車で出掛けます
People who like RPGs will like this.	ＲＰＧが好きな人にはぜひオススメだ
He can't keep up with the times at all.	彼が全然時代の波に乗れません
You can create a jpeg image file.	ｊｐｅｇ形式の画像ファイルを作成できます
Did you go to Rome during your travels?	旅行中ローマへ行きましたか。
I'll be in Tokyo on business next week.	来週私は仕事で東京にいます。
Come and see me on Sunday next week.	来週の日曜日に遊びに来てください。
How do you go to school every day?	毎日どのようにして学校へ行くのですか。
How do you go to school every day?	毎日どのようにして学校にいくのですか。
Please tell me a place to read books.	本が読める場所を教えてください。
What's the name of your insurance company?	保険の名前は何ですか。
She bought a new house the other day.	彼女は先日新しい家を買いました。
I think she's over 40 years old.	彼女は少なくとも４０才は越えていると思う。
She loves Tom more than she does me.	彼女は私よりトムの方を愛している。
She is going to learn how to drive.	彼女は近く運転を習うつもりでいます。
She is no longer what she used to be.	彼女はもはや以前の彼女ではない。
Before long, she came into my room.	彼女はまもなく私の部屋に入ってきた。
No one knows what has become of her.	彼女はどうなったのか誰も知らない。
She got into the car and drove off.	彼女はその車に乗って行ってしまった。
She knows that John loved her.	彼女はジョンが愛してくれているのを知っている。
She told me that she had bought a CD.	彼女はＣＤを買ったと私に言った。
I can't make out what she is saying.	彼女のいっていることがわからない。
Her look says that she loves you.	彼女が好きなことは彼女の目をみてわかる。
They requested him to do the job.	彼らは彼にその仕事をするように要請した。
They have lived here for a long time.	彼らは長い時間ここに住んでいる。
They are looking for a house to live in.	彼らは住む家を探している。
They make good use of their rooms.	彼らは自分の部屋をうまく利用している。
They gave a big party for me.	彼らは私のために盛大なパーティーを開いてくれた。
They were in Joe's class last year.	彼らは去年ジョーのクラスにいました。
They called off their visit to London.	彼らはロンドン行きを中止した。
They are trying to keep costs down.	彼らはコストを押さえようとしている。
He asked if I liked Chinese food.	彼は私に中華料理が好きかどうかたずねた。
He bought as many books as he liked.	彼は好きなだけの本をすべて買った。
He was seen to come out of the house.	彼は家からでてくるのを見られた。
He has been to Europe many times.	彼は何度もヨーロッパに行ったことがある。
He has designs on your property.	彼はひそかにあなたの財産を狙っていますよ。
He had much to do with the project.	彼はその計画におおいに関係があった。
He likes that video game very much.	彼はそのテレビゲームがとても好きだ。
Could you make out what he was saying?	彼の言ってた事、分かったかい。
Could you make out what he was saying?	彼の言ってたことが解ったかい。
I wasn't content to work under him.	彼の下で働くのでは満足できなかった。
Do you know the way that he does it?	彼のそれのやり方を知っていますか。
What he needs is not money but love.	彼に必要なのはお金ではなく愛です。
He has a large family to support.	彼には養わなければならない大家族がある。
You'd better not keep company with him.	彼と付き合わない方がいいよ。
It is Egypt that he wants to visit.	彼が行きたがっているのはエジプトだ。
Are you taking in all he is saying?	彼が云っている事を全部理解できるの。
He made the company what it is today.	彼がその会社を現在のようにした。
It is said that he wrote this book.	彼がこの本を書いたと言われています。
Do you have many friends here in Japan?	日本には友達が大勢いますか。
Where should I check in for Tokyo?	東京行きはどこでチェックインできるか。
The long game came to an end at last.	長く続いた試合がやっと終わった。
Mr Aoyama has a large family to support.	青山さんは養う家族が多い。
That's only because you don't have to do it.	人ごとだと思って。
Sign your name at the end of the paper.	書類の終わりに署名しなさい。
Could you please sign the register?	宿泊者名簿に記入していただけますか。
Give me what you have in your hand.	手に持っているものを私に渡しなさい。
Try to make the most of your time.	時間を最大限に活用するようにしなさい。
Try to make good use of your time.	時間をうまく利用するように努めなさい。
The more one has, the more one wants.	持てば持つほど、人は貧しくなる。
We think of the plan as of value.	私達は、その計画を価値あるものと見なす。
Our school is in the south of the city.	私達の学校は市の南部にある。
We returned to Honolulu on April 2.	私達４月２日にホノルルに帰ってきた。
I allowed her to go to the party.	私は彼女がパーティーに行くのを許可した。
I'm only three years older than he is.	私は彼よりも３歳だけ年上です。
I told him what to see in Kyoto.	私は彼に京都で何を見たらいいか教えました。
I love you better than he.	私は彼があなたを愛している以上にあなたを愛しています。
I've studied Japanese for five years.	私は日本語を５年間勉強している。
I don't like visiting big cities.	私は大きな都市を訪れるのは好きではない。
I'll support you as long as I live.	私は生きている限りあなたを援助する。
I am very pleased with my new house.	私は新しい家に完全に満足している。
I study English on Monday and Friday.	私は月曜と金曜に英語を勉強する。
I have lived in Kobe since last year.	私は去年から神戸に住んでいるの。
I see him in the library now and then.	私はときどき図書館で彼に会う。
I have been here for about three weeks.	私はおよそ３週間ここにいる。
I don't like music as much as you do.	私はあなたほど音楽は好きでない。
My hand came into contact with her hand.	私の手が彼女の手に触れた。
That's just what I was going to say.	私の言わんとするところもそこです。
I have a friend who lives in England.	私にはイギリスに住む友人がいる。
We study English in the same class.	私たちは同じ学級で英語を勉強します。
I'll help you as long as I live.	私が生きている限りは君を援助してあげよう。
It is not money but time that I want.	私がほしいのは金ではなく時間だ。
At first each man had paid $10.	始めそれぞれの男性は１０ドルずつ払いました。
I'm seeing my old friend this evening.	今日の夕方私は旧友に会います。
We sent you the book at your request.	御依頼により本をお送りしました。
Many people work in this field now.	現在多くの人がこの分野で働いている。
Ken has been to England before.	健は以前イングランドに行ったことがあります。
You have to learn standard English.	君は標準英語を学ばなくてはいけない。
Do you want to see her very much?	君は彼女に会いたくてたまらないのですか。
You must do as you are told to do.	君は言われた通りにしなければならない。
You must go through with your plan.	君は計画を遣り通さなければならない。
You have only to sign your name here.	君はここに署名しさえすればよい。
We Japanese come of age at twenty.	我々日本人は二十歳で大人の年齢になる。
London is large, compared with Paris.	ロンドンはパリに比べると大きい。
Lucy has as many friends as I do.	ルーシーには私と同じぐらい友達がいます。
Of course, I will be at the party.	もちろん私はそのパーティーに行きます。
I can't live any longer without him.	もう、彼がいないと生きていけない！
First find out her name and address.	まず彼女の名前と住所を調べなさい。
The French are said to love art.	フランス人は芸術を愛好すると言われている。
I would like to come to your party.	パーティーには是非伺いたく存じます。
I must help her at any cost.	どんな犠牲を払っても、彼女を助けなければならない。
I like English best of all subjects.	どの科目よりも英語が一番好きです。
Just then she came into my room.	ちょうどその時彼女が私の部屋に入ってきた。
That was, as it were, part of the job.	それはいわば仕事の一部だった。
This and that are two different stories.	それとこれとは話が別だよ。
And where is the money coming from?	それで、その金はどこから出るんだね？
Those new model cars are on the market.	その新型車が市場に出ている。
Could you tell me how to get there?	そこへはどうやって行けばよいですか。
Singapore has one big problem.	シンガポールは１つの大きな問題を抱えています。
John doesn't know what to do next.	ジョンは次に何をするべきかわからない。
Jim is learning how to drive a car.	ジムは車の運転の仕方を学んでいます。
Can you change this into small money?	これを小銭に換えてもらえますか。
These products are of the same quality.	これらの製品は同じ品質です。
This is all the money I have now.	これは今私が持っているすべてのお金です。
This book is less large than that one.	この本はあの本ほど大きくない。
How long can I keep this book?	この本どのくらいお借りしていてよろしいですか。
Please get these papers out of the way.	この書類を片付けてください。
Please tell her to call me back.	お電話して下さいと、お伝えいただけますか。
Will you go to America next month?	あなたは来月アメリカに行く予定ですか。
Are you pleased with your new house?	あなたは新しい家に満足してますか。
Tell me the time when you will come.	あなたが来る時間を教えてください。
You need not write more than 400 words.	４００語以上書く必要はない。
I will get the work done in a week.	１週間でその仕事をやり遂げましょう。
"No, I don't," said Mr Jordan.	「はい、ありません」とジョーダンさんは答えた。
Tom asked Mary what her last name was.	トムはメアリーに苗字を訊いた。
This is the point we need to think about.	ここが思案のしどころだ。
He will ask local people to work for me.	彼が現地の人に私の仕事を頼む
Well, at any rate, all the food is good.	とにかく全ての料理が美味しい
We need another person to play cards.	トランプをするのにもう一人必要だ。
The old people were taken good care of.	老人たちは十分な世話を受けた。
Where can I find a place to change money?	両替所はどこにありますか。
Could you act for me while I'm out?	留守の間私の代理をしていただけますか。
Next year, we'll be starting college.	来年私たちは大学生活が始まります。
He has a large family to support.	養っていかねばならない大家族がいるのです。
Please come into the room one by one.	部屋の中に一人づつ入ってください。
She is said to be in love with him.	彼女は彼に恋をしていると言われている。
She gave him money as well as food.	彼女は彼に食べ物だけでなく金も与えた。
She used the car to go to the office.	彼女は事務所に行くのに車を使った。
She likes to play the koto very much.	彼女は琴を弾くことがとても好きだ。
I thought she was my special friend.	彼女は私の特別な友人だと思っていた。
She goes under the name of Yotchan.	彼女はヨッチャンという名を使っている。
She won't have this job much longer.	彼女はこの仕事を長くできないだろう。
She got through her work before five.	彼女は５時前に自分の仕事を終えた。
No one could tell where she was.	彼女がどこにいるのか、わかる者はいなかった。
They have a large stock of information.	彼らは豊富な情報をもっている。
They like to look back on old times.	彼らは昔のことを回想するのが好きだ。
They compared the new car with the old one.	彼らは古い車と比べた。
They like to look back on old times.	彼らの昔のことを回想するのが好きだ。
He has to take two science classes.	彼は理科を２科目とらなければならない。
He looked around, but he saw no one.	彼は辺りを見回したが誰もいなかった。
He was asked to give her some money.	彼は彼女にお金をやるように頼まれた。
He is a member of the board of the company.	彼は同社の取締役です。
He reads ten books a month at least.	彼は少なくとも月に１０冊は本を読む。
He played the game as best he could.	彼は出来るだけ一生懸命に試合をした。
He comes to visit us every now and then.	彼は時々私たちを訪ねてくる。
He is the last person I want to see now.	彼は今一番会いたくない人だ。
He still writes to me from time to time.	彼は今でも時々手紙をくれる。
He has experience as well as learning.	彼は学問ばかりでなく経験もある。
He has much more money than I have.	彼はぼくよりたくさんお金を持っている。
He doesn't have the time to play cards.	彼はトランプをするときがない。
How long has he lived in London?	彼はどのくらいロンドンに住んでいるのですか。
He told me that he was going to Italy.	彼はイタリアに行くと私に言った。
He made friends with her in America.	彼はアメリカで彼女と友だちになった。
There wasn't much in what he said.	彼の言ったことにはあまり内容がなかった。
What he needs most is a good job.	彼が最も必要としているのはよい仕事である。
I gave him as much food as he wanted.	彼がほしがるだけの食べ物を与えた。
I don't know what plan he will try.	彼がどんな計画を試みるのかわからない。
I'll tell him so when he comes here.	彼がここへ来たら、彼にそう言います。
I'll tell him so when he comes here.	彼がここに来たら、彼にそう言います。
The university paid my way to Japan.	日本行きの費用を大学が出してくれた。
It is ten years since he came to Japan.	日本に来てから十年になります。
How about getting the special of the day?	日替わり定食にしませんか。
My family was well off in those days.	当時我が家は暮らし向きがよかった。
China is the largest country in Asia.	中国はアジアで最も広大な国である。
As long as we live, we should work.	生きてる限りは、働かなければならない。
Some people compare life to a story.	人生を一つの物語にたとえる人もいる。
The more we have, the more we want.	人は持てばもつほどなおさら欲しくなる。
Please come to see us at our new place.	新居にも是非遊びに来て下さい。
The seventh day of the week is Saturday.	週の７番目の日は土曜日です。
I haven't got much money with me.	手元にあまりお金の持ち合わせがありません。
How long will it take to get well?	治るのにどのくらいの期間がかかりますか。
Can you come at ten on May second?	次の予約は５月２日の１０時でいいですか。
He ran so he would get there on time.	時間どおりに着くために彼は走った。
We returned to Honolulu on April 2.	私達は４月２日にホノルルに帰ってきた。
He goes to school to study every day.	私は毎日勉強するために学校へ行く。
I have three times as many books as he.	私は彼の３倍の本を持っている。
I will get him to come and help me.	私は彼に手伝いに来てもらうつもりです。
I didn't know what to say to him.	私は彼に何と言ったら良いかわからなかった。
I know who lives in this house.	私は誰がこの家に住んでいるのかを知っています。
I visited New York for the first time.	私は初めてニューヨークを訪れた。
I go to school because I want to learn.	私は学びたいので、学校へ行く。
I'd like to visit America most of all.	私はとりわけアメリカに行きたい。
I read the book from cover to cover.	私はその本をすみからすみまで読んだ。
I will go and take a look at the house.	私はその家を見に行こうと思う。
I asked twenty friends to the party.	私は友人を２０人パーティーに招いた。
I have lived in Tokyo since 1985.	私は１９８５年からずっと東京に住んでいる。
I studied English when I was there.	私は、そこにいた時に英語を学びました。
We study English at school every day.	私たちは毎日学校で英語を勉強する。
We could not find out her address.	私たちは彼女の住所を見つけ出せなかった。
We've been close friends for many years.	私たちは長年親しくしている。
We must work as long as we live.	私たちは生きている限り働かなければならない。
We must keep up with the times.	私たちは時勢に遅れずについていかねばならない。
We had to do without a TV set.	私たちはテレビなしですまさなければならなかった。
That was my first visit to Japan.	私が日本に行ったのはそれが初めてのことだ。
You mustn't go out now. Why not?	今でかけてはいけないの。どうしていけないの。
I'm very low on change right now.	今、小銭の持ち合わせがほとんどないのです。
It goes without saying that I love you.	君を好きなのは言うまでもない。
You should know better at your age.	君の年齢なら、もっと分別があるべきだ。
I can not make out at all what you say.	君の言うことは全く分からない。
I think what you're doing is right.	あなたのやっていることは正しいと思う。
My education has made me what I am.	教育のおかげで私は今日のようになった。
What subjects do you study at school?	学校ではどんな科目を勉強しますか。
Our school is very close to the park.	我々の学校は公園のすぐ近くにある。
I've been going out with her for months.	何ヶ月か彼女と交際している。
How many English words do you know?	英語の単語をどれくらい知っていますか。
Within every man are thousands.	一人の個人の中に幾千ものことなった人間がいる。
I shall see him in less than a week.	一週間たたないうちに彼に会うだろう。
I wrote off for an application form.	わたしは手紙で願書を送るよう決めた。
You are doing very well. Keep it up.	よくやっているよ。その調子で続けて。
Please tell me if I get in your way.	もしじゃまだったら、そう言ってくれ。
I think I'll look around a little more.	もう少し見て回ろうと思います。
A little more to the right, just like so!	もう少し右の方へ―ようし！
It will not be long before he gets well.	もうすぐ彼はよくなるだろう。
It won't be long before he returns home.	まもなく彼は帰宅するだろう。
I should sell it while it still runs.	まだ動くうちに売ってしまわなきゃ。
First of all, I must say this.	まず最初に、私はこのことを言わなければならない。
Mike is the only man on the board.	マイクはその委員会で唯ひとりの男性です。
Are you going to visit any other countries?	ほかの国を回りますか。
He says he has been to Hawaii before.	ハワイにいった事があると彼が言う。
Why should she have sent for him?	なぜ彼女は彼を呼びにやる必要があったのか。
Tell me why you want to go there.	なぜそこへ行きたいのか、私に教えて下さい。
Please tell me where you will live.	どこに住むつもりなのか教えてください。
I was just thinking of a new job.	ちょうど新しい仕事のことを考えていたんだ。
The days are getting longer and longer.	だんだん日が長くなっています。
That is what they study English for.	それが彼らが英語を勉強する目的です。
The man is checking in at a hotel.	その男性はホテルにチェックインしている。
Since that time we have not seen him.	その時以来私達は彼にあっていない。
You should have said so at that time.	その時あなたはそう言うべきでした。
There was no sign of life in the house.	その家には人の気配はなかった。
Why didn't you do so at that time?	そのときなぜ君はそうしなかったのですか。
How long will it take to get there?	そこへ着くのにどれぐらいかかりますか。
It is very good of you to say so.	そう言っていただいてとてもありがたいです。
John and Mary loved each other.	ジョンとメアリーはお互いに愛し合っていました。
"May I go with you?" "Of course."	「ご一緒してもいいですか」「もちろんです」
I don't want to take on any more work.	これ以上仕事は引き受けたくない。
I'd like to send this by registered mail.	これを書留でお願いします。
Will you look over these papers?	これらの書類に目をとおしていただけませんか。
Please keep my place in this line.	この列の私の場所を取っておいてください。
This video recorder doesn't work right.	このビデオは正しく機能しない。
This money will allow me to buy a car.	このお金のおかげで車が買えます。
Is there a public phone around here?	このあたりに公衆電話はありませんか。
Prices have gone up these three months.	ここ三ヶ月物価が上昇しました。
Some say this, and others say that.	こう言う人もいれば、ああ言う人もいる。
You will get well in a week or so.	きみは一週間かそこらでよくなるでしょう。
You should know better at your age.	おまえの年ではもっと分別があるべきだ。
You must take life as it is.	あなたは人生をあるがままに受け入れなければならない。
You must help set the table.	あなたは食卓の用意をするのを手伝わなければいけない。
How long have you been in Kushiro?	あなたはどのくらい長く釧路にいましたか。
Which group do you want to join?	あなたはどちらのグループに加わりたいですか。
How did you come by the money?	あなたはどうやってそのお金を手に入れたのですか。
How many books do you read a month?	あなたは１ヶ月に何冊の本を読みますか。
Have you known her since 1990?	あなたは１９９０年から彼女を知っているのですか？
Should I have asked you first?	あなたにはまず最初に尋ねるべきだったでしょうか。
Please tell me what you saw then.	あなたがその時に何を見たのか話して下さい。
Take it to the men in Room 318.	３１８号室のお客さんに持って行ってあげなさい。
How about February 28th around 3:00 pm?	２月２８日の午後３時頃はどう。
"Is he right?" "I don't think so."	「彼は正しいですか」「そうは思いません」
I don't want to be better than him.	彼が常に上の存在であって欲しいと思います
It is the same even if there are changes.	変更があったときも同様とする
He wrote three books by the age of 75.	彼が７５歳までに本を３冊書きました
He does the work of one week in a day.	彼が１日で１週間分の仕事をやります
The problem is which way I should take.	問題は自分がどちらの道を選ぶかだ
People were still living in that house.	その家にはまだ人が住んでいました
We're having a party next Saturday.	来週の土曜にパーティーを開くつもりです。
There will be no school a week from today.	来週の今日は学校は休みだ。
Why didn't you phone before coming?	来る前になぜ電話をかけてくれなかったの。
She'll come even if you tell her not to.	来るなといっても彼女は来るよ。
I can't make out what you're saying.	僕は君の言っていることがわかりません。
She has good control over her class.	彼女は担任のクラスをよく把握している。
She has good control over her class.	彼女は担任のクラスをよく掌握している。
She doesn't know how to drive a car.	彼女は車の運転のしかたがわかりません。
She did all she could on my account.	彼女は私のできる限りの事をしてくれた。
She traveled around the world last year.	彼女は昨年世界一周旅行をした。
She goes to the library every other day.	彼女は一日おきに図書館へ行く。
She goes to the library every other day.	彼女は一日おきに図書館に行く。
She gave me access to her records.	彼女はレコードを聞いていいと言ってくれた。
It will not be long before she comes back.	彼女はまもなく戻るだろう。
She had the care of many older people.	彼女はたくさんの老人の面倒をみた。
She had gone there ten years before.	彼女はその１０年前にそこに行っていた。
You should have asked her for help.	彼女に手伝ってくれるよう頼むべきだった。
Her look says that she loves you.	彼女が君を好きなのは彼女の目を見れば分かる。
Her look says that she loves you.	彼女が君を好きなことは彼女の目つきでわかる。
They started studying English last year.	彼らは去年英語の勉強を始めた。
He is going to study English next week.	彼は来週英語を勉強する予定です。
He has a large family to support.	彼は養っていかなければならない大家族がある。
He goes to the library to read books.	彼は本を読むために図書館へ行きます。
He doesn't go to the office on Saturday.	彼は土曜日には会社に行かない。
I think he will come to our party.	彼は私たちのパーティーに来るとおもいます。
He has more experience on the job than I.	彼は仕事の上では私の先輩だ。
He doesn't have to go to school today.	彼は今日は学校へ行かなくてもいい。
He doesn't have to go to school today.	彼は今日は学校に行かなくてもよい。
He is the best player on our team.	彼は我々のチームで最もすぐれた選手である。
He traveled to Hawaii with the family.	彼は家族と一緒にハワイに旅行した。
He was seen going out of the house.	彼は家から出かけるところをみられました。
He will come back in another two weeks.	彼はもう２週間すると帰ってくる。
He gave her what little money he had.	彼はなけなしの金を全部彼女にあげた。
He wants to live as long as he can.	彼はできるだけ長く生きたいと思っている。
He told me to do it, so I did it.	彼はそれをするように言ったので私はそうした。
He had a share in completing the job.	彼はその仕事を完成するのに貢献した。
Are you taking in all he is saying?	彼の言っていることがぜんぶ理解できるの？
I will tell him so when he comes back.	彼が戻ってきたらそう話しましょう。
It is better not to go out of your field.	畑違いの事はしない方がいい。
The Japanese like to travel in groups.	日本人は集団で旅行するのが好きだ。
Japanese is not used in this country.	日本語はこの国では使われていません。
Which is larger, Japan or Britain?	日本とイギリスではどちらが大きいのですか。
China is twenty times as large as Japan.	中国は日本の２０倍の大きさだ。
Had I known it, I would have told you.	知っていれば教えてあげたんだけど。
No one can keep me from going there.	私はそこに行く。誰も私を止められない。
Ten games were played on the first day.	第１日目には１０試合が行われた。
A man is known by the company he keeps.	人は付き合っている人間でわかる。
Will you tell me how to get to Shinjuku?	新宿に行く道を教えてください。
There was room for one person in the car.	車には一人分の空きがあった。
I gave him what little money I had.	持っていたお金は少ないが全部彼にあげた。
We get the materials from Malaysia.	私達は原料をマレーシアから仕入れている。
We checked in at the hotel at three.	私達は３時にホテルでチェックインした。
I'm looking for a gift for my friend.	私は友人にあげる贈り物を探している。
I did that which she asked me to do.	私は彼女にするように頼まれことをした。
I do not know every one of them.	私は彼らの全部を知っているというわけではない。
I asked him if I could read them.	私は彼に私がそれらを読めるかどうかたずねた。
I can't make out what he was saying.	私は彼が言っていたことが理解できない。
I have just returned from Britain.	私はちょうどイギリスから帰ったところです。
I don't like any of these records.	私はこれらのレコードのどれも好きではない。
My plan is to study in Australia.	私の計画はオーストラリアで勉強することです。
My e-mail address has been changed.	私のｅ―ｍａｉｌアドレスが変わりました。
I didn't know what to say to him.	私には彼に何といったら良いか分からなかった。
I have a friend who lives in Sapporo.	私には札幌に住んでいる友達がいます。
I have a friend who works for NASA.	私にはＮＡＳＡで働いている友達がいます。
We will be living here next month.	私たちは来月ここに住んでいることでしょう。
We have been good friends for a long time.	私たちは長い間の友人です。
We must keep up with the times.	私たちは時勢に遅れないようにしなければならない。
We must keep up with the times.	私たちは時勢に遅れずついていかなければならない。
We have come to pay you a visit.	私たちはあなたにお目にかかるために伺いました。
Our school library has many books.	私たちの学校の図書館には本がたくさんある。
Every time I call on you, you are out.	私が訪ねるといつもあなたは留守だ。
This is all that I know about him.	私が彼について知っているのはこれだけです。
It is ten years since I came to Tokyo.	私が東京に来てから十年になります。
I'll offer him what help I can.	私が出来る限りの援助を彼に差しのべるつもりです。
I was called into the office first.	私が最初にオフィスに入るように呼ばれた。
Please tell me what I should do first.	最初に何をすべきか教えてください。
What are you going to do this evening?	今夜あなたは何をするつもりですか。
Come to my house at the end of this month.	今月末に僕の家にきなさい。
You had better not keep company with him.	君は彼と交際しない方がよい。
You're giving me the same old line.	君は相変わらず同じような電話しくれない。
You must go through with your plan.	君はその計画をやり通さなければならない。
Compared with yours, my car is small.	君の車と比べれば、ぼくの車は小さい。
I love you more than you love me.	君が私を愛している以上に私は君を愛している。
He will be studying when you get up.	君が起きるころには彼は勉強しているよ。
There are many places to visit in Kyoto.	京都には訪問すべき都市が多い。
There are many places to see in Kyoto.	京都には見るべきところが多くある。
We had better do what other people do.	我々も世間なみのことをしなくちゃ。
We must think about the community.	我々は地域社会について考えないといけない。
We must keep up with the times.	我々は時勢に遅れずに付いて行かなければならない。
How many books can I take out at one time?	一度に何冊借りられますか。
We must work as long as we live.	われわれは生きているかぎりは働かねばならない。
While in London, she studied English.	ロンドン滞在中彼女は英語を勉強した。
Who was looking for the record shop?	レコード店を探しているのは誰でしたか。
Of course you can take it if you want.	もちろん欲しければとってもいいよ。
Of course, we must do our best.	もちろんわれわれは最善を尽くさなければならない。
If he were here, what would he say?	もし彼がここにいたら、なんと言うだろう？
More and more people offered to help.	ますます多くの人々が援助を申し出た。
Did Paula study for today's test?	ポーラは今日のテストのために勉強しましたか。
He says he has been to Hawaii before.	ハワイに行ったことがあると彼は言う。
I'll look you up when I visit New York.	ニューヨークへ行ったら訪ねるよ。
Why do you need to read such a book?	なぜそんな本を読む必要があるのですか。
Tell me why you want to go there.	なぜそこに行きたいのか、私に教えてください。
Why do you study English every day?	なぜあなたは毎日英語を勉強するのですか。
Please tell me where to park my car.	どこに駐車したらいいか教えてください。
Please write down your name here.	どうぞ、ここにあなたの名前を書いてください。
But what will you do if he doesn't come?	でも、来なかったらどうするの。
Can you take over driving for a while?	ちょっと運転を代わってくれないか。
I'd like to see that in black and white.	それを文書で見たいと思います。
They are more or less the same size.	それらはだいたい同じくらいの大きさだ。
How did you come by that much money?	その大金をどうして手に入れたのですか。
The new store is going to open next week.	その新しい店は来週開きます。
Do your best to complete the work.	その仕事を完成するよう全力を尽くしなさい。
The country is supported by industry.	その国は産業によって支えられている。
Did you tell the news to your friends?	そのニュースを友達に話しましたか。
I made my first contact with him there.	そこで私は初めて彼と知り合った。
Here it is, all in black and white.	これです。全部書類にして持ってきたのは。
This information checks out all right.	この情報は調べたところ間違いない。
Will you sign your name on this paper?	この書類に署名していただけますか。
I say this from my own experience.	この事は私自身の体験から言っているのです。
How many credits can I get for this course?	この教科は何単位ですか。
This department store is closed today.	このデパートは今日は閉まっている。
Prices have gone up these three months.	ここ３か月、物価が上昇しました。
I asked you if you wanted some help.	お手伝いしましょうかっていったんです。
Please take with you as much as you need.	いるだけ持っていらっしゃい。
Would you tell me when to get off?	いつ降りたらいいのか教えていただけますか。
How long have you been studying English?	いつから英語を習っているのか。
How long have you been looking for it?	いつからそれを探しているのですか。
I think we're out of your size.	お客様のサイズは切らしてしまっているようですが。
Where have you been all this while?	あなたは今までどこに行っていたのですか。
You must go through with your plan.	あなたは計画をやり通さなければならない。
How long have you lived in Kobe?	あなたはどのくらいの間、神戸に住んでいますか。
I'd like to have a word with you.	あなたとちょっと個人的に話をする必要がある。
Tell me what you want me to do.	あなたが私にしてもらいたいことを言ってください。
Three out of ten persons have a video.	１０人中３人はビデオを持っている。
Yamada and Sato said it at the same time.	山田さんと佐藤さんが同時に言う
We will ask your personal information.	当社がお客様の個人情報をお伺いします
The only way to have a friend is to be one.	友を得んとすれば友となれ。
He wasn't at home when I called on him.	僕が訪ねて行った時彼は不在だった。
Miyuki set the table for the party.	美雪はパーティーのためにテーブルを整えた。
She is very good at changing the subject.	彼女は話題を変えるのがうまい。
She said he would be sixteen next month.	彼女は来月１６歳になると言った。
She came in company with her friends.	彼女は友人たちといっしょにやって来た。
He asked me what had become of her.	彼女はどうなったのだい、と彼は私に尋ねた。
She thought that John had loved her.	彼女はジョンが愛してくれていたと思った。
She told me this story off the record.	彼女はオフレコでこの話をしてくれた。
She does not have many friends in Kyoto.	彼女は京都にあまり友達がいない。
She had lived in five different countries.	彼女は５カ国で暮らしていた。
She can't so much as write her own name.	彼女は、自分の名前さえ書けない。
She should know better at her age.	彼女の年齢ではもっと分別がなくてはならない。
All the more so to think well of him.	彼をよく思うのはそれだけの理由がある。
How long did they live in England?	彼らはイギリスにどれくらい住んでいましたか。
He gives me a phone call every now and then.	彼は時々電話をくれます。
He has the least money of us all.	彼は私たちすべての中で一番お金を持っていない。
He has not only learning but experience.	彼は学識ばかりでなく経験もある。
He has gone to Italy to study music.	彼は音楽の勉強のため、イタリアに行った。
He was a big man called Little John.	彼はリトル・ジョンと呼ばれる大男だった。
He will be in New York for two weeks.	彼はニューヨークに２週間いるでしょう。
He lives some where about the park.	彼はどこかその公園にのあたりに住んでいる。
He looked around, but he saw no one.	彼はあたりを見回したが誰もみえなかった。
It is all the same to me where he goes.	彼がどこへ行こうと私には同じ事だ。
See to it that he does not go there.	彼がそこへ行かないように気をつけなさい。
How long is it since you came to Japan?	日本に来てどれくらいになりますか？
How long have you lived in Japan?	日本に住むようになってどのくらいになりますか。
The days are getting longer and longer.	日がだんだん長くなってきています。
We have hundreds of records in stock.	当店ではレコードの在庫が多数あります。
First of all, I want to tell you this.	第一に君にこのことを言っておきたい。
Any car will do, as long as it runs.	走りさえすれば、どんな車でもよいのです。
I ran into Mary at a party last week.	先週パーティーでメアリーに偶然会った。
Both our food and water were running out.	食料も水も底をつきかけてきた。
Haruki doesn't have much money with him.	春樹はあまりお金を持っていない。
Tell me what you have in your hand.	手になにを持っているか私に教えてください。
Jiro doesn't have to go to school today.	次郎は今日学校へ行く必要がない。
We may have to go without her.	私達は彼女を置いていかなければならないかもしれない。
What was it that we were told to do?	私達はなにをするように言われたのだっけ。
I am going to start a new job next week.	私は来週、新しい仕事を始めます。
I didn't know what to say to him.	私は彼になんて言ったらいいのかわからなかった。
I bought a new computer last month.	私は先月新しいコンピューターを買いました。
I think I'll take the test this time.	私は今度、テストを受けようと思います。
I must return home within a week.	私は一週間以内に故郷に帰らなければなりません。
I didn't need to pay for the food.	私はその食べ物の代金を払わなくてもよかった。
I don't know much about computers.	私はコンピューターについてあまり知識がない。
I'm trying to work out this problem.	私はこの問題を解こうとしているところだ。
I was on my own during these months.	私はこの数ヶ月間自分一人で生活していた。
I have four times more CDs than you do.	私はあなたの四倍ＣＤを持っている。
I can't allow you to do that.	私はあなたがそんな事をするのを許すわけにはいきません。
Please don't go out of your way on my account.	私の事はお構いなく。
I didn't know what to say to him.	私には彼になんて言ったら良いか分からなかった。
I have a friend who lives in America.	私にはアメリカに住んでいる友人がいる。
We must keep up with the times.	私たちは時勢に遅れずに付いていかなければならない。
We study many subjects in high school.	私たちは高校で多くの科目を勉強する。
We have the same problems as you.	私たちは君たちと同じような問題を抱えています。
Our school library is small, but new.	私たちの学校の図書館は小さいが新しい。
This is all the money that I have now.	私が今もっているお金はこれだけです。
When I came home, Tom was studying.	私が帰宅したとき、トムは勉強していました。
I'll call you up around eight this evening.	今夜、８時頃に電話します。
What have you been doing all this while?	今まで君は何をしていたのですか。
Now is the time when we need him most.	今は私達が彼を最も必要とする時です。
What do you say to going for a drive now?	今からドライブに行きませんか。
How many classes do you have on Monday?	月曜日には何時間授業がありますか。
I'd like a room with a good view, please.	景色のよい部屋をお願いします。
Do you have to go there every day?	君は毎日そこへいかなくてはならないのですか。
You don't have to come here every day.	君は毎日ここに来る必要はありません。
You've got it in one. That's right.	君はすぐに分かったんだね。そのとおりだよ。
How many schools are there in your city?	君の町にいくつ学校がありますか。
How many rooms are there in your house?	君の家には部屋がいくつありますか。
We had to learn to read the word.	我々は単語の読み方を覚えなければならなかった。
Our company has a long, long history.	我が社はとても長い歴史をもっています。
A well is a place where you can get water.	井戸は水を得られる所である。
While in Europe, she visited Rome.	ヨーロッパにいる間に、彼女はローマを訪れた。
If he comes, show him into my room.	もし彼がきたら、私の部屋に通してください。
Can't go back; no place to go back to.	もう戻れない、戻る場所もわからない。
How long have you been living in Tokyo?	もうどのくらい東京にいるのですか。
Mike got back from the library at five.	マイクは図書館から五時にもどった。
Are you going to visit any other countries?	ほかの国にも旅行しますか。
I don't know why you don't like him.	なぜ君が彼を嫌いなのか僕にはわからない。
I wouldn't sell that at any price.	どんな値段であっても私はそれを売りたくない。
Even the longest day will have an end.	どんなに長い日にも必ず終わりがある。
Will you tell me why you like her?	どうして彼女が好きなのか話してくれませんか。
Please tell me about your problem.	どうかあなたの問題について私に話して下さい。
How many books are there on the table?	テーブルの上に何冊の本がありますか。
I've got my friend on the line right now.	ちょうど今電話で話し中なんだ。
That's why I told you not to go by car.	だから車で行くなといったんですよ。
I don't know what to open it with.	それをどうやって開けたらいいのか分からない。
I must get the book back from him.	その本を彼から戻してもらわなければならない。
The shop is closed at nine every evening.	その店は毎晩９時に閉められる。
It won't take long to do the job.	その仕事をするのにそう長くはかからないだろう。
The company presented a three-act play.	その劇団は３幕ものの劇を上演した。
Shakespeare is the author of Hamlet.	シェイクスピアはハムレットの著者である。
I don't want to take on any more work.	これ以上この仕事は引き受けたくない。
These products are of the same quality.	こちらの製品は同じ品質になります。
I don't like this. Show me another.	これは気に入らない。別のものを見せてくれ。
This is a problem of your own making.	これはあなたが自分でおこした問題です。
This is the book that I told you about.	これは、私があなたに話した本です。
This is the biggest hotel in this city.	これがこの市で一番大きいホテルだ。
It's been two years since I saw him last.	この前彼に会ってから２年経つ。
This present was given to me by Ann.	このプレゼントはアンから私に与えられた。
This department store is closed at seven.	このデパートは７時に閉店する。
This is where my family used to live.	ここは昔、私の家族が住んでいた所です。
If you care to, you may come with us.	きたければ我々と一緒にきてもよろしい。
Might I ask your name and address?	お名前と住所お聞きしてもよろしいでしょうか。
He hasn't told me when he will return.	いつ帰るか彼は私にいいませんでした。
Oh, I didn't know it was that close.	あれ、そんなに近いとは知りませんでした。
One day she and I visited an old friend.	ある日彼女と私は旧友を訪問した。
One man says this, another that.	ある人はこうだと言い、またある人はああだと言う。
You have to get him to help you.	あなたは彼に手伝ってもらわなければなりませんよ。
What do you want to study at college?	あなたは大学で何を勉強したいのですか。
Have you been in Japan since last month?	あなたは先月から日本にいますか。
I will show you how to go to the park.	あなたに公園の行き方を教えましょう。
You must not look down on old people.	あなたたちは老人を軽蔑してはいけない。
What you said was in the main right.	あなたが言ったことはおおむね正しかった。
Asia is much larger than Australia.	アジアはオーストラリアよりはるかに大きい。
CDs have taken the place of records.	ＣＤがレコードに取って代わってしまった。
We got through the work just before ten.	１０時ちょっと前に仕事が済んだ。
What's the word for "kaisha" in English?	「会社」を英語で何といいますか。
I read at least one book every month.	私は少なくとも毎月１冊は本を読みます。
The most up-to-date information is being sent.	最新情報をお届けします
There are other people who know about it.	他に御存じの方がいらっしゃいます
You can get points just by clicking.	クリックするだけでポイントがもれなく貰える
I am thinking of going to Kobe next week.	来週神戸へ行こうかと考えている。
Please tell me the way to the post office.	郵便局へ行く道を教えて下さい。
He told me that he would start the next day.	明日出発すると彼は言った。
I don't like to take on any more work.	僕はこれ以上の仕事は引き受けたくない。
They love to give parties all the time.	頻繁にパーティーを開くのが大好きだ。
She asked me if I knew her address.	彼女は僕に彼女の住所を知っているかと尋ねた。
She asked me to help her with the work.	彼女は私に仕事を手伝うように頼んだ。
She's just started for your house.	彼女はたった今、あなたの家に向かったところだ。
I want to ask them when their big day is.	彼らに結婚式の日取りを聞きたい。
He will be calling on me next month.	彼は来週私を訪ねてくることになるでしょう。
He selected a Christmas gift for her.	彼は彼女のクリスマスプレゼントを選んだ。
He wrote this book at the age of twenty.	彼は二十歳のときにこの本を書いた。
He has more books than he can read.	彼は読み切れないほどたくさん本を持っている。
He gave me what little money he had.	彼は持っている無け無しのお金を私にくれた。
He has three times as many books as I have.	彼は私の三倍本を持っている。
He told me where to buy origami.	彼は私に折り紙をどこで買ったらいいか話してくれた。
He used to tell me stories about India.	彼は私によくインドの話をしてくれた。
He did not so much as say good-by to me.	彼は私にさよならさえ言わなかった。
He was seen to come out of the house.	彼はその家から出てくるところを見られた。
He has made the company what it is today.	彼がその会社を今日の会社にした。
May I have an application form in Japanese?	日本語の申請書はありますか。
No city in Japan is as large as Tokyo.	日本のどの都市も東京ほど大きくはない。
The cost of living in Japan is going down.	日本での生活費は下がっている。
There is much that is good in the world.	世の中にはよいものがたくさんある。
The more you have, the more you want.	人は溜まれば溜まるほど欲しくなるものだ。
Those who are present are all Japanese.	出席をしている人々は全部日本人です。
It goes without saying that time is money.	時は金なりとは言うまでもない。
The more one has, the more one wants.	持てば持つほど、ますます欲しがるものだ。
I know her well. She is my friend.	私は彼女をよく知っている。彼女は私の友達です。
I have just been to the post office.	私はちょうど郵便局へ行ってきたところです。
I've been working there for three months.	私はそこで３ヶ月間働いています。
I want to do some shopping around here.	私はこのあたりで少し買い物をしたい。
I make a point of getting up before six.	私は６時に起床することにしている。
If you were in my place, what would you do?	私の立場なら、どうしますか。
I have more money than I had last year.	私には去年より多くのお金があります。
We had a good time playing cards.	私たちはトランプをしながら楽しい時間を過ごした。
Our car is three years older than yours.	私たちの車はあなたのより３年古い。
Our city is getting bigger and bigger.	私たちの市はますます大きくなっている。
When I visited Ken, he was studying.	私が健を訪問した時、彼は勉強していました。
If I were you, I would do the same.	私があなただとしても、同じことをするだろう。
Please do not use the phone while working.	仕事中に電話しないでください。
It being Sunday today, we have no school.	今日は日曜日なので学校は休みだ。
What do you say to calling it a day?	今日はこれでおしまいにしてはどうでしょう。
There are a great many people in the park.	公園にたいへん多くの人がいる。
What subjects are you taking at school?	君は学校で何の科目を取っていますか。
All you have to do is sign this paper.	君はこの書類に署名をしさえすればよい。
All we have to do is to try our best.	我々は、最善を尽くしさえすればよいのだ。
How long have you been studying English?	何年くらい英語を勉強していますか。
What time did she check out of the hotel?	何時に彼女はホテルを出ましたか。
I'll get up your drive for English study.	英語の勉強のやる気をおこさせる。
Of course I can drive a car very well.	もちろん、じょうずに車を運転できます。
We will help him if he asks us.	もし彼が頼んでくれれば、私達はかれを助けてあげます。
It will not be long before he gets well.	もうすぐ彼の病気は回復するだろう。
It won't be long before Mike gets well.	まもなくマイクは元気になるでしょう。
Bert doesn't go to high school, does he?	バートは高校に通っていませんよね。
I'll look you up when I visit New York.	ニューヨークへ行ったら君を訪ねるよ。
Why do so many people visit Kyoto?	なぜそんなに大勢の人々が京都を訪れるのですか。
Tom has bought a house which has six rooms.	トムは６部屋ある家を買った。
How long have you been studying English?	どのくらい英語を勉強していますか。
At all costs, I want to live in America.	どうしても私はアメリカに住みたい。
What do you want such an old car for?	どうしてそんなに古い車がほしいのですか。
Every one wants to live free from care.	だれでも苦労の無い生活を望んでいる。
Why don't you look it up in the phone book?	電話帳で調べたらどうですか。
It is up to us to help those people.	それらの人々を助けるのが我々の義務である。
It is used by a great many people.	それは非常にたくさんの人々によって使われます。
It was a very good experience for him.	それは彼にとってとてもいい経験だった。
How did you get to know that person?	その人とどうして知り合いになったのですか。
The Johnsons love to have parties.	ジョンソン一家はパーティーをするのが大好きだ。
Don't go off without saying good-by.	さようならも言わずに出ていかないで下さい。
It has been a long time since I wrote you last.	ご無沙汰しています。
Tell me when you'd like to order.	ご注文がお決まりになりましたら、お呼びください。
Please give me help in taking this down.	これを下ろすのてつだってください。
This is a Christmas present from him.	これは彼からのクリスマスプレゼントです。
I don't like this. Show me another.	これは好きではない、別のものをみせて下さい。
There's not so much text in this book.	この本は本文の部分はそんなに多くない。
Which is older, this book or that one?	この本とあの本ではどちらが古いですか。
This department store is closed at seven.	このデパートは７時に閉められる。
Do you have many friends here in Japan?	ここ日本には友達はたくさんいますか。
You'd better check these points.	こういうチェックポイントを注意すると、いいですね。
You will have to join the project.	きみはその計画に参加しなければならないだろう。
There used to be a house here at one time.	かつて、ここに家がありました。
Might I ask your name and address?	お名前と住所をお聞きしてもよろしいでしょうか。
Good evening. How many are in your party?	いらっしゃいませ、何名様ですか。
Would you please tell me when to get off?	いつ降りたらよいか教えて下さい。
That is new a shop which opened last week.	あれは先週開店した新しい店だ。
You had better ask him how to do it.	あなたは彼にそのやり方を聞いたほうがよい。
Why did you live in Kyoto last year?	あなたは何故去年京都に住んでいたのですか。
What have you been doing all this while?	あなたはずっと何をしていましたか。
How long have you known Judy?	あなたはジュディさんと知り合ってどれぐらいになりますか。
You are not allowed to use this car.	あなたはこの車を使うことを許されていない。
Compare your paper with the model one.	あなたの答案を模範答案と比較しなさい。
You have only to do as you were told.	あなたは言われた通りにしさえすればいい。
I would like to have a word with you.	あなたと少し個人的に話をする必要がある。
You can tell him for all I care.	あなたが彼に言いつけたって私はちっともかまわない。
Do you love each other very much?	あなたがたはお互いに大変愛し合っているのですか。
Come to my room between three and four.	３時と４時の間に私の部屋に来なさい。
"I know him well." "Oh, do you?"	「彼のことはよく知っていますよ」「ああそうですか」
Do you have a tatami room for ten people?	１０人用の畳の部屋はありますか。
Our company provides high-quality products.	当社は高品質の商品を提供します
More than 80% are using the Internet.	８０％以上がインターネットを利用しています
He added 13 pages to the Link page.	彼がＬｉｎｋページに１３のページを追加しました
He has been doing research for fifteen years.	彼が１５年間の研究を重ねた
I visited your website for the first time.	初めてこちらのＨＰを拝見しました
I lived for more than a month in Nagoya.	１か月あまり名古屋に居たことがある。
Please tell me what will be coming next week.	来週の映画を教えて下さい。
Work while you work, play while you play.	勉強する間は勉強し、遊ぶ間は遊べ。
A man is known by the company he keeps.	付き合う仲間を見れば、その人がわかる。
She didn't know what to say to him.	彼女は彼に何を言ったらよいのか分からなかった。
She did it for the good of the community.	彼女は地域社会のためにそれをした。
She came up to me and asked my name.	彼女は私の側までやってきて私の名前を尋ねた。
She made friends with Tom at the party.	彼女はパーティーでトムと友達になった。
She asked about the location of the house.	彼女はその家のある場所を尋ねた。
She wanted to have paid a visit to India.	彼女はインドに行きたかったのだが。
You should have asked her for help.	彼女に手伝ってくれるように頼むべきだったのに。
They're going to have a party next week.	彼らは来週パーティーを開く予定です。
He has not written to them for a long time.	彼らは彼から長い間便りがない。
They don't have to go to school today.	彼らは今日は学校へ行く必要がありません。
They will take down the house in a day.	彼らはその家を１日で取り壊すでしょう。
It is five years since they came to Japan.	彼らが日本にきてから５年になる。
He said he would come and he did come.	彼は来ると言ったが、その通りやって来た。
He reads as many as twenty books every week.	彼は毎週２０冊もの本を読む。
He made a show of helping the old man.	彼は年寄りを助けて優しい男のふりをした。
He is different from the people around him.	彼は多くの点で周りの人と違う。
He didn't even look over the papers.	彼は書類に目を通しておくことさせしなかった。
He has a car which I gave to him.	彼は車を一台持っているが、それは私があげたものだ。
He did it for the good of the community.	彼は社会によかれと思ってそれをした。
He gave me what money he had with him.	彼は持ち合わせていた金を全部私にくれた。
He took back what he had said about me.	彼は私について言ったことを取り消した。
He isn't any older than I thought.	彼は私が思っていたよりも少しも年がいっていない。
It won't be a long time before he gets well.	彼は間もなく良くなるだろう。
He is not a learned man, but a man of action.	彼は学者でなくて活動家だ。
He is a man of great credit in our city.	彼は我々の市では大変評判のいい人だ。
He had to go without food for days.	彼は何日も何も食べずに過ごさねばならなかった。
I think he will become a Beethoven.	彼はベートーベンのような大作曲家になると思う。
How did he work out the big problem?	彼はどのようにしてその大問題を解決したのか。
I tried to get down every word he said.	彼の言うことすべてを書き取ろうとした。
He is the very person I have wanted to see.	彼こそ私の会いたかった人です。
I couldn't make out what he was saying.	彼が何を言っているのか殆どわからない。
The same may be said of other people.	同じことが他の人々についても言えるだろう。
It's been five years since I came to Tokyo.	東京へ来てから５年になります。
Would you care to come and see me on Saturday?	土曜日に家に来ませんか。
We'll have to go about it with care.	注意してそれに取りかからねばならないだろう。
It was not long before the news came.	知らせが来るまでには長くはかからなかった。
There were five classes in the first year.	第１学年には５つクラスがあった。
Osaka is the second largest city of Japan.	大阪は日本で２番目の大都市です。
We have to buy water from Malaysia.	水をマレーシアから買わなくてはならないのです。
Will you tell me the way to the library?	図書館に行く道を教えてくれませんか。
A man is known by the company he keeps.	人は交わる友によってその人物がわかる。
A man is known by the company he keeps.	人は関わる友によってその人柄が分かる。
Will you tell me what I should do next?	次に何をやるべきか教えてくれませんか。
You must make the most of your time.	時間はできるだけ有効に使わなければならない。
We can study English in many ways.	私達は多くの方法で英語を勉強することができます。
I think of him as one of my good friends.	私は彼を親友の一人と考えています。
I said so with a view to pleasing him.	私は彼を喜ばせるつもりでそう言ったのだ。
I don't have as much money as he does.	私は彼ほどたくさんのお金を持っていない。
I asked him where I should park my car.	私は彼にどこへ駐車したら良いか尋ねた。
I still haven't learned to drive a car.	私は相変わらず車の運転を習っていない。
I will come to your party this evening.	私は今晩あなたのパーティーに行きます。
I have read that story in some book.	私はその話を何かの本で読んだことがあります。
I couldn't think of the name of the place.	私はその地名を思い出せなかった。
I can't do my job without a computer.	私はコンピューターなしでは仕事ができない。
I do not like to take on any more work.	私はこれ以上の仕事を引き受けたくない。
He loves you as much as I do.	私はあなたを愛しているが彼も同じくらいあなたを愛している。
I have three times as much money as you.	私はあなたの三倍のお金を持っている。
I have three times as much money as you.	私はあなたの３倍のお金を持っている。
I saw him go out of the room just now.	私は、彼がたった今部屋から出るのを見た。
My room is three times as large as yours.	私の部屋は君の部屋の３倍の広さだ。
We had better save our time and money.	私たちは時間とお金を節約したほうがよい。
We checked in at the hotel at 5 p.m.	私たちはホテルに午後５時にチェックインした。
It has been ten years since I came here.	私がここに来てから１０年になります。
Keep up the good work, Mr. Sakamoto.	坂本さんこれからもいい仕事を続けてください。
Would you like to come and see us this evening?	今夜遊びにきませんか。
What I want now is not money, but time.	今僕が欲しいのはお金じゃなくて時間だ。
We have closed out this year's model.	今年のモデルは全て売りきってしまいました。
Do you write to him at all even now?	今でも彼に手紙を書くことが少しはありますか。
Now is the time when I need him most.	今こそ、私が彼をもっとも必要とする時期だ。
How many times a month do you write home?	君は月に何回家に手紙をかきますか。
All you have to do is sign your name here.	君はここに署名しさえすればいい。
I don't know what to make of your actions.	君のやることには判断に苦しむよ。
I'll give you a call before I visit you.	君のところへ行く前に電話をかけます。
I love you more than you love me.	君が私を愛しているよりもおおく私は君を愛している。
Mr Yoshida is at home in French history.	吉田君はフランスの歴史が詳しいです。
We'll go for a drive next Sunday.	我々は今度の日曜日にドライブに出かけるつもりです。
About how many days will it take to get there?	何日くらいで着きますか。
He said he had been to Hawaii before.	以前ハワイに行ったことがあると彼はいった。
I'm looking for books on Roman history.	ローマの歴史に関する本を探しています。
Of course you can take it if you want.	もちろん、欲しければとってもいいですよ。
Of course, I will go there with you.	もちろん、私はあなたとそこに行くつもりです。
It will not be long before he gets better.	まもなく彼は快方に向かうだろう。
I'll look you up when I visit New York.	ニューヨークにいったら君をたずねるよ。
You must try and come to the party.	なんとかしてパーティーに来ないといけませんよ。
I will not do that for the life of me.	どんなことになっても決してそれはしない。
It won't take long to read that book.	その本を読むのに長くはかからないでしょう。
Did you take the book back to the library?	その本を図書館へ返却しましたか。
The report was sent within the same day.	その報告書はその日のうちに送られた。
The story has come down through many years.	その物語は昔から伝わってきた。
Take another good look at the city map.	その市街地図をもう一度よく見て下さい。
There lived an old man in the old house.	その古い家に一人の老人が住んでいた。
That is why she didn't join them.	そういうわけで、彼女は彼らに加わらなかったのです。
All members have access to these books.	すべての会員はこれらの本を利用できる。
In other words, he doesn't want to do it.	すなわち彼はそれをしたくないのだ。
Which is older, this book or that one?	この本とあの本とではどちらが古いですか。
It is a long time since I saw you last.	この前会ってからずいぶん経ちましたね。
The last time I called him, he was out.	この前に電話したときは彼は留守でした。
What are the main products of this country?	この国の主要な産物は何ですか。
This food called BLT; what's in it?	このＢＬＴという料理は、どんな材料なのですか。
How many days are there before Christmas?	クリスマスまであと何日ありますか。
The cookies are all in the form of stars.	クッキーはどれも星の形をしている。
What's the name of the party you're calling?	お呼びする相手方のお名前は？
What have you been doing all this while?	いったい今まで何をしていたのですか。
I can't make out what the man is saying.	あの男の言っていることが分からない。
I can't make out what the man is saying.	あの男が言っていることがわからない。
Can you go around the world in a day?	あなたは一日で世界を回ることが出来ますか。
How long have you lived in Sasayama?	あなたはどれくらい篠山に住んでいるのですか。
Did you call your friend in Canada?	あなたはカナダにいる友達に電話をかけましたか。
Please take your book off this table.	あなたの本をこのテーブルからどけて下さい。
"Please give me some water." "All right."	「水を少しください」「いいですよ」
"You mustn't go out now." "Why not?"	「今出かけてはいけない」「どうしてだめなの」
As it is, prices are going up every week.	実のところ物価は毎週上昇している。
There is no contact between the three parties.	三者の間には何も連絡が無い
Our shop has a history of over forty years.	当店が４０年以上の歴史を誇ります
Japanese companies will go into this market.	この市場に日本の企業が参入する
Please write down your contact address here.	連絡先をここに書いてください。
I am going to take two days off next week.	来週二日間の休みを取るつもりです。
I hadn't seen my friend for over twenty years.	友達に２０年も会ってない。
I gave him what little money I had with me.	僕は彼になけなしのお金を与えた。
I haven't seen him for about three years.	僕はここ３年ばかりあの人に会わない。
There're more than 100 people in the room.	部屋に１００人以上の人達がいます。
Who that knows her doesn't love her?	彼女を知っている誰が、彼女を愛さないだろうか。
She is just started for your house.	彼女は建ったいま、あなたの家に向かったところだ。
She was noted for her good looks at school.	彼女は学校では美人で評判だった。
She thought that John had loved her.	彼女はジョンが以前に愛してくれていたと思った。
When I called on him, he was not at home.	彼を訪れたとき、彼は家にいなかった。
There is a community of thought between them.	彼らの思想には共通性がある。
He has not written to them for a long time.	彼らには長い間彼から便りが無い。
I know they're in love with each other.	彼らが愛し合っているのを僕は知っている。
He came to see me in a different light.	彼は私を違った観点から見るようになった。
He has no more than one hundred books.	彼はわずかに１００冊の本しか持っていない。
He knows French, much more English.	彼はフランス語を知っている。英語は勿論のことだ。
He may have gone home by another way.	彼はちがう道を通って家に帰ったかもしれない。
He will be up and about in a week.	彼は１週間もすれば起きて歩けるようになるでしょう。
He told me he would be here about seven.	彼は、７時ごろここに来ると私に言った。
He said he had seen her a month before.	彼は、１ヶ月前に彼女とに会ったと言った。
Many a story has been told about him.	彼についてはずいぶん多くの話が語られている。
How many classes do you have on Saturdays?	土曜日には何時間授業がありますか。
China is twenty times as large as Japan.	中国は日本の２０倍の大きさがあります。
You have to go to college for four years.	大学へは４年間行かなくてはいけない。
Many Europeans visit Egypt every year.	多くのヨーロッパ人が毎年エジプトを訪れる。
There is no one reading in the library.	図書館で読書している人は１人もいません。
We had a very good time at a New Year's party.	新年会はとても楽しかった。
I couldn't make out what he was saying.	私は彼の言っている事が理解できなかった。
I don't like the house in which he lives.	私は彼が住んでいる家は好きではない。
I couldn't make out what he was saying.	私は彼が言っている事を理解できなかった。
I may have told you this story before.	私は君にこの話を以前にしたかもしれません。
I have not lived in Sanda since last year.	私は去年から三田に住んでいません。
I have only a little money about me.	私はほんのわずかのお金しか持ち合わせていない。
I have the complete works of Shakespeare.	私はシェークスピア全集を持っている。
I want a box three times as large as this.	私はこの三倍の大きさの箱が欲しい。
I can see some Japanese people here.	私はここで何人かの日本人に会うことができます。
I have been studying English for four years.	私は４年間英語を勉強してきた。
My job will only last two years at most.	私に仕事はせいぜい２年しかもたないよ。
Don't tell me what to do or not to do.	私にしろとか、するなとか命じないで下さい。
We must keep up with the times.	私たちは時勢に遅れないようについていかなければならない。
We have been good friends for ten years.	私たちは１０年前から仲の良い友達です。
It's a house just like that I have seen.	私が見たのはそれにそっくりの家だった。
He loves you as much as I do.	私があなたの事を愛しているのと同じ位彼もあなたを愛している。
Mr. and Mrs. Yamada will come home next month.	山田夫妻は来月帰国します。
I have to pay high rates to the boarding.	高い料金を下宿屋に払わねばならない。
How did you come to know one another?	君達はどうやってお互いを知り合ったのですか。
You should know better at your age.	君の年齢ならもっと思慮分別があってしかるべきだ。
I gave him what little money I had.	僅かながらの私の持っていたお金を全部彼に与えた。
There are many places to visit in Kyoto.	京都には訪れる場所がたくさんあります。
The more you learn, the more you want to.	学べば学ぶほどますます学びたくなる。
English is studied all over the world.	英語は世界のいたるところで学習されている。
It is good to keep studying all your life.	一生懸命し続けることはいいことだ。
How many days a week do you go to school?	一週間のうちで何日学校に通いますか。
We drove to Hakone last Sunday.	わたしたちはこの前の日曜日に箱根へドライブに行きました。
Robert comes to visit me every now and then.	ロバートは時々私を訪ねて来る。
Of course I can drive a car very well.	もちろん、私は大変上手に車を運転できます。
I can't think about the design any more.	もうこれ以上、デザインを考えられない。
Mike has a friend who lives in Chicago.	マイクはシカゴに住んでいる友達がいます。
Why do you think I told her about it?	なぜ私がそのことを彼女に話したと思いますか。
No one but Tom handed in the report.	トムを除いてはだれもレポートを提出しなかった。
You should read as many books as you can.	できるだけ多くの本を読むべきである。
That's why I told you not to go by car.	だからこそ、車で行くなといったんですよ。
There were two hundred people in the room.	その部屋には２００人の人々がいた。
The shop is open from Monday to Saturday.	その店は月曜から土曜まで開いている。
A man may be known by the company he keeps.	その人の人柄は友を見ればわかる。
The action of the play takes place in France.	その劇の舞台はフランスです。
John knows English history from A to Z.	ジョンは英国史を隅から隅まで知っている。
Mr Johnson's house is next to my house.	ジョンソン氏の家は私の家の隣にあります。
This is little different from what I want.	これは私の欲しいものとは少し違う。
There is no market for these goods in Japan.	この品物は日本では需要がない。
I haven't seen him since last Sunday.	この前の日曜日以降、私は彼に会っていません。
This car is better as compared with that one.	この車はあれに比べればよい。
There were no Japanese in this country.	この国には日本人は一人もいませんでした。
California is about as large as Japan.	カリフォルニアは日本と同じくらいの広さだ。
Australia is smaller than South America.	オーストラリアは南アメリカより小さい。
Some day next month I plan to go to Kyoto.	いつか京都へ行きたいと思っている。
It would be better for you to read more books.	あなたは本を読む方がよい。
I asked her if she was going out.	あなたは出かけるところですかと私は彼女に聞きました。
Could you tell me your present address?	あなたの現住所を私に言って下さいますか。
I will tell you the history of my life.	あなたに私の人生の歴史を話してあげよう。
Go back to the list of 2005 news releases.	２００５年のプレスリリース一覧に戻る
Our feelings are in all of the words.	それぞれの言葉に私たちの想いが込められています
I was allowed to take photos of your family.	ご家族に写真を撮らせて頂きました
She looked pleased with her new job.	彼女は新しい仕事が気に入っているように見えます。
She has gone, but I still love her.	彼女は行ってしまったが、私はまだ彼女を愛している。
Shall I ask her to send the book to us?	彼女にその本を送ってくれと頼みましょうか。
Can you make out what she is driving at?	彼女が言おうとしていることが解りますか。
They had had to use what money they had.	彼らは有り金全部を使わざるをえなかった。
They had to read the book many times.	彼らは何回もその本を読まなければならなかった。
It will be some time before they come.	彼らが来るまでにはまだしばらくかかるだろう。
He took back what he had said about her.	彼は彼女について言ったことを取り消した。
He was open to a different way of thinking.	彼は異なった考え方を拒まなかった。
He has visited most countries in Europe.	彼はヨーロッパのたいていの国々を訪ねた。
He used to say so, but now he doesn't.	彼は、以前はそう言っていたが、今は言わない。
It has been two years since he came to Japan.	彼が日本に来て二年になります。
It will be some time before he gets well.	彼がよくなるにはしばらくかかるだろう。
Since it was Sunday, the store was closed.	日曜日だったので、店は閉まっていた。
Japan will get it from many countries.	日本は多くの国からしっぺ返しをくらうだろう。
You will be known by the company you keep.	人は付き合っている人によって変わる。
A man is more or less what he looks like.	人は多かれ少なかれ見掛け通りのものだ。
The more people have, the more they want.	人は持てば持つほどますます欲しくなる。
You must take care when you drive a car.	車を運転する時は注意しなければならない。
We will have an English test next Monday.	次の月曜に私達は英語のテストを受ける。
I will be traveling in Europe next week.	私は来週ヨーロッパを旅行しているだろう。
I am going to my room, where I can study.	私は勉強できるように自分の部屋に行く。
I have three times as many books as she has.	私は彼女の３倍の本を持っている。
I asked her if I could read the book.	私は彼女に私がその本を読めるかどうかを尋ねた。
I have read every book in the library.	私は図書館のすべての本を読んでしまいました。
I like May the best of all the months.	私はすべての月のうちで５月がもっとも好きだ。
I used to go to that library to study.	私はいつも勉強しにあの図書館へ行ったものだ。
I like to shop at that department store.	私はあのデパートで買い物するのが好きだ。
I have been studying German for two years.	私は２年間ドイツ語を勉強しています。
We are doing business with many countries.	私どもは多くの国と商売をしています。
We go to school because we want to learn.	私たちは勉強したいので学校へ行きます。
You must share your jobs with others.	君は自分の仕事を他の人と分け合わねばならない。
Do you know what this box is made of?	君はこの箱が何で作られているかを知っています。
How long have you been living in Kobe, then?	君はいつから神戸に住んでいるの。
I can not make out at all what you say.	君の言うことは全く理解することができない。
What would you do if you were in my place?	君が僕の立場だったら、どうするかね。
Is there a table available for two on Friday?	金曜日、２人分予約できますか。
Our company makes use of the Internet.	我々の会社ではインターネットを利用している。
English is studied all over the world.	英語は世界のいたるところで勉強されています。
If you try at all, you should try your best.	やるからには最善を尽くしなさい。
If I had time, I would study French.	もし暇があれば、私はフランス語を勉強するのだが。
Do you know how to use a personal computer?	パソコンの使い方を知っていますか。
Do you know which book sells well now?	どんな本が今よく売れているか知っていますか。
You must not take it on any account.	どんなことがあってもそれを受け取ってはいけない。
I'll tell you all I know about it.	その件について知っていることはすべてお話しましょう。
The people who live there are our friends.	そこに住んでいる人々は私の友人です。
How long have you known Jim Robinson?	ジム・ロビンソンとはいつからの知り合いですか。
There are cases where the system doesn't go.	システムが作動しない場合がある。
Mr Colcott came to like Japanese food.	コルコットさんは日本の食べ物が好きになった。
My life has been changed by this book.	この本によって私の人生は変えられてしまった。
This box is three times as big as that one.	この箱はあの箱の３倍の大きさです。
Can you tell me where I am on this map?	この地図で今私がいるところを教えて下さい。
It's been five years since I last saw you.	この前御会いしてから５年がたちます。
Is this new model available on the market?	この新しい型は市場で手に入りますか。
From this point of view, you are right.	この見地からすると、君の言うことは正しい。
What are you going to do with this money?	このお金をどうしようとなさるのですか。
The people which were here have all gone.	ここにいた人々はみんな行ってしまった。
I think a part-time job is a good experience.	アルバイトはいい経験になるの。
You have changed since I saw you last year.	あなたは昨年会った時から変わった。
How many classes do you have on Mondays?	あなたは月曜日にいくつ授業がありますか。
Please call me up between seven and eight.	７時から８時の間に電話してください。
She is coming home at the end of this month.	彼女は今月の終わりに帰省します。
Only six people came to the party.	そのパーティーにはわずか六人しか来ていませんでした。
There's a place called Kuchiwa in Hiroshima.	広島に口和というところがあります。
She was taken care of by one of her friends.	友達の一人が彼女のめんどうをみた。
Dr. Makino is looked up to by many people.	牧野博士は多くの人々に尊敬されている。
She said that they were good friends of hers.	彼女は彼らはよい友達だといった。
She told me that I could use her room.	彼女は私に、自分の部屋を使ってもいいと言った。
She is coming home at the end of this month.	彼女は今月の終わりに帰ってきます。
The more I know him, the more I like him.	彼を知れば知るほど、私は彼が好きになる。
They have a good store of food in the house.	彼らは家に十分食べ物を蓄えている。
It is your business to take care of them.	彼らのめんどうをみるのはあなたの役目だ。
He is longing to see my family in Tokyo.	彼は東京にいる私の家族に会いたがっている。
He has no more than five English books.	彼は多くても５冊しか英語の本を持っていない。
He is at work now, but will return at seven.	彼は仕事中だが７時には帰って来る。
He reads 10 books when he returns to the house.	彼は家に帰ると本を十冊読む。
He is as good as any player on our team.	彼はわがチームでもっとも優秀な選手である。
He had, I thought, no right to do that.	彼はそんなことをする権利がないと私は思った。
He has access to the stored information.	彼はその蓄えられた情報に近づく資格がある。
He was, is, and will be, my best friend.	彼は、昔も今も、またこれからも私の親友だ。
I should have known better than to call him.	彼に電話なんかしなければよかった。
I'll give him your message when he comes.	彼が来たらあなたの伝言を伝えておきます。
I don't know when he returned from France.	彼がいつフランスから帰ったか知らない。
It being Sunday, we have no classes today.	日曜日なので、今日は授業がありません。
Japan is a very long country from north to south.	日本は南北に長い国です。
Tokyo is larger than any other city in Japan.	東京は日本のどの都市より大きい。
The New Tokaido Line was completed in 1964.	東海道新幹線は１９６４年に完成した。
And the name of the person you're calling, please?	先方のお名前をどうぞ。
You must learn to see life as it is.	人生をあるがままに見るようにならなければならない。
I want a car, but I have no money to buy one.	車が欲しいがそれを買う金がない。
Time will show which of us is right.	時がたてば、私たちのどちらが正しいかわかるだろう。
I said that I didn't go shopping with her.	私は彼女とは買い物に行かないと言った。
I have no more than ten English books.	私は多くとも１０冊しか英語の本を持っていない。
I told the news to Tom, not to Mary.	私はメアリーではなくてトムにそのニュースを話した。
I visited American friends in Oakland.	私はオークランドに住むアメリカの友人を訪ねた。
I have ten times as many books as you have.	私はあなたの１０倍の本を持っている。
I have known him for more than ten years.	私は１０年以上も前から彼を知っています。
I have no less than one thousand records.	私は１０００枚ものレコードを持っている。
I have an American friend named Tony.	私にはトニーという名のアメリカ人の友人がいます。
Sapporo is the fifth largest city in Japan.	札幌は、日本で５番目に大きな都市だ。
You must do it by the end of this week.	今週の終わりまでにやらなくては、いけません。
Come to my office at the end of this month.	今月の終わりに私の事務所に来なさい。
It would be better for you to read more books.	君はもっと本を読んだ方がよい。
Are you doing what you think is right?	君は、自分で正しいと思うことをやっているのか。
You may as well tell me all about it.	君は、それについてすべてを私に話したほうがいい。
What would you do if you were in my place?	君が僕の立場にあったら、どうするかね。
I'll call by at the post office on the way home.	帰りがけに郵便局に寄るよ。
Give me any books you have on the subject.	関係のある本はどんなものでもください。
Our team played an even game with team "S".	わがチームはＳチームと対等に戦った。
If music be the food of love, play on.	もしも、音楽が愛の糧であるならば、奏で続けよ。
Would you like to join us for a game of cards?	みんなと一緒にトランプしない？
All but Mike were present at the party.	マイクを除いてみんなパーティーに顔を出した。
She acted as if she knew French well.	フランス語をよく知っているかのように振る舞った。
Only six people were present at the party.	パーティーには６人しか出席しなかった。
New York is the biggest city in the world.	ニューヨークは世界で一番大きな都市だ。
Tom says that he can read a French book.	トムはフランス語の本が読めると言っている。
Any paper you read will tell the same story.	どの新聞を読んでも話は同じだろう。
If you do it at all, try to do it well.	どうせやるからには上手にやるようにしなさい。
I don't see why I should not do that.	どうして私がそれをしてはいけないのかわからない。
Please write about your real experience.	どうかあなたの実体験のことを書いて下さい。
The only way was to ask her for help.	ただ一つの方法は、彼女に助けを求めることだった。
You can take her at her word on that.	その件については彼女の言葉を信じていいでしょう。
The company has changed hands three times.	その会社は経営者が３人も代わっている。
The company has changed hands three times.	その会社は、経営者が３回替わっている。
May I visit your home one of these days?	そのうちお宅にお伺いしてもいいでしょうか。
What will you live on while you are there?	そこにいる間、生活の糧はどうするのだ。
Mr Soarez has been my close friend for years.	ソアレズ氏は私の長年の親友です。
Why don't you share your cookies with Jim?	ジムに少しお菓子を分けてやったらどう？
Sydney is the largest city in Australia.	シドニーはオーストラリアで最大の都市です。
This looks like another government cover-up.	これまた政府の隠ぺい策のようです。
This will be the house we are looking for.	これが私たちがさがしている家でしょう。
This book is the smallest of all the books.	この本はすべての本の中で一番小さい。
Will you record this program on video for me?	この番組、ビデオに録っておいて。
Please check all the items on this list.	このリストの項目を全部チェックして下さい。
Can you give me a hand with this table?	このテーブルを運ぶのを手伝ってくれませんか。
Can these stars be seen in Australia?	こういった星はオーストラリアでは見えるのですか。
What have you been doing all this while?	いったい今までずっと何をしていたのですか。
An Englishman would not use such a word.	イギリス人ならそんな言葉は使わないだろう。
That country is five times as large as Japan.	あの国は日本の５倍の大きさです。
How long do you study English every day?	あなたは毎日どのくらい英語を勉強しますか。
We would like you to join our company.	あなたに私たちの会社に来てもらいたいのですが。
You and I must give him our present.	あなたと私は彼にプレゼントをあげなければならない。
Did you have a good time at the party?	あなたがたはパーティーで楽しく過ごしましたか。
When I was fifteen, I got a room of my own.	１５歳の時、私は自分の部屋を持った。
"How old is she?" "She is twelve years old."	「彼女は何才ですか」「１２才です」
"Can you do it in a week?" "I think so."	「一週間で出来ますか」「出来ると思います」
The six accounted for two thirds of the total.	それが６件で全体の２／３を占めた
The box and the card are placed on the table.	箱とカードがテーブルの上に置かれる
He can have some good quality time here.	彼がここでは充実した時間を過ごすことができる
The problem is not so much the cost as the time.	問題は費用よりむしろ時間だ。
He must be at home as the light in on.	明かりがついているから彼は家にいるにちがいない。
She asked me if I knew Tom's address.	彼女は私にトムの住所を知っているかどうかたずねた。
She said she was going to have her own way.	彼女は思い通りにするつもりだと言った。
She will be seventeen years old next February.	彼女は今度の２月で１７歳になる。
She writes much better now than she used to.	彼女は以前よりずっと上手に字を書く。
She will write another book one of these days.	彼女はまた近く本を書くでしょう。
She loves an old table made in England.	彼女はイギリス製の古いテーブルを愛しています。
She will give you what money she has.	彼女は、持っているお金を全部あなたにあげるだろう。
She told me she would be here about six.	彼女は、６時ごろここに来ると私に言いました。
I know they're in love with each other.	彼らが互いに愛し合っているのを僕は知っている。
He loves her, but she doesn't like him.	彼は彼女を愛しているが、彼女は彼が好きでない。
He visited me every time he came up to Tokyo.	彼は東京へ来るたび私を訪ねてきた。
He makes out that he has a right to say so.	彼はそう言う権利があると主張している。
He has been studying French for eight years.	彼は８年間フランス語を勉強している。
Give him the message when he comes back.	彼が戻ってきたら、その伝言を伝えてください。
I'll give him your message when he comes.	彼がきたならあなたの伝言を伝えておきます。
When he said "water," she gave him water.	彼が「水」と言えば、彼女は彼に水を与えた。
It being Sunday, the shops were not open.	日曜日だったので、どの店も開いてなかった。
Read over your paper before you hand it in.	答案を出す前にもう一度読み返しなさい。
Tokyo is as large a city as any in Japan.	東京は日本のどの都市にも劣らない大都市だ。
I found the book I had long been looking for.	長い間さがしていた本が見つかった。
Can you tell a Chinese person from Japanese?	中国人と日本人の見分けがつきますか。
People are living in all parts of the world.	人間は世界のあらゆる所に住んでいる。
No less than one hundred people were present.	少なくとも１００人は出席していた。
There were at least a hundred people present.	少なくとも１００人の人が出席した。
Could you tell me how to get to your office?	車での病院の行き方を教えてください。
I used a computer in order to save time.	時間を節約するためにコンピューターを使った。
Only time will tell you if you're right.	時がたてば君が正しいかどうかがわかるだろう。
We have been studying English for three years.	私達は英語を三年間勉強している。
We have many friends to visit in Tokyo.	私達には東京に訪ねるべき友達がたくさんいます。
I have been studying English for six years now.	私は六年間英語を勉強している。
I wanted her to come here this evening.	私は彼女に今晩ここに来てもらいたかったのです。
I couldn't make out what he wanted to say.	私は彼が何を言いたいのか分からなかった。
I visited Rome for the first time in my life.	私は生まれて初めてローマを訪れた。
I still think about her from time to time.	今でも私はときどき彼女のことを思い出す。
I come home from work about seven every day.	私はたいてい７時ころうちに帰ります。
I didn't go there because I wanted to.	私はそこへ行きたいから行ったわけではないのです。
All of my friends like computer games.	私の友達はみんなコンピューターゲームが好きです。
The living room in my new house is very large.	私の新しい家の居間はとても広い。
My family have lived here for twenty years.	私の家族はここに２０年間住んでいます。
We offered him the house for $300,000.	私たちは彼にその家を３０万ドルで売ると申し出た。
We should read one book a month at least.	私たちは少なくとも月に一冊本を読むべきだ。
We'll take your feelings into account.	私たちはあなたの気持ちを考慮に入れるつもりです。
Our school has twenty-four classes in all.	私たちの学校には、全部で２４クラスある。
We have the right to live where we please.	私たちには好きなところに住む権利がある。
It has been ten years since I saw her last.	私が彼女に会ってから１０年になります。
It is five years to a day since I came here.	私が当地へ来てからちょうど５年です。
Ken studies not only English but French.	健は英語だけでなくフランス語も勉強している。
What would you do if you were in my place?	君が僕の立場に立たされたらどうするかね。
I don't have as much money as you think.	君が思っているほど大してお金を持っていない。
Kyoto is visited by many people every year.	京都は、毎年多くの人々に訪れられます。
We must do our job as best as we can.	我々は最善を尽くしてその仕事をしなければならない。
Do you know what time the shop is closed?	何時にその店が閉められるか知っていますか。
Mr. Oh came to Japan to study Japanese.	王さんは日本語を勉強するために日本へ来ました。
Please book me a room in a first-class hotel.	一流ホテルの部屋を予約して下さい。
Not even a day can we live without water.	一日たりとも我々は水なしにはいきられない。
We have known each other for many years now.	わたしたちはもう長年の知り合いです。
If you were in my place, what would you do?	もしあなたが私の立場ならどうしますか。
Mary is setting by money to go to Japan.	メアリーは日本に行くためにお金を貯めている。
Mary called him every name she could think of.	メアリーはすべての悪態をいった。
It was not long before I got a call from him.	まもなく彼から電話がかかってきた。
When you come to Hawaii, I'll show you around.	ハワイにいらしたらご案内します。
Can you make out why he won't go with us?	なぜ彼が我々と同行しないのかわかりますか。
How long have you been learning English?	どのくらいの期間英語を勉強しているのですか。
Tony has lived in Kumamoto since last year.	トニー君は去年から熊本に住んでいます。
I want to know about your country so much.	とてもあなたの国について知りたいのです。
There are books and books on the subject.	その問題に関しては実にいろいろな本がある。
Our department doesn't have that information.	その資料はこの部署にはありません。
Did you make any money out of that business?	その仕事で少しはお金が儲かったかい。
I could not tell what I should do then.	そのとき私はどうしたらよいのか分からなかった。
The people who live there are our friends.	そこに住んでいる人々は私たちの友人です。
That was why the city was named Rome.	そういうわけでその都市はローマと名づけられました。
Has John returned to America for good?	ジョンは永久にアメリカに戻ってしまったのですか。
You needn't have bought such a large house.	こんな大きな家買う必要はなかったのに。
I don't like this one; show me another.	これは気に入らないから別なのを見せてください。
This car was selected the "car of the year".	この車は「年間最優秀車」に選ばれた。
I know about this project for the most part.	この計画について大部分は知っている。
This is a small house, but it will do for us.	この家は小さいが我々には十分です。
These days many people use computers.	このごろ、多くの人がコンピューターを使用している。
This is the house in which she used to live.	ここは彼女がかつて住んでいた家です。
Please tell me when you are coming back.	いつあなたはお帰りになるのか教えてください。
Please tell me about you and your family.	あなたやあなたの家族について話して下さい。
You should take account of what he said.	あなたは彼の言ったことを考慮に入れるべきだ。
Have you lived in Sasayama since last year?	あなたは去年から篠山に住んでいますか。
Which city are you going to visit first?	あなたはどの都市を最初に訪れるつもりですか。
You should start between six and seven.	あなたは６時から７時までの間に出発するべきだ。
I will write down your name and address.	あなたの名前と住所を書き留めておきましょう。
Your car is three times as big as this one.	あなたの車はこの車の３倍の大きさです。
What would you do if you were in my place?	あなたが私の立場にいたら、何をしますか。
I asked him if he knew her address.	「君は彼女の住所を知っているかい」と私は彼にたずねた。
She wrote the book about people she visited.	彼女は訪れた人々について本を書いた。
I will form a three member team, including him.	私が彼と一緒に３人でチームを組む
Travel is one of the better forms of education.	旅はよりよい教育法の一つである。
Next year I will be three times as old as you.	来年私はあなたの３倍の年齢になる。
I'll get you the info you need by next week.	来週中にあなたが必要な情報を送ります。
The problem is not so much the cost as the time.	問題は費用よりもむしろ時間だ。
She doesn't have to go to school on Saturday.	彼女は土曜日学校に行かなくてもよい。
She drove my car without so much as asking.	彼女は何の断りもなしに私の車を運転した。
She had, I thought, no right to do that.	彼女はそんなことをする権利がないと私は思った。
It has been ten years since I saw her last.	彼女に最後に会ってから１０年になります。
I know they're in love with each other.	彼らがお互いに愛し合っているのを僕は知っている。
He asked Nancy if she was free the next day.	彼はナンシーに明日ひまですかと尋ねた。
He has lived here since he was five years old.	彼は５歳の時からここに住んでいる。
Can you make out what he is trying to say?	彼が何を言おうとしているか理解できますか。
You must come every six months for a check-up.	半年に１回定期検診に来てください。
The same can be said of many other persons.	同じ事がほかの多くの人についても言える。
They started to sell a new type of car in Tokyo.	東京で新型の車が売り出された。
You need not come to the office on Saturdays.	土曜日には出社する必要がありません。
Can you check if the phone is out of order?	電話機が壊れているかどうか調べて下さい。
If it were not for water, we couldn't live.	水が無ければ私たちは生きられないだろう。
The library is open from 9 a.m. to 8 p.m.	図書館は午前９時から午後８時まで開いている。
The new model will be priced at $12,000.	新型は１２０００ドルの価格が付けられるだろう。
I will give you what little money I have.	少々ですが私が持っているお金を全部あげよう。
I'll go to Hokkaido next month with my friend.	来月友達と北海道へ行くつもりです。
I will go to Sydney on business next month.	私は来月、仕事でシドニーに行くでしょう。
I don't like being asked to go shopping.	私は買い物に行くよう頼まれるのが好きではない。
I would like to read books on Japanese history.	私は日本史に関する本が読みたい。
I have been studying English for three years.	私は今まで３年間英語を勉強している。
I saw the old man two or three times a week.	私はその老人を、週に２．３回見かけた。
I want to know more about your country.	私はあなたの国についてもっと知りたいと思います。
I have not seen him for about three months.	私は３ヶ月ぐらい前から彼に会っていない。
We can not do without water even for a day.	私たちは水無しでは一日もやっていけない。
What will we be doing this time next week?	私たち、来週の今ごろは何をしているかしら。
You've got to go even if you don't want to.	行きたくなくても行かなければなりません。
You've got to go even if you don't want to.	行きたくなくても行かなくてはなりません。
What's the name of the person you want paged?	呼び出してほしい人の名前は何ですか。
You have only to give him a little help.	君は彼にちょっと手をかしてやりさえすればいい。
Do you know how to use a personal computer?	貴方はパソコンの使い方を知っていますか。
When did they register the names of the members?	会員の名前をいつ登録したのか。
We set to work with all our might and main.	我々は全力をつくして仕事に取り掛かった。
We must make do with what we have got.	我々は、手持ちのもので間に合わせなければならない。
Yokohama is one of the largest cities in Japan.	横浜は日本で最大の都市の一つだ。
English is used in every part of the world.	英語は世界中いたるところで使われている。
It won't be long before he is up and about.	まもなく彼は病気が治って動き出すだろう。
I still haven't found what I'm looking for.	まだ捜している何かをみつけていないから。
Over 100 people were present at the party.	パーティーには１００人以上が参加していた。
How come you didn't come to the party?	どうして、あなたはパーティーに来なかったのですか。
A person named Jones has come to see you.	ジョーンズさんという方がお見えになりました。
Jim is not the man that you think him to be.	ジムは君が思っているような人ではない。
Do you have one a little bigger than these?	これらよりもう少し大きいのはありますか。
I haven't had much time to see Japan.	これまで日本を見物する時間があまりありませんでした。
There are so many people here in Tokyo.	ここ東京にはずいぶんたくさんの人がいるんですね。
It is ten years since I came to live here.	ここで暮らすようになってから１０年になる。
There must be a better person for both of us.	お互いもっと適した相手がいるはずだ。
You should go over a house before buying it.	あなたは家を買う前に良く調べるべきだ。
It would be better for you to read more books.	あなたはもっと本を読むほうがよい。
You are the very person I have been looking for.	あなたこそ私が探していた人だ。
I see why you don't want to go there.	あなたがどうしてそこへ行きたくないのかが分かります。
He did more research into that way of doing it.	彼がそのあり方にさらに検討を加えた
Oh my, you're right, I didn't know that at all.	あらまあ、ホント、全く知らなんだ。
We must think about the care of old people.	高齢者のケアについて考えなければならない。
Should he come, what should I say to him?	万一彼が来たらなんと言ったらよいのでしょうか。
I've wanted this CD player for a long time.	僕はこのＣＤプレーヤーがずっと欲しかった。
She gave a look as much as to say, "Get out".	彼女は出て行けとばかりの顔つきをした。
Some people like him and other people don't.	彼を好きな人もいればそうでない人もいる。
He came to New York in order to look for a job.	彼は職を探しにニューヨークに来た。
He is at home, but no one can see him.	彼は在宅していますが、どなたにもお目にかかりません。
He is at work now, but will return at seven.	彼は今は働いているが、７時に帰っている。
He is better than any other player in the team.	彼はチームの誰より優秀な選手です。
It has been ten years since I saw her last.	彼が彼女に最後に会ってから十年になります。
Can you make out what he is trying to say?	彼が何を言おうとしているのか理解できますか。
Tokyo is larger than any other city in Japan.	東京は日本の他のどの都市よりも大きい。
It will do you good to live in the country.	田舎に住むのはあなたにとってよいでしょう。
In the first place we must find a way out of this.	打開策を見つけるのが先決だ。
We would like you to come to our party.	私達はあなたにパーティーに来てもらいたいのですが。
I asked her if I could read the book.	私は彼女に私がその本を読めるかどうかどうかをたずねた。
I like English the best of all the subjects.	私は全ての教科の中で一番英語が好きです。
I have been studying English for five years.	私は五年間ずっと英語を勉強し続けている。
I told Jane how to get to our school.	私はジェーンにどうやって通学すればよいかを教えました。
Our world is getting smaller and smaller.	私たちの世界は、だんだん小さくなってきている。
The place I live in is very good for your health.	私が住んでいる所は健康に良い。
Don't phone me while I'm at the office.	私が事務所にいる間は電話をかけてよこさないでくれ。
We are giving a small party this evening.	今晩小さなパーティーをひらくことになっている。
He said that I shouldn't even be coming in today.	今日は休めと言われたんだけど。
In other words, I don't like to work with him.	言い換えれば、私は彼と働きたくない。
Why don't you try to get your money back?	君はどうして自分の金を取り戻そうとしないのか。
How much is the car you are planning to buy?	君が買う予定をしている車はいくらですか。
Yokohama is the second largest city in Japan.	横浜は日本で二番目に大きい都市である。
The Rhine runs between France and Germany.	ライン川はフランスとドイツの間を流れている。
I should think we will need some more money.	もう少しお金が必要になると思うのですが。
Could you tell me which way I should go?	どちらにいったらいいのか教えてくださいませんか。
Try as you may, you can't do it in a day.	たとえどんなにやってみても、一日では出来ない。
In that case, I think you should come in today.	それでしたら今日いらしてください。
I read the book in my second year of high school.	その本は高校２年の時に読んだ。
Only ten people showed up for the party.	そのパーティーに姿を見せたのは１０人だけだった。
The stories in the book are written for her.	この本の物語は彼女のために書かれている。
There are a great many books in this library.	この図書館にはたくさんの本があります。
Little money will come from this business.	この仕事ではほとんど金がもうからないだろう。
These two are very different from each other.	この２つはお互いに非常に異なっている。
The food is good, and service is good here.	ここは食べ物もおいしいし、サービスもよい。
Can you tell me how this compares to that?	あれとこれとを比較するとどちらがいいですか。
How did you pay for this computer?	あなたはどうやってこのコンピューターの代金を払ったのですか。
You will take to this new job before long.	あなたはすぐに新しい仕事が好きになるだろう。
I can't think of you as more than a friend.	あなたのことを友達以上には考えられないの。
You just have to do as you're told.	あなたがしなければならない事はいわれた通りにする事だけだ。
You must return the book by the end of April.	４月の終わりまでにその本を返しなさい。
The two cars tried to make way for each other.	２台の車は互いに道をゆずろうとした。
He returned home for the first time in ten years.	１０年ぶりに、彼は家に戻った。
Yamada placed seventh in the over 105kg class.	１０５キロ超級で山田選手が７位に入った
She did not visit me on Sunday but on Monday.	彼女は日曜日ではなく月曜日に訪ねてきた。
She was been here before, and so have I.	彼女は以前にここに来たことがあり、私もまたそうだ。
They want to take part in the Olympic Games.	彼らはオリンピックにさんかしたがっている。
He has not written to them for a long time.	彼は長い間彼らに手紙を書いていませんでした。
He told me that he had no time to read books.	彼は私に読書する時間がないと言いました。
He told me that he would go to France in June.	彼は私に６月にフランスへ行くと言った。
We've found him to be the right man for the job.	彼はこの仕事の適任者だと見ている。
I don't think your seeing him is good for you.	彼とつきあうのは君にとってマイナスだ。
I saw him playing cards with all of them.	彼がみんなとトランプをしているところをみました。
Is this the first time for you to have Japanese food?	日本料理は初めてですか。
I'd like to make a person-to-person call to Japan.	日本へ指名通話をお願いします。
Many a person has had the same experience.	同じような経験をした人は行く人も行く人もいる。
Your test papers must be handed in by Monday.	答案用紙は、月曜日までに提出するように。
The history of China is older than that of Japan.	中国の歴史は日本の歴史より古い。
No man can live to be two hundred years old.	誰でも２００歳まで生きられるものではない。
While I was in Taiwan, I made friends with him.	台湾にいたとき私は彼と友達になった。
It is ten years since I came to live in Shizuoka.	静岡に来てから１０年になります。
There are about 6 billion people in the world.	世界には約６０億の人々が暮らしている。
From what time to what time is your office open?	診察時間は何時から何時までですか。
The new model will be on the market in November.	新型車は１１月に市販になるだろう。
I will give you what little money I have.	少々ですが私が持っているお金を全部君にあげよう。
We must make the best of the small room.	私達はその狭い部屋を最大限利用しなければならない。
I asked her if she had been to Mexico.	私は彼女がメキシコへ行ったことがあるかどうかたずねた。
At first I did not like him, but now I do.	私は初めは彼が好きではなかったが、今は好きだ。
I don't have as much money as you think.	私は君が考えているほどたいしてお金を持っていない。
I tried many times to use a personal computer.	私は何度もパソコンを試しに使ってみた。
I go to the library two or three times a week.	私は一週間に２、３度図書館に行きます。
I don't know French, much less Greek.	私はフランス語を知らない、ましてギリシャ語はなおさらだ。
Will you tell me how to get to your house?	私にあなたの家への行き方を教えてくれませんか。
It has been ten years since I saw her last.	私が彼女に最後に会ってから１０年になります。
Is there any special news in today's paper?	今日の新聞に何か特別なニュースがありますか。
I have so little money at the end of the month.	月末にはお金がほとんどなくなります。
I'll help you so long as you do your best.	君が最善を尽くすかぎりは君を援助してあげよう。
Our city has one third as many people as Tokyo.	我々の市は東京の３分の１の人口です。
If only we didn't have to take a test in English.	英語の試験さえなければいいのに。
As long as we love each other, we'll be all right.	愛さえあれば僕らは大丈夫だよ。
I should like to call on you this evening.	もしご迷惑でなければ今晩お伺いしたいのですが。
Paris is one of the largest cities in the world.	パリは世界最大の都市の一つである。
Please tell me the way to the XYZ store.	どうぞわたしにＸＹＺストアへ行く道を教えて下さい。
What had kept him from coming to the party?	どうして彼はパーティーに来なかったのですか。
The more you have, the more you want.	たくさん持てば持つほど、それだけいっそう多く欲しくなる。
You should not keep company with such people.	そんな人たちとはつき合ってはいけません。
That being the case, he had little to say.	そんなわけで、彼はほとんど言うことがなかった。
In that country the government controls prices.	その国では政府が物価を統制している。
We have little money available for the research.	その研究に使える金はほとんどない。
If you want a hotel, look, it's just down there.	そのホテルならほらすぐそこですよ。
If you visit Spain, come and see me.	スペインに来られるようなことがあれば、会いに来てください。
I don't like this one; show me another.	これは気に入らない、もう一つほかのを見せてください。
Please write down what I am going to say.	これから私の言うことをどうぞ書き取ってください。
Which book is older, this one or that one?	この本とあの本ではどちらの本の方が古いですか。
Special care should be taken on this point.	この点については特に注意しなければならない。
Every fifth person has a car in this country.	この国では、５人に１人が車を持っている。
If you do your study at all, do your best.	いやしくも勉強をするなら、一生懸命やりなさい。
Tell me when you are through with your work.	いつあなたの仕事が終わるか教えてください。
An Englishman would act in a different way.	イギリス人ならもっと違った行動をとるだろう。
You should go over a house before buying it.	あなたは家を買う前に、それを調べるべきだ。
I want to know more about your school life.	あなたの学校生活についてもっと色々知りたい。
I will take care of you when you are old.	あなたが年をとったらわたしが面倒を見てあげます。
How long is it since you bought this car?	あなたがこの車を買ってからどのくらいたちますか。
There were as many as five hundred people present.	５００人もの出席者がいました。
You didn't do a very good job, I said.	「きみらはあんまりいい仕事をしていないね」私は言った。
"Where is your house?" "It is over there."	「あなたの家はどこですか」「それは向こうです」
He said he had come to Japan the previous week.	彼は前の週に日本に来ていたと言った。
You should care more about the people around you.	もっと周りの人たちを大切にしないと
Next week, he is going to New York on business.	来週彼は仕事でニューヨークに行きます。
The money needed will be given at any time.	必要とされるお金はいつでも与えられるでしょう。
She is well known both in Japan and in America.	彼女は日本でもアメリカでも有名である。
She doesn't have to go to school on Saturday.	彼女は土曜日に学校に行く必要はありません。
She asked me if I would be free next Sunday.	彼女は今度の日曜日は暇かどうか私にたずねた。
She is well known in both India and China.	彼女はインドだけでなく中国でもよくしられている。
They want to take part in the Olympic Games.	彼らはオリンピック大会に参加したがっている。
He said he would write to me, but he hasn't.	彼は私に便りをすると言ったがまだしてこない。
He has not written to us since last February.	彼は去年の２月以来私達に便りをしてこない。
China is about twenty-five times as large as Japan.	中国は日本の約２５倍の広さだ。
What is the second largest country in the world?	世界で２番目に大きい国はどこですか。
The new department store will be opened next month.	新しいデパートが来月開店する。
Some people read that they may get information.	情報を得るために読書をする人もいます。
I asked her if she could go to the party.	私は彼女にそのパーティーに行けるかどうかたずねた。
I asked him if he would go there the next day.	私は彼に翌日そこへ行くかどうかと聞いた。
I gave him what little information I had.	私は彼に少しではあるが持っていた情報を全部教えた。
I have been studying French four years now.	私はこれで４年間ずっとフランス語を学んでいる。
He returned home for the first time in ten years.	私は１０年ぶりで、彼は家に戻った。
We had to make the best of our small house.	私たちは小さな家で我慢しなければならなかった。
Our school was not the same size as yours.	私たちの学校はあなたの学校と大きさが違っていた。
It has been ten years since I saw her last.	私が彼女に最後にであってから１０年になります。
He asked me when I was going to buy a new car.	私がいつ新車買うつもりかと彼はたずねた。
If I were you, I wouldn't live with him.	私があなただったら、あの人といっしょに暮らしません。
Will you take us for a drive next Sunday?	今度の日曜日にドライブにつれていってくれませんか。
Can you help her out before they get her?	向こうが彼女を捕まえる前に、彼女を救い出せないか。
There's very little money coming in at present.	現在はほんのすこしの収入しか入らない。
You should hand in your report to me on Monday.	月曜日までに報告書を私に提出しなさい。
It is not good that you did not ask her name.	君が彼女の名前を尋ねなかったのはよくない。
I don't like you any more than you like me.	君が私を好きでないのと同様私も君を好きでない。
Why don't you come to my house one of these days?	近いうちに私のところへ来ませんか。
We must make the best of what we are.	われわれは現在のわれわれを最大限にいかさなければならない。
If it were not for water, we could not live.	もし水がなければ、我々は生きられないだろう。
If I were in your place, I would not do so.	もし私が君の立場だったら、そうはしないだろう。
Don't you have another one that's a little larger?	もう少し大きいのはありませんか。
It will not be long before our food runs out.	もうじき我々の食糧は尽きてしまうでしょう。
I must take back the money at all costs.	どんなことがあってもそのお金を取り返さねばならない。
Not knowing what to do, I asked for help.	どうしてよいか分からなかったので私は助けを求めた。
Not knowing what to do, I asked for help.	どうしたらいいのかわからなかったので助けを求めた。
You must do it even if you don't want to.	たとえしたくなくても君はそれをしなくてはならない。
From that time on, they came to love each other.	それ以来彼らは愛し合うようになった。
I can't tell which work is better than the other.	それらの作品には優劣をつけがたい。
We have little money available for the research.	その研究所に使える金はほとんどない。
It will not be long before Scott gets well.	スコットが元気になるのもそう遠くないでしょう。
John is looking for a book on Japanese history.	ジョンは日本史に関する本を探している。
I can't check my mail. The server is down.	サーバーがダウンしてて、メールチェックできない。
You'll take this to the post office, won't you?	これをもって郵便局へ行ってくれますね。
This is one of the jobs I have to do every day.	これは私の毎日の決まった仕事の一つだ。
Can I make a credit card call on this public phone?	この電話はカードが使えますか。
These words came out of the book you have.	このことばは、君の持っている本から引用したのだ。
You must do the work even if you don't like it.	いやでもその仕事をしなければならない。
Are the stores closed on Sunday in England?	イギリスでは、日曜日にお店が閉まっていますか。
You should go over a house before buying it.	あなたは家を買う時は調査しなければならない。
You will take to this new job before long.	あなたはこの新しい仕事がすぐに好きになるだろう。
"She likes music, doesn't she?" "So she does."	「彼女は音楽が好きではない」「そうだね」
"May I park here?" "No, you must not."	「ここに駐車してもよろしいですか」「いいえ、いけません」
She came up to me and said "How are you?"	彼女が私に近づいてきて「おげんきですか」と言った。
"Are those your books?" "No, they aren't."	「あれらはあなたの本ですか」「いいえ、違います」
209 files will open when the system starts up.	システム起動時で２０９のファイルを開きます
He learns how to make business applications.	彼が業務アプリケーションの作成方法を学習します
How are you finding the Quality Control department?	畑違いの品質管理課は如何ですか？
Well now ... shall we scarper before we're found?	さてと・・・見つかる前にずらかるか。
What is the program of the Kabuki for next month?	来月の歌舞伎座の出し物はなんですか。
What is the Christmas gift we are giving to her?	彼女へのクリスマスの贈り物は何ですか。
She told me that she would go to Paris in August.	彼女は私に８月にパリに行くといった。
She tries to read as many books as she can.	彼女はできるだけたくさんの本を読もうとしている。
She didn't know what to do with the problem.	彼女はその問題をどう扱うべきかわからなかった。
They came by two large cities on the country.	彼らはその国へ行く途中２つの大都市を通った。
He had to, but didn't want to, do the job.	彼は仕事をせざるはえなかったが、したくはなかった。
He is now looking for a bigger house to live in.	彼は今、もっと大きな家をさがしている。
He can't read French, much less write it.	彼はフランス語を読めない。まして書くことはできない。
I love him for what he is, not what he has.	彼の財産でなく、彼の人柄のために私は彼が好きだ。
By and large, this school is one of the best.	全般的に見てもこの学校は最優秀校のひとつだ。
All the goods for sale are set out on the tables.	商品はすべて陳列台に並べてあります。
I was thinking about what she had said to me.	私は彼女が私に言ったことについて考えていた。
I became friends with at least 10 Americans.	私は少なくとも十人のアメリカ人と友達になった。
I like to give gifts to my family and friends.	私は家族や友人に贈り物をするのが好きです。
It is six years since I started to study English.	私は英語を始めてからもう６年になる。
We have wanted to visit the city for a long time.	私たちは長い間その街を訪れなかった。
We are using a new process to make butter.	私たちはバターを作るのに新しい工程を用いています。
Miho was in the living room when I visited her.	私が美穂を訪ねたとき、彼女は居間にいた。
At first I didn't like him, but I do now.	最初は彼のことが好きではなかったけれど今は好きです。
Have you read the leading article in today's paper?	今朝の新聞の社説を読みましたか。
We had to learn the lines of the play in park.	一週間で劇のせりふを思えなければならない。
If you don't know, you had better ask around.	わからなかったら方々の人に聞いた方がいいよ。
If it were not for water, we could not live.	もし水がなければ、私達は生きていけないだろう。
Mary called him every name she could think of.	メアリーは彼に考えうる限りの悪態をついた。
Which present shall I take to the party?	パーティーにはどんなプレゼントを持っていきましょうか。
In any case, you must come here by ten.	とにかくあなたは１０時までにここに来なければなりません。
You had better ask him which way to take.	どちらの道を行ったらいいか彼にたずねたほうがいいよ。
Looks like you didn't study much for the test.	テストの勉強、あんまりしなかったようだね。
Just run down to the post office, won't you?	ちょっと郵便局までひとっ走りしてくれませんか。
It was the best experience in all my life.	それは私のこれまでの生涯の中で、最高の経験だった。
So we are saving up in order to buy them.	それで私たちはそれらを買うためにお金を貯めています。
The people in the room all know one another.	その部屋の人々は、みんな互いに知り合いだった。
The two cars tried to make way for each other.	その２台の車は互いに道を譲ろうとしたのだ。
I saw some people there leading a low life.	そこの人々が下層社会の生活を送っているのを見た。
Such being the case, I could not be present.	そういうわけだから私は出席できなかったのです。
I found all the shops closed by that time.	すべての店がその時までに閉まっているのがわかった。
"Weren't you there?" asked Mr Jordan.	ジョーダンさんは「授業に出ていなかったのですか」とたずねた。
Is this what you've wanted for a long time?	これですか、あなたが長い間欲しがっていたものは。
Please mail this form to your insurance company.	この用紙を保険会社に郵送してください。
If it were not for this book, I couldn't study.	この本がなかったら、勉強できないだろう。
There are a great many books in this library.	この図書館には非常にたくさんの本があります。
This is the first time I have visited England.	イングランドを訪れるのはこれが初めてです。
You shouldn't have told him about the plan.	あなたは彼にその計画を話さなければよかったのに。
Did you go to Ming's party last Saturday?	あなたは先週の土曜日ミンのパーティーに行きましたか。
What are you going to do with your first pay?	あなたの初めての給料をどうするつもりですか。
I can't make out what you are trying to say.	あなたが何を言おうとしているのか理解できない。
As many as ten people live in this small house.	１０人もの人がこの小さな家に住んでいる。
No less than 1,000 people came to the party.	１０００人もの人がそのパーティーへやってきた。
Now you are looking at our company website.	あなたは今、当社のホームページを御覧になっています
She was not in the least pleased with my present.	彼女は私の贈り物を少しも喜ばなかった。
She may have called me up while I was out.	彼女は私が外出している間に電話をくれたかもしれない。
She knows French, and even more English.	彼女はフランス語を知っている。英語はなおさら知っている。
She is trying to save as much money as she can.	彼女はできるだけお金を貯めようとしている。
She said that she had seen such and such there.	彼女はそこでしかじかの人々を見たと言った。
He made a point of reading ten pages every day.	彼は毎日必ず１０ページ読むことにしていた。
He made a point of reading ten pages every day.	彼は毎日かならず十ページ読む事にしていた。
He is at work now, but will return at seven.	彼は今仕事中ですが、７時には戻ってくるでしょう。
He does not know English, much less French.	彼は英語を知らない。フランス語はなおさらのことだ。
He can't read English, much less German.	彼は英語が読めない。ましてやドイツ語はなおさら読めない。
He has been well off since he started this job.	彼はこの仕事を始めてから暮らし向きがよい。
If he can do it well, so much more can we.	彼ですらそれが上手にできるなら、我々ならなおさらだ。
No other city in Japan is as large as Tokyo.	日本のほかのどの都市も東京ほど大きくありません。
There are people called Incas in South America.	南アメリカにインカ族と呼ばれる人々がいる。
Can you check if the phone is out of order?	電話機が故障しているかどうか調べていただけますか。
I took the job without giving it much thought.	深く考えないでその仕事を引き受けてしまった。
We used the computer in order to save time.	私達は時間を節約するためにコンピューターを使った。
I have to make the best of that small room.	私はその狭い部屋をせいぜい活用しなければならない。
I told him that I had seen her a week before.	私は１週間前に彼女に会った、と彼に話しました。
We like English the best of all our subjects.	私たちはすべての教科の中で英語が一番好きです。
Rie Kawada will do my job while I'm gone.	私が不在の間は河田理恵が私の仕事をすることになります。
It will be a long time before I can buy a house.	私が家を買えるのはずっと先のことだろう。
It is more than five years since I last saw him.	私がこの前彼に遭ってから５年以上になる。
I would do it in a different way than you did.	君がやったのと違うやり方で僕ならするだろう。
There are a great many people trying buy houses.	家を買おうとしている人が非常に多くいる。
I've read any and every book in this library.	わたしはこの図書館のありとあらゆる本を読んだ。
If I knew her address, I would write to her.	もし彼女の住所を知っていれば、手紙を書くのだが。
If I knew it, I would tell it to you.	もし私がそれを知っているなら、私はそれをあなたに告げるだろう。
What would you say if you were in my place?	もしあなたが私の立場だったらどうおっしゃいますか。
I'd like to know how to send money to France.	フランスへの送金の仕方を教えて欲しいんですが。
I want you to take back what you said just now.	たった今言ったことを取り消してもらいたい。
The problem has more to do with you than with me.	その問題は私よりも君の方と関係が深い。
The man controlled the country for fifty years.	その男は５０年にわたってその国を支配した。
All the signs are that she is getting better.	すべては彼女がよくなっていることを示している。
This is going to take a long time, said Tony.	これは長い時間かかりそうだ。とトニーは言った。
How long does it take for you to read this book?	この本をあなたはどれぐらいで読めますか。
We're having a sukiyaki party this Sunday.	この日曜日にすき焼きパーティーをする事になっている。
All you have to do is to hand this book to him.	きみはこの本を彼に渡してくれるだけでいい。
I don't know when I'll get around to visiting you.	いつあなたを訪問できるか分からない。
Life as it is is very uninteresting to him.	あるがままの人生は彼にとっては非常に退屈なものだ。
The USA is a good market for Japanese products.	アメリカ合衆国は日本製品の良い市場である。
I will be studying when you come at seven.	あなたが７時に来るときには私は勉強をしているだろう。
It is said that Yamada and Sato are in the same class.	山田と佐藤はクラスが同じと言う
There aren't very many places like that around here.	この周辺にはそういう場所が殆ど無い
There were many people who helped me get there.	そこに至るまでには多くの方々の協力を得ました
I found out about this website for the first time.	私は初めてこのサイトの存在を知りました
He has more than 8 years experience in the field.	彼がその業務に８年以上の実務経験を有する
You will no longer be allowed to use our service. 	今後、弊社サービスのご利用をお断ります
I will have lived here for ten years next month.	来月でここに１０年間住んだことになります。
The problem is what we should do with this money.	問題は我々がこの金をどう処理すべきかだ。
She doesn't get paid by the month, but by the day.	彼女は月給ではなく日給をもらっている。
She gave him all the money that she had then.	彼女はその時持っていたすべてのお金を彼にあげた。
It took a long time for her to write the report.	彼女がレポートを書くのに長い時間かかった。
He said he would give a helping hand to them.	彼は彼らに援助の手を差し伸べるつもりだと言った。
He had to, but didn't want to, do the job.	彼はその仕事をせざるを得なかったが、したくはなかった。
He has been working on a new book for two months.	彼は２ヶ月間、新しい本に取り組んでいる。
Did you check all the items on the shopping list?	買い物リストの品物を全部確かめましたか。
Mariko studied not only English but also German.	真理子は英語だけでなくドイツ語も勉強した。
This one is of much higher quality than that one.	質ではこれはあれよりはるかに勝っている。
Get off my back about my personal life!	私個人の生活についてとやかくうるさくいうのはやめてください。
I have kept company with her for about 10 years.	私は彼女と１０年ほど親しくつきあってきた。
I didn't call on him because I wanted to.	私は彼を訪ねたからと言う理由で、彼を訪ねたわけではない。
I have to take these books back to the library.	私はこの本を図書館に返却しなければならない。
The problem before us today is not a new one.	現在我々が当面している問題は新しいものではない。
You are free to do as you please with your money.	君は好きなように君のお金を処分してよい。
I'm thinking of visiting you one of these days.	近いうちにあなたを訪ねようかと思っています。
One can't help many, but many can help one.	一人で大勢は助けられないが、大勢は一人が助けられる。
Our company has come a long way since it was set up.	わが社も設立以来よく伸びたもんだ。
Can you tell me how to get to Lincoln Center?	リンカーン・センターにはどう行けばよいのですか。
You should set a high value on every man's life.	すべての人の生涯を高く評価するべきである。
I'd like to place a person-to-person call to Chicago.	シカゴに指名通話をお願いします。
The right word for this does not come to me.	これを言いあらわす適当なことばが思いうかびません。
Tell me where I am, and what's going on, oh please.	ここは何処なんだ、何がどうしたんだ。
How long does it take to get there from here?	ここからそこまで行くのにどれくらいかかりますか。
How long does it take from here to your house?	ここからあなたの家までどれくらいかかりますか。
Kazu told her that he would go to Brazil in May.	かずは彼女に５月にブラジルへ行くと言った。
India is the seventh largest country in the world.	インドは世界で７番目に大きい国である。
For all you say about him, I still like him.	あなたが彼についてどう言おうと私はまだ彼が好きだ。
Many people are better off than they used to be.	暮らし向きが以前よりよくなっている人が多い。
She is trying to save as much money as she can.	彼女は出来るだけお金を溜めようと努力している。
She is trying to save as much money as she can.	彼女はできるだけお金を貯めようと努力している。
Try to see the problem from her point of view.	彼女の立場からその問題をとらえるようにしなさい。
He can do it well, and you can do it even better.	彼はそれをうまくやれる、君ならなおさらだ。
He has been keeping company with Ann for three months.	彼はアンと三ヶ月付き合っている。
In Japan people come of age when they are 20 years old.	日本では、２０歳で成人となる。
What is the total price with all taxes included?	全ての税を入れると合計でいくらになりますか。
In nine cases out of ten he will take the first place.	十中八九、彼は一位になるだろう。
I gave him what little money I had with me.	私は少ないながら持ち合わせていたお金を全部彼にやった。
I bought every book on Japan I could find.	私は見つけることができる日本に関するあらゆる本を買った。
I'm saving up so that I can go to Australia.	私はオーストラリアに行けるようにお金を貯めています。
We made friends with at least ten Americans.	私たちは少なくとも１０人のアメリカ人と友達になった。
We have been studying English for three years now.	私たちはもう３年間英語を勉強しています。
She loved me in the same way that I loved her.	私が彼女を愛したように、彼女も私を愛してくれた。
I also know the job won't be very well done.	仕事ぶりはあんまりよくないということもわかっている。
At first, I couldn't make out what he was saying.	最初は彼の言っていることが分からなかった。
From now on, I'll try to help you with the work.	今後、あなたの仕事を手伝うようにしましょう。
You will need much more money than you do now.	君は今よりもずっと多くのお金が必要になるだろう。
Why are you here when you should be in school?	学校にいるはずのおまえがなぜこんな所にいるのか。
We haven't had a price increase in the last five years.	過去５年間価格を上げてません。
London is one of the largest cities in the world.	ロンドンは世界で最も大きな都市の一つです。
If the car is gone, he can't be at the office.	もし車が無いのなら、彼は事務所にいるはずがない。
Takeshi looked very much like one of my friends.	たけしは私の友達の一人と大変よく似ています。
Please give me the paper when you have done with it.	その新聞を読み終えたら私にください。
The more I think of it, the less I like it.	そのことを考えれば考えるほど、私はますますいやになる。
I think that there are many places to see there.	そこにはたくさん見るところがあると思います。
This is just what I have been looking for so long.	これこそ私が大変長い間探していた物です。
This house is about the same size as Peter's.	この家は、ピーターの家とだいたい同じくらい大きい。
I'd like to try out the aerobics class for a day.	エアロビクス教室に一日入学したいのですが。
That is the house where I have lived for a long time.	あれが私が長い間住んでいる家です。
How much time does it take to get from A to B?	Ａ市からＢ市までどれくらいの時間がかかりますか。
"Why aren't you going?" "Because I don't want to."	「なぜ行かないの」「行きたくないからさ」
I want to create the best ramen website in Japan .	ラーメンに関する日本一のサイトを目指します
You should take full control of your own health care.	特に健康管理には十分気をつけましょう
I have to take a make up test in English next week.	来週英語の追試験を受けなければならない。
Yoko is in London now. She's studying English.	洋子は今ロンドンにいる。彼女は英語を勉強している。
I gave her my word I would be back home by nine.	僕は９時までに帰るという約束を彼女にしました。
Please credit my account for the returned item.	返品した品物の代金を私の口座に振り込んで下さい。
She is in her thirties, but looks old for her age.	彼女は３０代だが、歳の割にはふけて見える。
She has been studying English since the age of ten.	彼女は１０歳からずっと英語を習っている。
She is trying to save as much money as she can.	彼女は、出来るだけお金をためようと努力している。
He has been keeping company with Mary for three years.	彼は三年間メアリーと交際している。
He knew better than to tell the story to her.	彼はその話を彼女にするような馬鹿なことはしなかった。
He started learning English at the age of eleven.	彼は１１歳の時から英語の学習をはじめました。
How do I get to your office from Hioka Park?	日岡公園から貴社へはどうやって行ったらよいでしょうか。
It's best to have one of the locals show you around.	土地の人に案内してもらうのが一番だよ。
Our world is getting smaller and smaller every year.	世界は毎年ますます狭くなってきている。
If you're low on money, this one will be on me.	持ち合わせが足りなければ、ここは私が払いますよ。
I ran out of the room without knowing what I was doing.	私は無我夢中で部屋を飛び出した。
I asked her for a date, only to have her say no.	私は彼女をデートに誘ったが断られただけだった。
I have to return this book to the library today.	私はこの本を今日図書館に返さなければいけない。
We will have to call on our friends to help us.	私たちは友人に援助を求めなければならないだろう。
We are to pay back the money within the week.	私たちは今週のうちにそのお金を返さなくてはならない。
We will travel to Los Angeles by way of Hawaii.	私たちはハワイ経由でロサンゼルスに旅する予定だ。
We haven't seen each other for such a long time.	私たちはずいぶん長い間お互いに会っていません。
It has been twenty years since I saw you last.	私がこの前あなたにお会いしてから２０年になります。
It pays in the long run to buy goods of high quality.	結局は質の良い物を買う方が得をする。
I don't like both of you going to such a place.	君たち二人がそんな場所へ行くことを私は好まない。
Can you tell me how to get to Hyde Park?	どのようにしてハイドパークへ行ったらいいか教えてくれませんか。
Not knowing what to do, he asked me for help.	どうしていいのかわからなくて、彼は私に助けを求めた。
These messages have to be read between the lines.	その文章は言外の意味を読み取らねばならない。
John and Mary have known each other since 1976.	ジョンとメアリーは１９７６年以来の知り合いです。
It has been three years since I came to live here.	ここに住むようになってから３年になります。
That Italian author is little known in Japan.	あのイタリアの作家は日本ではほとんど知られていない。
You must have such friends as will help you.	あなたを助けてくれるような友達を持たなければならない。
The new designs are much better than the old ones.	その新しいデザインは古いのよりずっとよい。
He is good at French, much more so at English.	彼はフランス語が得意です。まして英語はなおさらです。
She told me about what she saw in Australia.	彼女はオーストラリアで見たことについて私に話してくれた。
She has been on her own since the age of eighteen.	彼女は１８歳のときから経済的に独立している。
I had a call from her for the first time in a long time.	彼女から久しぶりに電話があった。
He's coming back from America a week from today.	彼は今日から１週間目にアメリカから帰ってきます。
He knew full well that he didn't have long to live.	彼はもう先が長くないことをよく知っていた。
He knew better than to tell the story to her.	彼はその話をする彼女にするような馬鹿な事はしなかった。
When asked how to do it, he said he didn't know.	彼はそのやり方を尋ねられたが、知らないと言った。
He has read as many as 50 books in the last two weeks.	彼はこの２週間に本を５０冊も読んだ。
If he asks, I will give it; if not, not.	彼がほしいと言うなら、それをあげよう。言わないならやめておこう。
It is more than ten years since we came to live here.	当地に住み着いてから１０年以上になる。
Tomoko asked her friends to come to her party.	智子は友人に彼女のパーティーに来てくれるよう頼んだ。
All in all, we had a good time at the party.	全体としてみれば、私達はパーティーで楽しい時を過ごした。
The new designs are much better than the old ones.	新しいデザインは古いデザインよりずっとよい。
I know the very person that will do this job.	私はこの仕事をするのにうってつけの人物を知っています。
It's because I was asked to come that I'm here.	私がここに来ているのは来るように言われたからです。
At first, I couldn't make out what he was saying.	最初私は彼が言っていることが理解できなかった。
You should take care so that you can have good health.	健康であるように気をつけるべきです。
Had I known about it, I would have told you.	もし私がそのことを知っていたら、君に話していただろうに。
Why do many people like John Lennon so much?	なぜ多くの人々がジョン・レノンをそんなに好きなのですか。
Say, Mike. Tell me how to get to your house.	ところでマイク、あなたの家への行き方をおしえてください。
You must do the work, even if you do not like it.	たとえいやでもその仕事はしなければいけないよ。
Tatsuya has some friends who live in New York.	タツヤにはニューヨークにすんでいる友人が数人います。
It was last week that John bought a second-hand car.	ジョンが中古車を買ったのは先週であった。
Now, are you going back to your room or not?	さあ、とっとと自分の部屋に帰るのか帰らんのか、どっちだ？
You know, there are more and more old people.	ご存知の通り、お年寄りがますます多くなってきています。
We have to find a new market for these products.	これらの製品の新たなる販路を開拓せねばならない。
I'd like to try out this new model before I buy it.	この新しい機種を買う前に一度試してみたい。
Could you give me a card with this hotel's address?	このホテルの住所を書いたカードをください。
Kate has three times as many records as Jane has.	ケイトはジェーンの３倍のレコードを持っている。
I just asked because I thought you would know.	あなたならわかると思ってちょっと聞いてみたまでです。
If Jason should call me, tell him I'm not in.	万一ジェイソンが電話してきたら、僕はいないといってくれ。
Mahjong is a game well-known all around the world.	麻雀は世界でとても有名な、ゲームのひとつです。
She wrote down the name and address as requested.	彼女は要求されたようにその名と住所を書き留めた。
She knows ten times as many English words as I do.	彼女は私の１０倍近く多くの英単語を知っている。
He will tell her about it when she comes back.	彼女が帰ってきたときに、彼はそれについて話すでしょう。
He gave me what little money he had about him.	彼は少ないながらも持ち合わせていた金を全部私にくれた。
He told me that he had seen her there the day before.	彼は私に前日そこで彼女に会ったと言った。
I don't like him any more than he likes me.	彼がぼくのことを好きでないのと同様、ぼくも彼を好きではない。
We can drive in Japan when we are eighteen years old.	日本では十八歳になると車を運転できます。
It pays in the long run to buy goods of high quality.	長い目で見ると良い品物を買った方が得だ。
The company plans to sell the new product for $1,000.	新製品を１０００ドルで販売する計画です。
It took me some time to learn how to drive a car.	車の運転を覚えるのにしばらく時間がかかりました。
I couldn't for the most part make out what he said.	私は彼の言ったことを大部分理解できなかった。
When you can come to my house, please call me first.	私の家に来れる時は、まず電話をして下さい。
It's best to make international calls person to person.	指名通話で国際電話をかけるといいよ。
There is going to be a game between Waseda and Keio today.	今日早稲田対慶応の試合がある。
There's less to do in this job than the last one.	今度の仕事は前の仕事よりもやるべきことが少ない。
It might be said that this is the computer age.	現在はコンピューター時代といってもいいくらいである。
You need to have friends who can help you out.	君は君を助けてくれるような友達を持たなければならない。
Our company wants to take part in that research project.	わが社はその調査計画に参加したい。
If I had known the news, I would have told you.	もしそのニュースを知っていたら、君に言っただろうに。
Not knowing what to do, I asked him for help.	どうして良いか分からなかったので、私は彼に助けを求めた。
Not knowing what to do, I asked him for help.	どうしてよいかわからなかったので、私は彼に助力を求めた。
I'd like to try on one size smaller than this.	これよりも１サイズ小さいものをしちゃくしたいのですが？
This is room No. 1025. Room service, please.	こちらは１０２５号室ですが、ルームサービスをお願いします。
Here is note from him. He must have come here.	ここに彼の書き置きがある。これはここに来たに違いない。
Please tell me how to get to the post office from here.	ここから郵便局への道を教えて下さい。
Australia is about twenty times as large as Japan.	オーストラリアは日本のほぼ２０倍の大きさです。
You look as if you don't have a care in the world.	あなたは浮き世の悩みがないような顔をしている。
Does she still want to take part in the party?	彼女は今でもまだパーティーに参加したがっているのですか。
She didn't play cards, because she didn't like it.	彼女はトランプがすきではなかったのでしなかった。
He not only does not work but will not find a job.	彼は働かないだけでなく、仕事を探そうともしない。
He makes a living by working for a government office.	彼は政府関係の事務所で働いて生活している。
He is trying to keep up with the current of the times.	彼は時代の流れに遅れないようにしている。
He is a different person from the one we are looking for.	彼は私達が探している人とは別人だ。
He must have said so without giving it much thought.	彼はそう言ったがそれは出任せに決まっている。
He had no money and so could not buy any food.	彼はお金がなかったので、食べ物を買うことができなかった。
He said that he had been in California for ten years.	彼は１０年間カリフォルニアにいたと言った。
I don't know if he will visit us next Sunday.	彼が今度の日曜日に私達のところに来るかどうかは分からない。
She lived in five different countries by age 25.	二十五歳までに、彼女は異なる五つの国で暮らしてきた。
You should not allow him to get out of your hand.	手がつけられないほど彼に甘くすべきではありません。
What's the good of having a car if you don't drive?	車を持っていても運転しなければ何にもならない。
We'll have to try and make the best of it.	私達はそれを禍とせず最善を尽くして頑張っていかなくてはならない。
I don't love her, not even if she loves me.	私は彼女を愛してはいない、彼女のほうで愛してくれてもごめんだ。
I would like to go to Austria in order to study music.	私は音楽の勉強にオーストリアへ行きたい。
I have to make money to buy a personal computer.	私はパソコンを買うためにお金をためなければならない。
I made friends with many Americans at the party.	私はそのパーティーで多くのアメリカ人と親しくなった。
We have not seen each other since our school days.	私たちは学生時代以来ずっとお互いに会っていない。
We know that we are all people of one world.	私たちは、私たち皆が一つの世界の国民であることを知っている。
It pays in the long run to buy goods of high quality.	高級な品物を買う事は、結局は損にならない。
The more she thought about it, the less she liked it.	考えれば考えるほど彼女はそれが嫌になった。
Ms. Roland, what do you think about this problem?	ローランドさん、この問題についてどうお考えですか。
There is no one who doesn't want to have good friends.	よい友達を得たいと思わない者はいません。
If I had had more time, I would have written to you.	もっと時間があったら、君に便りを出したのに。
If you don't have money, you have to do without.	もしお金がないのなら、なしで済まさなければならない。
Nathanael asked Jesus, "How do you know me?"	ナタナエルはイエスに言った。「どうして私をご存じなのですか」
Tom loved Mary, who didn't love him at all.	トムはメアリーを愛していたが、彼女は彼を全く愛していなかった。
Well, I think it's time the real story was told.	ところで、もう本当の話がされてもいい時期だと思うよ。
Not knowing what to do, I asked him for help.	どうしたらよいかわからなかったので、私は彼に助力を求めた。
From that day on, we helped him learn Japanese.	その日から私たちは彼が日本語を学ぶのを手伝ってやった。
You had better go over the house before you take it.	その家を買う前に、よく調べた方がいいですよ。
It'll be opening time, time I get down there.	そこにたどりついたときはもう開始の時刻になっているだろう。
From this point of view we should say he was right.	この観点からすれば、彼は正しかったと言えよう。
How long does it take to get to Chicago from here?	ここからシカゴへ行くのにどのくらいかかりますか。
How many Christmas cards did you write last year?	あなたは去年、クリスマスカードを何枚書きましたか。
She said to me, 'I'll go out and buy cookies.'	「外へ行ってクッキーを買ってくるわ」と彼女は私に言った。
"Are you from Australia?" asked the Filipino.	「オーストラリアからですか」とフィリピン人はたずねました。
Yumi and Emi were studying for their English test.	由美と絵美は英語のテストのために勉強していました。
They can't have gone out because the light's on.	明かりがついているのだから、彼らが外出したはずがない。
She came to Tokyo with a view to getting a new job.	彼女は新しい職を見つけるために東京にやってきた。
She will return home next Sunday, that is, the tenth.	彼女は今度の日曜、すなわち１０日に帰ります。
She would not tell me why she had gone home first.	彼女はなぜ先に家に帰ったか私に言おうとしなかった。
They don't know what they should do with the money.	彼らはそのお金をどう処理すべきかわからなかった。
He said that if he were there, he would help her.	彼はもしそこにいたら、彼女を助けてやるのにと言った。
He said he had bought that book there the day before.	彼は「この本をきのうここで買った」と言った。
I was going to call him, but thought better of it.	彼に電話をかけるつもりだったが、考え直してやめた。
Will you tell him about it when he comes home?	彼が帰ってきたら、そのことについて彼に話してくれませんか。
When you read a book you should read between the lines.	読書するには趣旨をくみ取ることが必要だ。
I bought a new computer to keep up with the times.	時代に遅れないように新しいコンピューターを買った。
I have to hand in my report by next Wednesday.	来週の水曜日までにレポートを提出しなければならないんです。
I'll have to make do with the old car for a while.	私はしばらくは古い車で間に合わせなければならない。
I work every other day: Monday, Wednesday, and Friday.	私は、月・水・金と一日おきに仕事をします。
I work every other day: Monday, Wednesday and Friday.	月曜、水曜、金曜と私は１日おきに働いている。
I called at Nancy's house on my way home from school.	学校の帰り道、ナンシーの家に立ち寄りました。
You have to look out for other cars when you drive.	運転する時は、他の車に注意しなければなりません。
Not having seen her before, I did not know her.	以前会ったことがなかったので、私は彼女がわからなかった。
How can you tell an Englishman from an American?	どのようにしてイギリス人とアメリカ人を区別できますか。
You don't have to tell it to me if you don't want to.	それを私に言いたくなければ、言う必要はない。
The place just doesn't look as good as it used to.	その場は以前ほどはきれいになっていないようなのだ。
The business hasn't been paying for the last six months.	その事業はここ６ヶ月もうかっていない。
Only twenty people will come to the party at best.	せいぜい２０人しかそのパーティーには来ないだろう。
Jane gave me the same present as Wendy did.	ジェーンは私にウェンディがくれたのと同じプレゼントをくれました。
It'll take a week or so to read through this book.	この本を読み終えるには１週間かそこらかかるだろう。
This experience will do you good in the long run.	この経験は長い目で見れば、あなたのためになりますよ。
In him was life, and that life was the light of man.	このかたに命があった。この命は人の光であった。
Gary will have been in Japan for six years next month.	ゲアリーは来月で日本に６年いたことになる。
The price of the stock of that company will not come down.	あの会社の株価は下がらないだろう。
You have only to ask him if he'd like to join us.	あなたは、彼に参加したいかどうか尋ねさえすればいい。
"Why aren't you going?" "Because I don't want to."	「どうして行かないの？」「行きたくないからだよ。」
He had started going back to Mr. Yamada's class in 2002.	彼が０２年から再び山田先生の教室に通った
Good timing. I'll get you to test drive the new model.	ちょうどいいね。新型の試乗してってもらうね。
She knew him better than did all the others.	彼女は彼のことを、他のみんなが知っていたよりも、よく知っていた。
She wants to travel to Antarctica, of all places.	彼女は場所もあろうに南極大陸に旅行したいと言っている。
She looks better today than when I her saw last.	彼女は私がこの前会った時より今日の方が体調が良さそうだ。
He doesn't work here now, but he used to work here.	彼は今ではここで働いていないが、以前は働いていた。
The new designs are much better than the old ones.	新しいデザインの方が古いデザインよりもはるかによい。
I couldn't for the most part make out what she said.	私は彼女の言ったことを大部分は理解できなかった。
I wanted to take part in the party but I couldn't.	私はそのパーティーに参加したかったが、出来なかった。
What has become of my old house where I used to live?	私が以前住んでいた古い家はどうなったのだろう。
I'm planning to read as many books as I can this year.	今年はできるだけたくさん本を読むつもりです。
Had I known it, I'd have told you about that.	もしそれを知っていたらなら、私はその事をあなたに話しただろう。
This is the very book that I have long wanted to read.	これこそ私が長い間読みたいと思っていた本だ。
A person named Jones came while you were out.	あなたの留守の間にジョーンズさんとおっしゃる方が来られました。
Look! That shop's just opened! Why not take a look?	ね、ね、あの店、ニューオープンだって！よってみない？
It is no use going to school if you are not going to study.	勉強しなければ学校へ行ってもむだだ。
What do you say to asking her to come and help us?	彼女に手伝いに来てくれるように頼んでみてはどうですか。
They found that their families didn't like each other.	彼らはお互いの家族が憎み合っているとわかった。
He had been there for ten years before he came to Kyoto.	彼は京都に来る前に１０年間そこにいました。
We must hand in a history paper by next Saturday.	次の土曜日までに歴史のレポートを提出しなければならない。
I said Paul was out, but that Mary was at home.	私は「ポールは外出中ですが、メアリーは家にいます」と言った。
He told me that if he were I, he would not do so.	私が君だったらそんな事はしないだろうよと彼は私に言った。
I could have done better if I had had more time.	もっと時間があったら、もっとうまくやることが出来たのだが。
By that time he will have seen much of the world.	そのときまでに彼はだいぶ世間のことが分っているでしょう。
Jane has it in for Bob because he didn't help her.	ジェーンはボブが助けてくれなかったのを根に持っている。
I will tell him about it when he comes next time.	この次に彼がきた時に、そのことについて彼に話しましょう。
At any rate, it will be a good experience for you.	いずれにしてもそれは君にとって良い経験となるでしょう。
You may as well make friends with people who need you.	あなたを必要とする人々と仲良くなった方がよい。
He requests information materials from each insurance company.	彼が各保険会社に資料請求をします
It had been a long time since he played a game for that long.	彼が久しぶりに長時間ゲームをやった
All for one, and one for all. That's team play.	一人はみんなの為に、みんなは一人の為に。それがチームプレイだ。
You've come up in the world since the last time I saw you.	僕が最後に君にあって以来君は出世したね。
She is open to people who have a different point of view.	彼女は見解の異なる人々にも心を閉ざさない。
He keeps two cats: one is black, and the other white.	彼は猫を二匹飼っている。一匹は黒でもう一匹は白だ。
He keeps two cats: one is black, and the other white.	彼は２匹猫を飼っている。一匹は黒でもう一匹は白だ。
The more you know about him, the more you like him.	彼のことを知れば知るほどいっそう彼のことが好きになる。
If you travel in China, it is best to go with a guide.	中国を旅するならガイドを連れていくのが一番いい。
I'm going to Europe by way of Anchorage next week.	私は来週アンカレッジ経由で、ヨーロッパへ行くつもりです。
If I had the money, I would travel around the world.	私にもしそのお金があれば、世界一周旅行をするだろう。
Not only did we go to Paris, but we also visited Rome.	私たちはパリに行っただけでなく、ローマも訪れた。
Many old people these days can't keep up with the times.	最近では、多くの老人が時勢についていけない。
If it were not for my family, I would give up this job.	家族がいなければ、私はこの仕事を辞めるだろう。
He would not say so if he didn't know about that.	もし彼がそのことについてしらなければそうは言わないだろう。
If she knew your address, she would write to you.	もし君の住所を知っていれば、彼女は君に手紙を書くだろうに。
There are many jobs available in the computer industry.	コンピューター産業ではいろいろな働き口がある。
Please show me some of the travel guides for this country.	この国の旅行ガイドを見せてくれませんか。
All you have to do is to write your name and address here.	ここに君の名前と住所を書けばよいのです。
Have them send you an application form over the Internet.	インターネットで願書を取り寄せるといいよ。
The more books you read, the more you'll know.	あなたはたくさんの本を読めば読むほど、たくさんの事を知るだろう。
For more information, please visit the company's home page.	詳しくは会社のホームページを見てください
I had ramen at a ramen shop for the first time in a long time.	久々にラーメン屋でラーメンを食った
Her business called for her to travel around the world.	彼女の仕事は彼女に世界中を旅することを要求した。
If only she were here, she would tell me what to do.	彼女がここにいれば、何をすべきか教えてくれるだろうに。
Compared with America or China, Japan is a small country.	日本はアメリカや中国に比べれば小さな国です。
If only I knew, I would tell you all that I knew.	知ってさえいれば、知っているかぎりお話しするのですが・・・。
Man lives in communities such as cities and countries.	人は市や国というような生活共同体を作って生活する。
We knew that Columbus visited America in 1492.	私たちはコロンブスが１４９２年にアメリカを訪れたことを知っていた。
It is our policy not to give out personal information.	個人に関する情報は、教えないのが私どもの方針です。
How long does it take to go to the office from your home?	家から会社までどれくらい時間がかかりますか。
Yokohama is a city where more than three million people live.	横浜は３００人以上の人が住む都市だ。
It will be three months before our house is completed.	われわれの家が完成されるまでに３カ月かかるだろう。
Please hand in your papers by the last day of this month.	レポートは今月の末日までに提出してください。
Had I had a little more money, I would have bought it.	もうすこしお金を持っていたら、それを買っただろう。
Why should he think that he knows better than I do?	どうして彼は自分のほうが僕より分別が有ると思うんだろう。
This is also part of your work, as I told you before.	すでに言ってあるように、これもあなたの仕事のうちだ。
In order to use a computer, you must learn to type.	コンピューターを使うには、タイプを覚えなくてはならない。
This is the very place I have long wanted to visit.	これこそまさに長い間私が訪ねたいと思っていたところです。
Every time you read a book, you will be the better for it.	あなたは本を読むたびに一層向上するだろう。
A man who wanted to see you came while you were out.	あなたに会いたいと言う人が、あなたの留守中に来ました。
"I can make it to my class on time," he thought.	「時間通りに、教室にうまく行き着くことができる」と彼は思った。
The better you get to know her, the more you'll like her.	彼女を知れば知るほどますます好きになるだろう。
It took a long time to take in what she was saying.	彼女が言っている事を理解するのにずいぶんと時間がかかった。
They are trying to drive Japanese goods out of the market.	彼らは日本品を市場から駆逐しようとしている。
He is not the man that he was when I first knew him.	彼は私が最初に知り合った頃の当時の彼ではなくなっている。
He is studying English, but he is also studying German.	彼は英語を勉強しているが、ドイツ語も勉強している。
We couldn't go there because we didn't have a car.	車がなかったので、私たちはそこへ行くことができませんでした。
I will have been studying for five years next February.	私は今度の２月で５年間勉強していることになります。
The guide who took us there was only ten years old.	私たちをそこに案内してくれたのは、ほんの１０歳の子だった。
At Christmas we send Christmas cards to our friends.	私たちはクリスマスには友人にクリスマスカードを送ります。
A person named Sato came to visit while you were out.	佐藤さんという方があなたの留守中にお見えになりました。
Living costs this month are lower than those of last month are.	今月の生活費は先月よりかからない。
Experience without learning is better than learning without experience.	亀の甲より年の功。
Please come to my house next Saturday if you care to.	もしよければ、今度の土曜日にうちに遊びに来てください。
If you are to do it, you must make a good start.	もしそれをするつもりならば、よいスタートをきらなければならない。
It was at Oxford University that Tom studied history.	トムが歴史を研究したのはオックスフォード大学でだった。
Even if she comes to see me, tell her I am not at home.	たとえ彼女が会いに来ても、私は留守だと言ってくれ。
So I will see him running on the way to school today.	だから今日学校へ行く途中彼が走っているのを見るだろう。
No person by that name is listed in the register of the school.	その名の人は学籍簿に載ってません。
They might pay me more if I could use a computer.	コンピューターを使えたらもっとお金を貰えるかもしれないのだが。
They might pay me more if I could use a computer.	コンピューターが使えたらもっとお金をもらえるかもしれないのに。
Alan Tate and I looked at one another for a while.	アラン・テイートさんと私はしばらくの間お互いに見つめ合った。
How can you make your way in life without a good education?	良い教育を受けないでどうして成功できるのか。
You are allowed to check out not more than five books at a time.	本の貸出しは１度に５冊までですよ。
Not only did he come but he also offered to help me.	彼は来てくれただけでなく、援助してあげようと言ってくれた。
We'll have to make do with the old one for a while.	当分は今まで使っていた古いやつで間に合わせなければならない。
How long does it take you to go home from my house?	私の家からあなたの家に帰るのにどのくらい時間がかかりますか。
You should have told him about it while he was here.	君は彼がここにいるうちに、そのことを話しておくべきだった。
Why don't you look in on Mr Anderson on your way back?	帰る途中にアンダーソン氏をちょっと訪ねたらどうですか。
We have two cats; one is white, and the other is black.	家はねこが２匹います。１匹は白で、もう１匹は黒です。
If I had known her address, I could have visited her.	もし彼女の住所がわかっていたなら、彼女を訪問できたのに。
If I had known it, I would have told it to you.	もし私がそれを知っていたとしたら、私はそれをあなたに言っただろうに。
The ballboys and ballgirls all come from local schools.	ボールボーイとボールガールはみな地元の学校の生徒だ。
Even if I have to sell my house, I'll keep my business going.	たとえ家を出る事になっても事業は続ける。
It will be done a week from today, that is, on May 3.	それは今日から一週間後、つまり５月３日に行われるだろう。
It will be done a week from today, that is, on May 3.	それはこれから１週間後、つまり５月３日に行われるだろう。
The program does not allow for changes at this point in time.	その計画は現在では全く変更の余地がない。
Here are two dogs; one is white and the other is black.	ここに２匹の犬がいます。１匹は白で、もう１匹は黒い。
I've visited many countries, but I like Japan best of all.	いろいろな国へ行ったがやっぱり日本が一番いい。
The other day, I read a book for the first time in a long time.	私は先日久しぶりに１冊の本を読みました
We support your new life with our products and services.	当店が商品とサービスであなたの新生活をサポートします
She got into the university with a view to studying English.	彼女は英語を勉強するためにその大学に入った。
If I had known her address, I would have written to her.	彼女の住所を知っていたら、彼女に手紙を書いただろう。
He doesn't have what it takes to make it around here.	彼はここでうまくやっていくには何が必要かわかっていません。
I am saving money in order to buy a new personal computer.	新しいパソコンを買うつもりで金を溜めているんだ。
I have read sixty pages, while he has read only ten.	私は６０ページ読んだが、一方彼は１０ページしか読んでいない。
Los Angeles is one of the places that I'd like to visit.	ロサンゼルスは私が行ってみたいと思う場所の１つです。
I'd like to make a person-to-person call to Mrs. Richards.	リチャーズさんの奥さんに指名通話をお願いします。
We could have bought the car with a little more money.	もう少しお金があったなら、その車を買うことができたのに。
A party is a good place to make friends with other people.	パーティーはほかの人と友達になるのにいい場所だ。
The car cost $5000 and did not run well at that.	その車は五千ドルもしたが、それにもかかわらず、まともに走らなかった。
If he doesn't want to learn, we can't make him.	その気がなければ、はたからはどうすることもできないとよく言うだろうね。
How many days will it take if I send this as registered mail?	これを書留で送ると何日くらいかかりますか。
The quality of their products has gone down over the years.	ここ数年にわたって彼らの製品の質は落ちてきた。
How long do you think it takes to go from here to Tokyo?	ここから東京までどれぐらい時間がかかると思いますか。
Will you help me give out the programs to those people?	あの人たちにプログラムを配る手伝いをしてくれませんか。
I want to make a person-to person call to 212-836-1725.	２１２ー８３６ー１７２５に指名通話をかけたいんだけど。
Next Sunday we are going to have a party for Mr Oka.	来週の日曜日私たちは岡先生のためのパーティーをするつもりです。
I'll pay you back a week from today, that is, on July 21.	来週の今日、すなわち７月２１日に君に返済いたします。
Nakagawa was on the point of going out when I called on him.	中川君を訪問したとき彼は出かけようとしていた。
I learned to study and play like my Japanese friends.	私は、日本人の友人達と同じように勉強し遊ぶようになりました。
What's new with you? How is your new job working out?	君のほうは変わりはないですか。新しい仕事はどんな具合ですか。
You can't just come in here and start ordering people around.	いきなり入って来て威張ってもらってもこまる。
It will not be long before one out of five people owns a car.	５人に１人が車を持つような日も遠くあるまい。
If you need books, make the most of the books in the library.	本が必要なら、図書館の本を最大限利用しなさい。
She got a part-time job so that she could study at college.	彼女は大学で勉強できるようにアルバイトを見つけた。
Shakespeare was not of an age but for all time.	シェイクスピアは一時代だけの人ではなくて、あらゆる時代に通じる人であった。
We visited her house, where we had a Christmas party.	私達は彼女の家にいって、そこでクリスマスパーティーをしました。
I had lived in Sendai for ten years before I came to Tokyo.	私は東京に来るまでに１０年間仙台に住んでいました。
Just go about your business and don't keep looking at me.	私の方ばかり見ていないで、自分の仕事に精をだしなさい。
I'm sending you $12 on my order No. 2345 by check.	私どもの注文書２３４５の代金として１２ドルを小切手にてお送りします。
At such times, I think of my family, not my friends.	私がそんなときに思うのは、家族のことであり、友達のことではない。
I searched high and low for my lighter but couldn't find it.	ライターをあちらこちら探したが見つからなかった。
If I had known about the plan, I could have helped him.	もし計画について知っていたら、私は彼の手助けができたのに。
Had you run all the way, you'd have got there in time.	もし君がずっと走っていたら、そこへ間に合って着いただろうに。
I'm thinking about which college might be best for me.	どの大学が私にもっとも適しているかよく考えているところです。
The TV news program help us keep up with the world.	テレビのニュース番組は我々が世界に遅れないでついていく助けになる。
I think most people are better off now than they used to be.	たいていの人は以前よりも暮らし向きがよいと思う。
I think most people are better off now than they used to be.	たいていの人が以前よりも暮らし向きがよいと思う。
This is the very place that I have long wanted to visit.	こここそまさに私が長い間訪れたいと思っていたところです。
It took him a long time to take in what she was saying.	彼女が言っていることを理解するのに彼には随分時間がかかった。
He will have lived here for ten years by the end of next month.	彼は来月の末でここに１０年間住むことになる。
I know that he'll call with another price increase.	彼がさらに値段を上げたいということで連絡してくることはわかっている。
For the time being, I must share this room with my friend.	当分の間、私は友人とこの部屋を共用しなければならない。
It may be said that a man is known by the company he keeps.	人は交わる仲間によって知られるということができよう。
I didn't go out at all because you told me not to.	私はまったく外出しなかった、というのは君がそうしないように言ったから。
You are free to use this car, because I have another one.	私にはもう一台車があるので、君はこの車を自由に使えます。
There is not one of us who does not want to help you.	私たちの中で１人としてあなたを助けたいと思わない者はありません。
How long did it take you to drive from here to Tokyo?	君はここから東京まで車で行くのにどのくらい時間がかかりましたか。
You are the only man in the world that I can call my friend.	君は、私が私の友人と呼べる世界でただ一人の人です。
If I knew her name and address, I could write to her.	もし彼女の住所氏名を知っていれば、私は彼女に手紙が書けるのだが。
The New York Times reviews her gallery all the time.	ニューヨークタイムズは彼女のギャラリーにいつも取材にくるんだから。
You have wanted to go there for a long time, haven't you?	あなたは以前からずっとそこへ行きたがっていましたからね。
I've looked through your report and made some notes on it.	あなたの報告書に目を通し、コメントを書いておきました。
By the age of 25, she had lived in five different countries.	２５歳までに、彼女は五つの異なる国で暮らしてきた。
"Why in the world would you do that?" the other asked.	「またまた、なんでそんなことするの？」もう片方の女性が聞いた。
He said that if he knew her address, he would write to her.	彼は彼女の住所を知っていれば手紙を書くのだがと言った。
He will be back a week from today, that is, on December 10.	彼は今日から１週間後、つまり１２月１０日に帰ってくる。
We were living in Osaka for ten years before we came to Tokyo.	東京に来る前に私たちは大阪に１０年間住んでいた。
I lived three years in Paris during which time I learned French.	三年間パリに住みその間にフランス語を覚えた。
The problem is that our car will not be available on that day.	困ったことに、その日は車の都合がつかないのです。
Now that you have come of age, you should know better.	君はもう成人に達したのだから、もっと分別をもたなければならない。
If John should call me, tell him I'll be back at seven.	もし万一ジョンから電話があったら、７時にもどると伝えて下さい。
If it were not for your help, I could not run this store.	もし君の援助がなかったら、私はこの店を経営できないだろう。
Just tell Mr Tate that Helen Cartwright is here to see him.	テイトさんにヘレンが会いにきているとだけ伝えて下さい。
This is why they can find their way around the world.	そういうわけで彼らは世界中の彼らの道をみつけることができるのです。
How long does it take to go from here to the Hilton Hotel?	ここからヒルトンホテルまでどのくらい時間がかかりますか。
What takes you only three days, takes me as many weeks.	あなたにほんの３日しかかからないことが私には３週間かかります。
She loves him for what he is, not for what he has.	彼女は彼の人柄に惹かれているのであって、彼の財産に惹かれているのではない。
It took him a long time to take in what she was saying.	彼女の言っていることを理解するのに彼にはずいぶん時間がかかった。
It goes without saying that he's the best person for the job.	彼がその仕事に適しているということは言うまでもない。
By next April you will have studied English for ten years.	次の四月までに、あなたは１０年間英語を勉強したことになる。
I, in company with most other people, support that new law.	私は他の多くの人たちといっしょに、新しい法律を支持する。
I visited cities such as New York, Chicago and Boston.	私はニューヨーク、シカゴ、ボストンといったいくつかの都市を訪れた。
The food in my country is not very different from that of Spain.	私の国の食べ物はスペインのとあまり変わらない。
Having visited Rome many times, he knows about it well.	何度もローマを訪れたことがあるので、彼はローマをよく知っている。
With more education, he would have found a better job.	もっと教育を受けていたら、彼はさらによい仕事を見つけていただろう。
I don't like this model but I'll have to make do with it.	この機種は気に入らないが、これで間に合わせなければならない。
Love is like the measles; we all have to go through it.	恋愛は、はしかのようなものだ。みんな一度はかからなければならない。
She can't be over thirty; she must still be in her twenties.	彼女は３０を超えているはずはない。まだ２０代に違いない。
It is better for the health to live in the country than in the city.	都会に住むより田舎に住む方が健康に良い。
I offered him some money, but he would not take it.	私は彼にお金を差し出したが、彼はどうしてもそれを受け取ろうとはしなかった。
I did so, not because I wanted to, but because I had to.	私はしたかったからではなく、しなければならなかったからそうした。
I like her all the better because she has childishness.	私は、彼女には子供っぽさがあるから、かえってそれだけ彼女が好きだ。
We will have lived here for ten years at the end of this month.	今月の末で１０年間ここに住んでいることになります。
The people he is living with in London are coming to see me.	ロンドンで彼が一緒に住んでいる人が近く私に会いに来ます。
In any case, there's no one that can compare with Maradona.	少なくとも、だれもマラドーナと比肩する存在になってはいない。
The new national elder-care insurance system starts next year, right?	来年から日本では介護保険制度が始まるね。
I've got to take my library books back before January 25th.	僕は一月の二十五日までに図書館の本を返却しなければならない。
It has been as many as ten years since I started to live in Tokyo.	東京に住みはじめて１０年も経ってしまっている。
The more people you know, the less time you have to see them.	知人が増えれば増えるほど、それだけ会う時間が少なくなる。
In order to know a man, you have only to travel with him a week.	人の性格を知るには、１週間も一緒に旅行すればいい。
I had lived in Sendai for ten years before I visited Matsushima.	私は仙台に住んで１０年してからやっと松島を訪れた。
We are good friends now, but we didn't like each other at first.	今は良い友達だが、初めはお互いに好きではなかった。
They say this is one of the best books, if not the best.	これは最良の本ではないにしても、そうした本の一冊だということです。
Kathy got a part-time job so that she could study at college.	キャッシーは大学で勉強できるようにアルバイトを見つけた。
England is a country that I've wanted to visit for a long time.	イギリスは、長い間私が訪問したいと思っていた国です。
She came up with a good way of making money by using the Internet.	彼女はインターネットで稼ぐよい方法を思いついた。
By next April will you have studied English for ten years?	次の４月までに、あなたは１０年間英語を勉強したことがありますか。
Nancy was to show up at the place, but she didn't make it.	ナンシーはその場所に来ることになっていましたが、来ませんでした。
What do you think were the year's ten biggest items of news?	ここ一年の１０大ニュースにはどんなものがあったと思いますか。
You have only to ask for it and it will be given to you.	あなたはそれを求めさえすればよい。そうすれば、与えられるのでしょう。
Just go about your business and don't keep looking at me.	あなたの仕事だけに取りかかって、私をじっと見るのをやめてください。
She tries to keep up with what is going on in the world.	彼女は世の中で起こっていることに遅れずについていくように努力している。
It must be three years if a day since she was last in England.	彼女はこの前英国に来てからすくなくとも３年にはなるはずだ。
I didn't want to work with him, but I made the best of it.	私は彼といっしょに仕事をしたくなかったが、なんとか我慢してやった。
I will have been studying English for five years next February.	私は今度の２月で５年間英語を勉強していることになります。
There are 5 computers in the house, but 2 of them aren't any use.	家にはパソコンが５台あるが、内２台は役立っていない。
You don't look very well. You had better not go to work today.	あまり調子がよくなさそうだよ。今日は仕事に行ってはだめだ。
When she was in Los Angeles, she had at least six different jobs.	彼女はロサンゼルスにいる間に少なくとも６回職を変えた。
She can't be over thirty; she must still be in her twenties.	彼女が３０歳以上であるはずがない。まだ２０代であるにちがいない。
I had been studying music in Boston before I returned to Japan.	私は日本に帰ってくるまでボストンで音楽を勉強していました。
I would like you to think about what you would have done in my place.	君が僕の立場だったら、どうしたか考えてほしい。
Some people look down on others because they have less money.	金をそれほど持っていないという理由で他人を軽べつする人もいる。
If he had been there, I could have given him your message.	もし彼がそこにいたら、あなたのメッセージを伝えることができたのにね。
I tried to give her some money, but she wouldn't take any.	彼女にお金をいくらか渡そうとしたが、どうしても受け取ろうとしなかった。
It has been long since they said the time of local government had come.	地方自治体の時代が来たといわれてから久しい。
First off, I'd like you to come with me to a department store sale.	最初にデパートのバーゲンにつきあってほしいんだけど。
There's no room to study here. If only I had a room of my own!	ここには、勉強する空間がない。自分の部屋があるといいのになあ。
He will include a photo taken within six months with the application form.	彼が申請書に６ヶ月以内の写真を添付します
I asked twenty people to my party but not all of them came.	私は２０人の人にパーティーに来てくださいと言ったが、全員は来なかった。
We will have been studying English for five years next February.	私たちは今度の２月で五年間英語を勉強していることになります。
If you visit New York, you've just got to come and see our house.	ニューヨークに来たら、ぜひ私たちの家に遊びに来てください。
This work took me 5 days, but it will take you as many weeks.	この仕事は、私には５日かかったが、あなたなら５週間かかるでしょう。
He takes part in planning many information system development projects.	彼が多数の情報システム開発プロジェクトに参画する
Then, when you're making CG, how should you use light sources?	では、CGを作る場合はどのように光源を使用すればよいのであろうか。
How long will you have been working here by the end of next year?	来年末までで、ここで働き始めてどれくらいの期間になりますか。
In order to know a man, you have only to travel with him for a week.	人を知るには、その人と一週間一緒に旅をするだけでいい。
I will see you on next Tuesday, that is to say, the 10th of September.	この次の火曜日、すなわち９月１０日に君に会いたい。
It doesn't go with the room at all, but I got it for free so it's all good!	全然部屋に似合わないけど、貰ったから良し！
In most of the countries in Europe, cars have to keep to the right.	ヨーロッパの大ていの国では、車は右側通行しなければならない。
But every man had to give five years of service to the government.	しかし人々は政府に対して５年間の兵役を努めなければならなかった。
We will be studying at the University of San Francisco in September.	私たちは９月にはサンフランシスコ大学で学ぶことになるでしょう。
Since he could not work out the problem that way, he tried another way.	彼はその問題をあの方法で解けなかったので別の方法を試みた。
I will have been studying English for six years by the end of next month.	私は来月の末で６年間ずっと英語を学んでいることになる。
If it had not been for your help, I couldn't have completed the work.	もし君の助けがなかったなら、その仕事を完成できなかっただろう。
From time to time, he goes to the library to get new information about books.	ときおり彼は図書館に行き本の新しい情報を得る。
I was going to run over the notes one last time, but there wasn't time.	もう一度メモをざっと読み直そうと思ったが、時間が無かった。
Jim wrote to me last week and said he had come back two months before.	ジムは先週私に手紙をよこして、２ヶ月前に戻っていることを告げた。
At present there are about 31 million Americans over the age of sixty-five.	現在、６５歳を越したアメリカ人はおよそ３１００万人いる。
Don't pussyfoot around the issue; do we have a problem, or don't we?	論点をはぐらかさないでくれよ。問題があるのか、ないのか、はっきりしろよ。
Manjiro played a part in making the two countries friends with each other.	万次郎はこの二国をお互いに親しくするために一役果たしました。
I came down from the back to get a better look at the board.	後ろの席に座っていたんですが、もっと黒板が見やすい席が良かったので前に移動してきました。
From my point of view, Australia is one of the best countries in the world.	私の視点から言えば、オーストラリアは世界で最高の国の１つです。
They asked me what my name was, where I came from, and why I had come.	彼らは私に、名前は何と言うのか、どこの出身か、なぜやって来たのかと尋ねた。
If only she had known I was in Tokyo, she would have come to visit me.	私が東京にいることを彼女が知っていさえいたら、彼女は私を訪問してくれただろ。
Between them, the two largest companies account for a share of more than 50% of the market.	上位２社で市場の５０％を上回るシェアを占めている。
I shopped around for my computer and ended up paying $200 less than David.	コンピューターを物色して歩いたあげく、デイヴィドより２００ドル安い値段で手に入れた。
In the last fifteen or twenty years, there have been great changes in family life in Britain.	この１５年から２０年の間に英国の家族生活には大きな変化があった。
Our Web site, http://www.example.com will tell you all you need to know.	私どものウェブサイトhttp://www.example.comは、あなたに必要な情報を全てお伝えします。
I don't care how much you say you love me. I know your feelings for her haven't changed.	いくら私を愛してるって言っても、彼女のことも好きなことには変わりはないでしょ。
I'd like to set up a sign like, "This Way ->," but what would it be if I made it in English?	「順路→」といったかんじの看板を設置したいと思うんですけど、これを英語で作るとどうなるでしょうか？