We were never to see her again.	私たちは２度と彼女に会えない運命だった。
Both of us want to see the movie.	私たちは２人ともその映画を見たい。
We know the fact that she was born in Canada.	私たちは、彼女がカナダで生まれたという事実を知っている。
We are human.	私たちは、人間です。
We saw the children enter the room.	私たちは、子供たちがその部屋に入るのを見た。
We like children.	私たちは、子供が好きです。
We're not so young that we don't understand what love is.	私たちは、愛がどんなものかわからないほど若くはありません。
We will move into our new house next month if it is completed by then.	私たちは、それまでに完成していれば、来月新しい家に引っ越すつもりだ。
I studied hard to enter the school.	私は、その学校に入学するためによく勉強した。
Any student in our college can use the computer.	私たちの大学のどの生徒もコンピューターを使える。
Let's try to make our world better.	私たちの世界をもっとよいものにするように努めよう。
We have a lot of English books in the library.	私たちの図書館にはたくさんの英語の本がある。
Our business calls for a lot of people.	私たちの仕事は多数の人間を必要としている。
There are about 1000 students at our high school.	私たちの高校には約千人の生徒がいます。
Our plan didn't work in practice.	私たちの計画は実際には旨く行かなかった。
Our school has about one thousand students.	私たちの学校には約１０００人の生徒がいる。
We have a boxing club in our school.	私たちの学校にはボクシング部がある。
Welcome to our home.	私たちの家へようこそ。
There is a garden at the back of our house.	私たちの家の後ろに庭があります。
Could you take our picture?	写真を撮っていただけますか。
We welcome you to our club.	私たちのクラブへのご入会を歓迎します。
Our club has three times as many members as yours.	私たちのクラブにはあなた方のクラブの３倍、部員がいます。
Our class is made up of 30 students.	私たちのクラスは３０人の生徒から成り立っている。
There are forty-seven students in our class.	私たちのクラスには４７人の生徒がいる。
This is all the air that is available to us.	私たちに利用できる空気はこれだけだ。
We have thirteen clubs.	私たちには１３のクラブがある。
Didn't you notice us going out of the room?	私たちが部屋を出て行くのに気がつかなかったのですか。
The sort of information we need is not always available.	私たちが必要とする情報は必ずしも手に入らない。
It is five years since we moved here.	私たちが当地に引っ越してから５年になります。
It's important for us to think about the future of the world.	私たちが世界の未来を考えることは大切だ。
The day will come when space travel becomes possible.	私たちが宇宙旅行を楽しめる日がくるだろう。
To know where we are is important.	私たちがどこにいるのかを知ることが重要である。
It was easy for us to find Jane.	私たちがジェーンを見つけるのは簡単でした。
It is five years since we moved here.	私たちがここに引っ越して来てから５年になる。
It is very important for us to know each other.	私たちがお互いに分かり合うことは大切だ。
I was the shorter of us two.	私たち２人では私のほうが背が低かった。
Do I sound in love?	私が恋をしているように聞こえますか。
There was a large sound when I was reading a book.	私が本を読んでいる時に大きな音がした。
That's not what I heard.	私が聞いたのとは違うな。
If I were in her place, I wouldn't give up yet.	私が彼女の立場なら、まだあきらめにだろう。
It is a fact that I don't know her name.	私が彼女の名前を知らないのは事実だ。
When I called on him, he was talking on the phone.	私が彼をたずねた時、彼は電話ではなしていた。
The money I have given him amounts to $10,000.	私が彼に与えた金合計１万ドルになる。
What have you done with the watch I bought for you?	私が買ってあげた時計をどうしてしまったのか。
It would be best if I met him in person.	私が直接彼に会うのが一番いいだろう。
It is the fact that I want to know.	私が知りたいのは事実だ。
It turned out that I was right.	私が正しかったことがわかった。
You are no more a god than I am.	私が神でないのと同様あなたも神ではない。
It cost me a lot of money to build a new house.	私が新しい家を建てるのにたくさん費用がかかった。
It cost me a lot of money to build a new house.	私が新しい家を建てるのにたくさんのお金がかかった。
It was in Kyoto that I first met her.	私が初めて彼女に会ったのは京都だった。
Please take a look at the picture that I chose.	私が自分で選んだ絵をどうか見て下さい。
I will have been to Paris five times when I go there again.	私が今度パリへ行ったら、５回行ったことになる。
He turned around when I called.	私が呼んだとき彼は振り向いた。
I mean what I say.	私が言っていることは本気なのだ。
Were I you, I would study harder.	私が君だったら、もっと一生懸命勉強するでしょう。
What I like is her way of talking.	私が気に入っているのは、彼女の話し方だ。
When I came home, she was watching TV.	私が帰宅したとき、彼女はテレビを見ていました。
She says something every time I turn around.	私が顔を出すと彼女はいつも文句を言う。
It is her that I want to meet.	私が会いたいのは彼女なんです。
She was watching TV when I came home.	私が家に帰ったとき、彼女はテレビを見ていました。
You know what I mean.	私が何を言いたいかおわかりでしょう。
Let go of me!	私から手を離せ！
It is easy for me to answer the question.	私がその質問に答えるのは簡単です。
It was easy for me to do so.	私がそうすることはやさしさでした。
It's been three years since I moved here.	私がここに引っ越してきて３年になる。
He never hears what I'm trying to say.	私がいたって彼がいうこと聞く訳ないじゃない。
Do as I ask you or I won't answer for the result.	私があなたに頼んだようにしてください。さもないと私はその結果に責任をもちません。
I will see to it that you meet her at the party.	私があなたがパーティーで彼女に会えるように取り計らいます。
You need to open an account at a bank to receive the payment.	支払いを受けるために銀行口座を開く必要がある。
They moved up and down the keys.	指は鍵盤のあちらこちらに動きました。
It is easier than I thought.	思ったよりもやさしい。
You can go however you like.	思い通りに行けるのさ。
Are there any tours of the city?	市内観光ツアーはありますか。
The city supplied food for the children.	市が子供たちに食べ物を供給した。
Do you have a children's department?	子供用品売り場はどこですか。
Children like playing more than studying.	子供達は勉強することよりも遊ぶことの方が好きである。
The little children were too much for her.	子供達は彼女の手に負えなかった。
The children are at play in the garden.	子供達は庭で遊んでいる。
Children should be seen and not heard.	子供達は姿は見られてもおしゃべりを聞かれてはならない。
One of the children is studying, but the others are playing.	子供達の中の１人は勉強していますが他の子供達は全員遊んでいます。
You should give a good example to your children.	子供達に良い手本をしめすべきだ。
I'll go and see what the children are doing.	子供達が何をやっているか見てこよう。
Written for children, this book is easy to read.	子供向けにかかれているので、この本は読みやすい。
I took my child.	子供を連れていった。
It's a book for children.	この本は子供を対象とした本です。
Don't let children have their own way.	子供を好きかってにさせておくな。
Children need loving.	子供は、人に愛されることが必要なのです。
As a child, Bob lived in Boston.	子供のときボブはボストンに住んでいた。
I was always told to study when I was a child.	子供のころしょっちゅう勉強しろと言われた。
Taking the group of children to the library was no problem.	子供のグループを図書館に連れて行くのはどうってことなかったさ。
All families with children get special rates.	子供のいる家族はみな特別料金です。
Children should not have more money than is needed.	子供に必要以上のお金を持たせてはならない。
Children should not be given more money than is needed.	子供には必要以上の金を与えてはならぬ。
A child needs love.	子供には愛情が必要だ。
Even a child can do it.	子供にでもそれはできる。
Even children can understand it.	子供にだってそんな事は分かるよ。
Even a child can understand it.	子供でもそんな事はわかる。
Even a child can do it.	子供でもそれをすることができる。
Even a child can answer it.	子供でもそれぐらい答えられる。
Even a child can understand that.	子供でさえもそれはわかる。
Even a child can answer the question.	子供でさえその質問に答えられる。
Even a child can read this.	子供でさえこれを読むことが出来る。
I took the children to school.	子供たちを学校に連れて行った。
Don't let the children play on this street.	子供たちをこの通りで遊ばせてはいけない。
You must not allow the children to play here.	子供たちをここであそばせてはいけない。
The children were playing about.	子供たちは遊び回っていた。
Children should be seen and not heard.	子供たちは目の届く所にいて何も言わぬがよい。
Children play in this park every day.	子供たちは毎日この公園で遊びます。
She took care of the children.	子供たちは彼女に世話してもらった。
Are the children playing in the park?	子供たちは公園で遊んでいますか。
Children are full of energy.	子供たちは元気いっぱいだ。
The children wanted to go out.	子供たちは外に出たかった。
Children are playing at the back of the house.	子供たちは家の後ろで遊んでいる。
The children were playing at keeping house.	子供たちはままごとをして遊んでいた。
Children don't keep still.	子供たちはじっとはしていられない。
I am thinking about my children.	子供たちの事を考えている。
A group of children were playing in the park.	子供たちの一団が公園で遊んでいた。
Do you have any good books for children to read?	子供たちが読むのによい本はありませんか。
A group of children were playing.	子供たちが集団で遊んでいた。
The children were playing in the park.	子供たちが公園で遊んでいた。
He did not like children.	彼は子供が好きではなかったのです。
We've got six children, you know.	子供が６人いるものですからね。
She took care of the children.	子ども達は彼女に世話をしてもらった。
Children are not allowed in.	子どもは入場お断りです。
Children can't smoke; it's not legal.	子どもは喫煙してはならない。それは法律上許されない。
Children don't keep still.	子どもはじっとしていないものだ。
You should set a good example to your children.	子どもには良い手本を示さなければならない。
I thought it easy at first.	始めはそれを簡単な事だと思いました。
Bring your work to my room.	仕事を私の部屋に持ってきなさい。
Let us start our week.	仕事を始めよう。
He worked all night so that he could get the job done in time.	仕事を間に合わすため彼は徹夜で働いた。
Let's press on with our work.	仕事をどんどん推し進めるようにしましょう。
The work should let up by a week from today.	仕事は来週の今日までに一段落するはずです。
Jobs are hard to come by with so many people out of work.	仕事は非常にたくさんの人が失業しているので得るのに難しい。
My job is easy and I have a lot of free time.	仕事は楽で、暇がたくさんあります。
The job is interesting, and then again, the pay is good.	仕事はおもしろいしその上給料がいいのです。
The job is interesting, but not always easy.	仕事はおもしろい、が必ずしもやさしくはない。
Let's get down to business.	仕事に取りかかろう。
Let's get down to business, shall we?	仕事に取りかかりましょうか。
I'm applying for a job.	仕事に応募する。
You should give a lot of care to your work.	仕事には十分気を配りなさい。
I know how you feel, but it's over.	残念だったね。
We will pay this amount by June 30.	残金は６月３０日までに御支払いします。
Please bring the others.	残りを持って来てください。
There are big faces on it.	山に顔があるよ。
I want to look at the reference books.	参考書をみたいのですが。
Bring me the magazines.	雑誌を持ってきてください。
Shall I bring a magazine?	雑誌を持ってきましょうか。
What is the use of reading magazines?	雑誌なんか読んで何の役に立つというのか。
A young man broke into my house last night.	昨夜若い男が家に押し入った。
I studied last night.	昨夜私は勉強しました。
We watched TV last night.	昨夜私たちはテレビを見た。
Were you out last night?	昨夜君は外出していましたか。
Going home last night, I saw her again.	昨夜帰宅途中に、彼女に再び会った。
My house was broken into last night.	昨夜家に泥棒がはいった。
It was hot last night.	昨夜は暑かった。
I didn't have a good time last night.	昨夜は楽しくありませんでした。
We played cards last night.	昨夜はトランプをして遊んだ。
I did not watch TV but studied English last night.	昨夜はテレビを見ないで英語を勉強した。
Where were you making for last night?	昨夜は、君はどこへ行こうとしたの。
A child was run over here last night.	昨夜ここで子供がひかれた。
Did you watch TV last night?	昨夜あなたはテレビを見ましたか。
Last night he came to the party with Jane.	昨夜、彼はジェーンと一緒にパーティーに来た。
I parted from her last night.	昨晩彼女と別れた。
What did you do last night?	昨晩君は何をしましたか。
Were you at home last night?	昨晩は家にいましたか。
A man called on you last night.	昨晩ある人があなたを訪ねてきました。
Last year, I saw at least fifty films.	昨年私は少なくとも５０本は映画を見た。
The building built last year is very big.	昨年建てられたその建物はとても大きい。
We have not heard from him since last year.	昨年以来からは何の便りもありません。
I met my friend on the street.	昨日通りで友人に会った。
The other day I met an old friend on the street.	昨日私は通りで旧友にあった。
Did you have a good night last night?	昨日はよく眠れましたか？
Where were you last night?	昨日の夜どこにいたの？
Did you hear my show last night?	昨日の晩、私のショーを聞いてくれた？
Every now and then she called home during the party last night.	昨日のパーティーの間、彼女は時折家に電話していた。
Financial support is given to them.	財政的援助が彼らに与えられている。
Let's take it to court.	裁判で決着をつけましょう。
Bring it back when you are through.	済んだら戻してください。
Please answer the phone.	済みません、電話に出て下さい。
Did you mark the papers?	採点しましたか。
Take such steps as you think best.	最善と思われる処置を取りなさい。
At first, I couldn't understand what he said.	最初は私は彼が言っていることを理解できませんでした。
Take the first street to the right.	最初の通りを右に曲がりなさい。
The first step is always the hardest.	最初の一歩が常に最も難しい。
First, put the right hand out.	最初に右手を出しなさい。
Try it again from the first.	最初からもう一度やってごらん。
I feel on top of the world.	最高の気分だ。
Who was the last person to log on to the computer?	最後にコンピューターを使ったのは誰なのだ。
I want to hear all your news.	最近君はどうしているか詳しい便りをください。
Life is getting hard these days.	最近は暮らしにくい。
I'm really not up on recent TV shows.	最近のテレビ番組のことは知らないんだ。
Please note that we have quoted the lowest possible price.	最も低い見積価格をご提示していることをご理解ください。
May there never be another world war!	再び世界大戦が起こりませんように。
She was never to see her home again.	再び故郷に帰れない運命だった。
Let's go back to our places.	座席へ戻ろう。
We have to do without sugar; we're short of it.	砂糖なしでうまくすまさなくてはなりません。きらしているのです。
We are to meet at five this evening.	今夕５時に会う予定です。
Let's make a night of it.	今夜は大いに楽しもうよ。
What's on the air this evening?	今夜はどんな番組がありますか。
They are on the air now.	今放送中です。
I had a great night.	今晩は大変楽しかったです。
What's on the air this evening?	今晩はどんな放送番組があるのですか。
Let's give a party this evening.	今晩パーティーを開きましょう。
What's on the air this evening?	今晩の番組で何かあるかい。
What's on the air this evening?	今晩どんな番組がありますか。
What do you think is the best film that you have seen this year?	今年見た映画で、何が一番良かったと思いますか。
I want to read as many English books as possible this year.	今年はできるだけたくさん英語の本を読みたいと思っている。
This year New Year's Day falls on Sunday.	今年はお正月は日曜日にあたる。
When are you going on holiday this year?	今年はいつ休暇を取りますか。
This year is an important year for me.	今年は、私にとって重要な年だ。
I'm going to Paris this fall.	今年の秋はパリへ行くつもりだ。
St. Valentine's Day falls on Sunday this year.	今年のバレンタインデーは日曜日に当たる。
Christmas falls on Sunday this year.	今年のクリスマスは日曜日にあたる。
Is this today's issue of the Asahi Shimbun?	これは今日発行の朝日新聞ですか。
As of today, we haven't had an answer from him.	今日現在、彼から返事をもらっていない。
How about meeting today?	今日会わない？
It's going to be another hot day.	今日も暑くなりそうだ。
I have the blues today.	今日は憂鬱な気分だ。
I've had a lot of calls today.	今日は電話がたくさんかかってきている。
It is very hot today.	今日は大変暑い。
I feel out of sorts today. That well water is why.	今日は体調が悪い。あの井戸水が原因だ。
Why don't you go home early today?	今日は早退したらどうですか。
I am a little out of sorts today.	今日は少し気分が悪い。
Do you feel any better today?	今日の方が少しは気分がいいですか。
Have you practiced any today?	今日は少しでも練習しましたか。
I think it will be hot today.	今日は暑くなると思う。
It's hot today, isn't it?	今日は暑いですね。
It's hot today.	今日は暑いです。
It's hot today.	今日は暑い。
I feel like going out today.	今日は出かけたい気分だ。
We have a holiday today.	今日は祝日です。
Let's call it a day.	今日は終わりにしましょう。
I was on the go all day today looking for a loan.	今日は借金の工面で東奔西走した。
It is too hot a day for work.	今日は仕事をするのには暑すぎる。
I don't feel like working today.	今日は仕事をしたくない。
Today is the hottest day this year.	今日は今年になって一番暑い。
I feel better today.	今日は気分が良い。
Do you feel any better today?	今日は気分がよくなりましたか。
I feel well today.	今日は気分がよいようです。
How hot it is today!	今日は何て暑いんだ。
I feel like doing something different today.	今日は何か別のことがしたい気がする。
I don't feel like studying English today.	今日は英語を勉強する気がしない。
Let's go Dutch today.	今日は割り勘にしよう。
As it is very hot today, I don't feel like studying.	今日はとても暑いので勉強する気になれない。
I have a lot of work to get through today.	今日はたくさんの仕事を終えなければならない。
It's very hot today, isn't it?	今日はたいへん暑いですね。
I feel much better today.	今日はずっと具合がいい。
I feel much better today.	今日はずっと具合いい。
How do you feel today?	今日はご気分はいかがですか。
Let's call it a day today.	今日は、この辺でやめておきましょう。
Let's call it a day.	今日はここまでにしておこう。
Today's play really moved me.	今日の舞台には、とても感動しました。
Bring me today's paper, please.	今日の新聞を持って来てください。
Bring me today's paper.	今日の新聞を持ってきて欲しい。
Have you read today's paper yet?	今日の新聞はもう読みましたか。
I've not read today's paper yet.	今日の新聞は、まだ読んでいない。
What do you think about young people today?	今日の若い人についてどう思いますか。
I read it in today's edition.	今日の社説でそれを読んだ。
Let's call it a day.	今日の仕事は終わりにしましょう。
I put in a good word for my friend at today's meeting.	今日の会議で、私は友人のために口添えをしてやった。
Who was in charge of today's party?	今日のパーティーは誰が主催なの？
How do you feel today?	今日のご気分は？
I'll apply for the job today.	今日その仕事を申し込もう。
Today, many people receive higher education.	今日、多くの人が高等教育を受けている。
We have a lot of social problems to think about today.	今日、私たちに考えるべき社会問題が数多くある。
I don't know when he'll come again.	今度彼がいつ来るのかわかりません。
Next time I see you, please give me your answer.	今度会うとき返事をください。
I was asked a question in my turn.	今度は私の方が質問された。
I was asked a question in my turn.	今度は私が質問された。
It's my turn to drive next.	今度は私が運転する番よ。
What is the child up to now?	今度はあの子は何をねらっているのか。
It's your turn to drive.	今度はあなたが運転する番だ。
Have you chosen what to do next Sunday yet?	今度の日曜日に何をするかもう決めましたか。
Please come and see me next Sunday by all means.	今度の日曜日にぜひお越しください。
My new job is harder than my old one.	今度の仕事の方が前の仕事より厳しい。
The next holiday falls on a Sunday.	今度の祭日は日曜日と重なります。
You must put up with your new post for the present. I'll find you a better place one of these days.	今度の勤め口でしばらく辛抱しなさい。そのうちもっと良いところを見つけてあげます。
I really must buy that radio next time I am in New York.	今度ニューヨークに行く時は、必ずそのラジオを買わなければならない。
You must let me know when you come here next time.	今度こっちに来るときは絶対知らせてくださいね。
It will be one year before I see you again.	今度あなたに会えるのは１年後になるだろう。
Are there any good films on this week?	今週はよい映画が上映されてますか。
What movies are playing this week?	今週の映画情報を教えてください。
In the future, you have to get here on time.	今後は時間通り来なければなりませんよ。
Study harder from now on.	今後はもっと一生懸命勉強しなさい。
I'll let it go this time.	今回は大目に見よう。
Can you go to the movie now?	今映画に行けますか。
The store is making a mark.	今や有名店ですね。
The war was now over.	今や戦争は終わった。
Up to now they have worked very hard.	今まで彼らは一生懸命働いてきた。
It's really hard to turn your back on your way of life.	今まで慣れ親しんできた生活習慣を捨てると言うのは、本当に大変なことだ。
Up to now, I have never met him.	今まで一度も彼に会ったことはない。
You should study still harder.	今まで以上にいっそう勉強に励みなさい。
We have no information as yet.	今までのところ何の情報もない。
As yet we have not made any plans for the holidays.	今までのところ、私たちは休みの計画は立てていない。
As yet, I have not completed the work.	今までのところ、まだその仕事は出来上がっていない。
It is not too much to say that this is the age of cars.	今は車の時代だと言っても過言ではない。
What's on the air now?	今は何を放送していますか。
I don't feel much like talking right now.	今はあまり話したい気がしない。
The money I have now falls short of what I need.	今の私の所持金では必要額に達しません。
The child of today is the man of the future in the making.	今の子供は、発達中の未来の大人である。
May I watch TV now?	今テレビを見てもいいですか。
If only I knew the answer now!	今その答えを知ってさえいればなあ。
The young man who is talking with John is a student from Canada.	今ジョンと話している若い男の人はカナダからきた学生です。
It's now or never.	今しかない。
May I talk to you now?	今お話ししてもよろしいですか。
I need a little time to talk to you now.	今あなたに話すにはちょっと時間が必要です。
Right now your actions do not match your words.	今、皆さんの行動は言っていることと一致していません。
Shall we watch the movie now?	今、映画を見ようか。
Let it all out.	込み上げる感情をさらけ出せ。
The law of a country must be followed.	国の法律に従わなければならない。
Give the password.	合言葉を言う。
What is the total amount?	合計でいくらですか。
You bought these articles at too high a price.	高い買い物をしたものだ。
What you do is more important than what you say.	行動は言葉より大切です。
Let's try to read between the lines.	行間を読むように心がけてみよう。
It is not always easy to read between the lines.	行間を読むことは必ずしも易しくない。
You aren't to go, Bill.	行ってはだめだぞ、ビル。
You may go with him if you choose.	行きたければ彼といっしょに行ってもいいよ。
It just turned out that I had to do it.	行きがかり上しなけりゃならなかった。
If I send it by air mail, how much will it cost?	航空便にすると値段はいくらかかりますか。
It is a common saying that thought is free.	考えることは自由であるとは、一般に言われていることだ。
The less men think, the more they talk.	考えることの少ない人ほど多くしゃべる。
I'll have to let you know.	考えておきます。
You think too much.	考えすぎだよ。
He is not a good student, to say the least.	控え目に言っても、彼はよい学生ではない。
Don't get taken in by their advertising; I don't see how they can sell something like that for that price.	広告に乗せられては駄目だ。あんなものがそんな値段で売れるわけないだろう。
More students are interested in finance than in industry.	工業よりも金融に関心のある学生のほうが多い。
You may choose what you like.	好きなものを選んでいいよ。
Put it where you like.	好きなとこへ置けよ。
You may talk as much as you like.	好きなだけ話してよろしい。
Look at the large building over there.	向こうの大きなビルをごらんなさい。
Please put in this way.	口添えしてね。
We need less talk and more action.	口先だけでなくもっと実行が必要だ。
"You talk too much," he said.	口数が多いぞと彼は言った。
You talk too much.	口数が多いぞ。
I told you again and again.	口をすっぱくして言ったのに。
I no longer have the energy to talk.	口をきく元気もなくなった。
You're all talk and no action!	口ばっかり！
It is easy to talk.	口で言うのは簡単だ。
Easier said than done.	口で言うのは実行するのよりやさしい。
Easier said than done.	口では大阪の城も建つ。
It is a short drive to the park.	公園までは車ですぐです。
It is not easy to find the way to the park.	公園へ行く道を見つけることはやさしくありません。
I saw something white in the park.	公園に何か白いものが見えた。
There were a lot of people in the park.	公園には大勢の人が出ていた。
There were few people in the park.	公園にはほとんど人がいなかった。
There are lots of animals in the park.	公園にはたくさんの動物がいます。
There were a lot of people in the park.	公園にはたくさんの人がいた。
There are a lot of children in the park.	公園にはたくさんの子供がいます。
Light travels faster than sound.	光は音よりも速く進む。
Light travels much faster than sound.	光は音よりもずっと早く進む。
Light travels much faster than sound.	光は音よりはるかに早く伝わる。
How do you know that light travels faster than sound?	光が音より速いということがどうやって分かるのですか。
Let's take turns at running.	交代に走りましょう。
Let's help each other.	お互いに助け合いましょう。
Tell me something about your family.	御家族のことを教えてください。
Turn back, please.	後ろ向きになってください。
I've never heard such a story all my life.	後にも先にもこんな話を聞いたことがない。
In case you go out before 5, just let me know.	五時前にお出かけのときは、ちょっと知らせてください。
Live and let live.	己も生き他も生かせ。
The good old days have gone, never to return.	古き良き時代は去って、二度ともどってこない。
The good old days are gone never to return.	古き良き時代は過ぎ去って再び戻らない。
The good old days have gone, never to return.	古きよき日々は去って、二度と戻らない。
The good old days have gone, never to return.	古きよき時代は去り、二度と戻らない。
The good old days are gone never to return.	古きよき時代は過ぎ去って二度と戻ってこない。
I was looking at old pictures.	古い写真を見てたんだよ。
You shouldn't ask personal questions.	個人的な質問はしないほうがいいよ。
Might I ask you a personal question?	個人的なことをお聞きしてもよろしいでしょうか。
Each individual is different.	個人はそれぞれ異なっている。
The rights of the individual are the most important rights in a free society.	個人の権利が自由社会でもっとも大切な権利です。
Put in a good word for me.	言葉添えを頼む。
It is said that man is different from other animals in that man uses language.	言葉を使うという点で人間は他の動物と異なるといわれている。
Language keeps in step with the times.	言葉は時代とともに移りゆく。
Words, when well chosen, have such great force in them.	言葉は、適切に選ばれれば、非常に大きな力を持つ。
Please show me the meaning of word.	言葉の意味を教えてください。
Watch your language.	言葉づかいに気を付けなさい。
But for language, there would be no thought.	言葉がなければ、思想はないであろう。
Language keeps in step with the times.	言語は時代に合わせて変化していく。
I like languages.	言語が好きです。
It goes without saying that Rome was not built in a day.	言うまでもないことだがローマは１日にしては成らず。
It's easier said than done.	言うは易く行うは難し。
Easier said than done.	言うのはた易いが、行うのは難しい。
In other words, it takes all sorts of people to make a world.	言い換えると、世の中にはいろいろな人間が必要だということだ。
I know what you mean.	言いたいことは分かるよ。
I understand what you're saying.	言いたいことは分かってるよ。
Let's face the facts!	現実を直視しようじゃないか。
At present, we have 1,600 students at our school.	現在本校には１６００名の生徒がおります。
Are you having your period?	現在生理中ですか。
Some people are never content with what they have.	現在自分の持っているものに絶対満足をしない人もいる。
The present state of the city's finances is not good.	現在のその市の財政は芳しくない。
Harajuku is one of the hottest places in Tokyo.	原宿は東京の中で最も活気のある場所の一つである。
How are you? What sort of day are you having today?	元気かい？今日はどんな一日を送っているのだい？
Put it back where you found it.	元のところへ戻しておきなさい。
Put it back where it was.	元どおりにしまってください。
Would you help me look for my keys?	鍵を捜すのを手伝ってくれませんか。
Turn the key to the right.	鍵を右に回しなさい。
May I have the key?	鍵をいただけますか。
I can't find my key.	鍵が見つからない。
Without the key, she could not have entered the room.	鍵がなかったら、彼女はその部屋に入れなかっただろう。
Do you have something with keys?	鍵がついてるのはありますか。
The more you look, the more you will see, and the more interesting they will become.	見れば見るほど、それだけ多くわかり、また興味も増してくる。
There are many animals to see there.	見なくちゃ行けない動物がたくさんいるよ。
Let's take a look.	見てみましょう。
Oh, let me show you.	見せてあげる。
Kenji is always the first to come to school.	健二はいつも真っ先に学校に来る。
I will go for a medical.	健康診断を受けに行きます。
Health is more important than money.	健康はお金よりも大切だ。
Your health is more important.	健康のほうがもっと大事でしょう。
It goes without saying that health is important.	健康が大切なことは言うまでもない。
It goes without saying that health is most important.	健康が最も大切であることは言うまでもない。
Who runs faster, Ken or Tony?	健君とトニー君とではどちらが早く走りますか。
Ken is the youngest of the four.	ケンは4人のうちで一番年下です。
Ken has never visited Kyoto.	健は一度も京都を訪れたことがない。
I always feel blue on Mondays.	月曜日はいつも憂鬱だ。
We have to turn in our reports on Monday.	月曜日にレポートを提出しなければならない。
I go to the movies three or four times a month.	月に三ないし四回映画を見に行く。
They are as different as day and night.	月とすっぽん。
The wedding will take place on Saturday.	結婚式は土曜日に行われるだろう。
The wedding will take place at the end of October.	結婚式は十月末に行われる。
The wedding was put off.	結婚式は延期された。
Where is the wedding to be?	結婚式はどこであるのですか。
When is the wedding going to take place?	結婚式はいつ行われるのですか。
When did the wedding take place?	結婚式はいつ行われましたか。
Does this mean you're not coming to help?	結局私を助けにやって来ないの？
It all turned out for the best in the end.	結局すべてが旨く行った。
He brought it up first, but he didn't show up. What's going on?	結局、言い出しっぺの人が来てないのだけど、どういうことだ？
The results were as follows: Japan 1st; Spain 2nd; Italy 3rd.	結果は次の通りでした。１位日本、２位スペイン、３位イタリア。
The results were as follows.	結果は次の通りだった。
It will not be long before we know the result.	結果はまもなく分かるだろう。
We'll let you know the result within a week.	結果は１週間以内にお知らせします。
We will report the results when known.	結果が分かったらこちらから報告します。
We will now report on this year's business results.	決算報告を申し上げます。
Never let me go.	決して放さないで。
The hard work has run him down.	激務で彼はすっかり参った。
Art is long, life is short.	芸術は長く、人生は短い。
It is easier to make plans than to put them into practice.	計画を立てることは、それを実行することよりも容易だ。
The plan has worked well as yet.	計画は今までのところ上手く行った。
The plans are still up in the air.	計画はまだ未定である。
There is not one person who is in agreement with the plan.	計画に賛成している人は一人もいない。
You should turn off the mobile phone.	携帯電話の電源を切るべきである。
The notice could not be made out by the students.	掲示文は学生にはわからなかった。
Keiko has a good figure.	恵子はスタイルがいい。
Keiko is at the head of her class.	恵子はクラスで首席だ。
The official in charge let me in.	係官は私を通してくれた。
I'll hear all of you in turn.	君達全部のいう事を順番に聞こう。
You are new students.	君達は新入生です。
I couldn't help but fall in love with you.	君を好きにならずにはいられなかった。
You're taking on the company style.	君も社風に染まっている。
Both you and I are students.	君も私も学生だ。
You, too, should have seen that movie.	君もあの映画を見ればよかったのに。
You are too young to be in love.	君は恋するには若すぎる。
Did you meet her?	君は彼女に会ったのかい。
Are you younger than him?	君は彼より若いのかい。
You work as hard as he did at your age.	君は彼が君の年だったころと同じほどよく働く。
You work as hard as he did at your age.	君は彼が君の歳だったころとほぼ同じほどよく働く。
What subject do you think he is interested in?	君は彼がどの学科に興味を持っていると思いますか。
You should work hard.	君は熱心に勉強すべきだ。
You must study hard.	君は熱心に勉強しなければならない。
Are you a Japanese student?	君は日本人の学生ですか。
Are you a Japanese student?	君は日本の学生ですか。
You work too hard.	君は働きすぎです。
You are working too hard. Take it easy for a while.	君は働きすぎだよ。しばらくのんびりしたら。
You know the answer?	君は答えがわかるって？
You are a good student.	君は善良な学生です。
You will have heard this story before.	君は前にこの話を聞いたことがあるだろう。
Are you for the war or against it?	君は戦争に賛成か反対か。
You ran a red light.	君は赤信号を無視して走りましたね。
You are way off track.	君は常軌を逸しているよ。
What do you want to do in the future?	君は将来何をしたいですか。
You work hard.	君は商売熱心だね。
You must face the facts.	君は事実を直視しなければならない。
You must face the facts.	君は事実を直視しなくてはならない。
You must face the facts.	君は事実を直視しなくてはいけない。
Are you for or against my plan?	君は私の案に賛成ですか反対ですか。
Did you call me up last night?	君は昨夜私に電話をかけましたか。
Did you go out last night?	君は昨晩外出しましたか。
You worked a lot this week.	君は今週は随分働いたね。
You have to turn in the reports on Monday.	君は月曜日に報告書を提出しなければならない。
You can get a loan from a bank.	君は銀行から金が借りられるよ。
You are in need of a holiday.	君は休暇が必要だ。
What are you talking about?	君は何の話をしているのですか。
What did you talk about?	君は何について話しましたか。
What did you come here so early for?	君は何でこんなに早くここへきたの。
Please let me know what you want.	君は何が欲しいのか知らせてください。
You have only to study hard.	君は一生懸命勉強すればいい。
You have only to study hard.	君は一生懸命勉強しさえすればよい。
You only have to try hard.	君は一生懸命に努力しさえすればよい。
If you studied hard, you would get good marks.	君はよく勉強すれば良い点をとれるだろうが。
You're really a hard worker.	君はよくがんばるね。
You should study harder.	君はもっと熱心に勉強すべきです。
You must study much harder.	君はもっと熱心に勉強しなければならない。
All you have to do is to work harder.	君はもっと熱心に勉強しさえすればよい。
You need to study harder.	君はもっと一生懸命勉強をする必要がある。
You should have worked harder.	君はもっと一生懸命勉強すべきだったのに。
You should have come earlier.	君はもっとはやくくるべきだったのに。
You should have worked harder.	君はもっとがんばって働くべきだったのに。
You are now an adult.	君はもう大人だ。
Now you've come of age, you have the right to vote.	君はもう成人したから投票する権利がある。
You should have come a little earlier.	君はもう少し早く来るべきだった。
You must get up a little earlier.	君はもう少し早く起きなければなりません。
You are not a child any more.	君はもう子供ではない。
Have you turned in your report?	君はもうレポートを提出しましたか。
If you read this book again, you will have read it three times.	君はもう１度この本を読んだら３度読んだことになるね。
What did you come here so early for?	君はなんでこんなに早くここに来たの。
What has brought you here?	君はどうしてここに来たのか。
You need not have come here so early.	君はそんなに早くここに来る必要はなかったのに。
You can bank on that.	君はそれを当てにできる。
Are you for or against the bill?	君はその法案に賛成なのか反対なのか。
You should apply for that post.	君はその職に応募すべきだ。
You make too much of the event.	君はその出来事を重視しすぎる。
You need not take account of the fact.	君はその事実を考慮に入れる必要はない。
How do you account for the fact?	君はその事実をどう説明しますか。
You must state the fact as it is.	君はその事実をありのまま述べなければならない。
Did you watch the game?	君はその試合を見ましたか。
You have to account for the result.	君はその結果を説明しなければならない。
Are you for or against the plan?	君はその計画に賛成ですか、それとも反対ですか。
Are you planning to take part in the meeting?	君はその会合に出席するつもりですか。
Are you planning to take part in the meeting?	君はその会合に参加するつもりですか。
All you have to do is to meet her there.	君はそこで彼女に会えさえすればよい。
Have you read this book yet?	君はこの本をもう読みましたか。
You have only to read a few pages of this book.	君はこの本の数ページは読みさえすればよい。
You are asking too much for this car.	君はこの車に高い値段をつけすぎた。
You should not think little of this result.	君はこの結果を軽視すべきじゃない。
You always talk back to me, don't you?	君はいつも言い返す。
You are always watching TV.	君って、いつもテレビを見てるね。
You are watching TV all the time.	君はいつもテレビばかり見ているね。
You always talk back to me, don't you?	君はいつもああ言えばこう言うね。
You can always ask a question in return.	君はいつでもその代わりに質問をすることができる。
You shouldn't talk back like that.	君はあんなふうに口答えすべきではない。
You had better not work too hard.	君はあまり働きすぎないほうがよい。
Are you on the committee?	君はあの委員会のメンバーですか。
You're never going to give in, are you?	君はあくまで意地を張るのだね。
You always talk back to me, don't you?	君はああ言えばこう言うね。
You should by all means read the book.	君は、是非ともその本を読むべきだ。
Didn't you hear your name called?	君の名前が呼ばれるのが聞こえませんでしたか。
Tell me about your program for the future.	君の未来計画について話してください。
It's your move.	君の番だよ。
At your age, I would think so, too.	君の年齢だったら、私もそう考えるだろうね。
Compare your answer with Tom's.	君の答えをトムのと比較しなさい。
Your answer is to the point.	君の答えは適切である。
Your answer is right.	君の答えは合っています。
What's your major field?	君の専攻分野は何ですか。
I can hear you, but I can't see you.	君の声は聞こえるが、姿は見えないよ。
With reference to your request, I will support.	君の申し出に関して、私は君を支持したい。
Please let me drive your new Toyota.	君の新しいトヨタ、僕にも運転させて。
May I take your picture?	君の写真を撮ってもいい？
I would like your picture.	君の写真が欲しいのですが。
Your question does not bear on the subject under discussion.	君の質問は討議中の問題と関係がない。
Your questions were too direct.	君の質問は直接的すぎた。
Your question is hard for me to answer.	君の質問に僕は答えにくい。
What time is it now by your watch?	君の時計では今何時ですか。
What time is it by your watch?	君の時計では何時ですか。
What you have said doesn't apply to you.	君の今言ったことは、君にあてはまらない。
I know what you mean.	君の言わんとすることはわかる。
What you said does not apply to this case.	君の言ったことはこの場合に当てはまらない。
I can't see what you mean.	君の言うことの意味が分からない。
I don't follow.	君の言うことがわからない。
I don't get what you mean.	君の言いたいことが分からない。
You can read any book that interests you.	君の興味をひく本なら何でも読んでいいよ。
You're on the right track.	君のやっていることは間違っていないよ。
Your plan sounds great.	君のプランは素晴らしい。
Choose the one you like.	君の好きなのを選びなさい。
I have something to tell you.	話したい事があるんだ。
You can't have understood what he said.	君に彼の言ったことがわかったはずがない。
I feel for you.	君に同情するよ。
I want you to work harder.	君にもっとしっかり仕事をしてもらいたい。
I want to see you again.	君にまたお会いしたい。
I'd like to talk with you in private.	君にちょっと話がある。
I'll give you this camera.	君にこのカメラをあげよう。
I want to go with you, but I'm broke.	君と一緒に行きたいけれど文無しなんだ。
You and I are good friends, but we have little in common.	君とぼくは仲がよいが、共通するものはほとんどない。
What are you talking about?	君たちは何の話をしているのですか。
What are you talking about?	君たちは何について話しているのですか。
Are you students at this school?	君たちはこの学校の学生ですか。
Only you answered the question.	君だけが質問に答えた。
You are asking too much for this car.	君この車に高い値を付けすぎだよ。
Don't you move from here.	君ここを動くんじゃないぞ。
You or I will be chosen.	君か僕が選ばれることになるでしょう。
I noticed you entering my room.	君が部屋に入ってくるのに気づいた。
I noticed you entering my room.	君が部屋に入って来るのがわかった。
We were just talking about you when you called.	君が電話をくれた時私達はちょうど君の事を話していた。
We were just talking about you when you called.	君が電話をくれたとき丁度君の事を話していた。
Choose the color you like the best.	君が最も好きな色を選びなさい。
The picture you are looking at is a copy of a Picasso.	君が見ている絵はピカソの複製だ。
The money you give them will be put to good use.	君が寄付するお金は立派に使われるだろう。
You shouldn't have paid the bill.	君が勘定を払うべきではなかったんだ。
I'll come again when you are free.	君が暇なときにまた来るよ。
I heard it from you.	君からの便りがあった。
I will see to it that you meet her at the party.	君がパーティーで彼女に会うように取り計らう。
By the time you got there, the sun had set.	君がそこに着くころまでには、日が暮れてしまった。
The time will come when you will understand this.	君がこのことを理解する時がくるだろう。
Where was it that you found this key?	君がこのかぎを見つけたのはどこでしたか。
The watch you gave me doesn't keep time.	君がくれた時計は狂っているよ。
You don't understand.	君、わかってないね。
If it were not for air and water, we could not live.	空気と水がなければ、私たちは生きることはできないだろう。
If it were not for air, we could not live.	空気がなかったら、人間は生きられないだろう。
If it were not for air, we could not live.	空気がなかったら、我々は生きることができないだろう。
I've been to the bank.	銀行へ行ってきたところです。
Can you tell me the way to the bank?	銀行へ行く道を教えて下さい。
The bank keeps money for people.	銀行は人の金を預かる。
The bank isn't open on Sundays.	銀行は日曜にはやってません。
The bank loaned the company $1 million.	銀行は会社に１００万ドル貸し付けた。
The bank came through with the loan we had requested.	銀行は我々が要請したローンを用立ててくれた。
Is the bank open?	銀行は開いていますか。
You'll have to get off at the bank and take the A52.	銀行のところで降りて、Ａ５２に乗り換えないと駄目ですよ。
We must ask the bank for the loan.	銀行に貸付を頼まねばならない。
Please go to the bank.	銀行に行って下さい。
How much money do you have in the bank?	銀行にどれだけお金がありますか。
You'll find the shop between a bank and a school.	銀行と学校の間にその店があります。
He works for a bank.	銀行で働いています。
I have to take some money out of the bank.	銀行から少し金をひきださなければならない。
I need to know your answer by Friday.	金曜日までに回答が必要です。
On Friday night, three men came into Mr White's hotel and asked for rooms.	金曜日の夜、３人の男性がホワイト氏のホテルへやって来て、泊めてほしいと頼んだのです。
We ran short of money.	金不足になった。
Love of money is common to all men.	金銭欲は万人に共通している。
I think the love of money is common to us all.	金銭欲は私達全てに共通のものだと思う。
I'm broke.	金欠なんだ。
There is a lot of money.	金はたくさんある。
I feel the want of money.	金の必要を感じる。
I am short of money.	金に不足している。
Money talks.	金がものを言う。
Little money, few friends.	金がないと友達も少ない。
I will be seeing her again one of these days.	近日中に彼女にまた会うことになっている。
Travelling is easy these days.	近頃は旅行は楽だ。
Few people visit me these days.	近頃は私を訪ねるひともほとんどいない。
As for the students of today, I don't know what they are thinking about.	近頃の学生といえば、何を考えているのか私にはわからない。
Hard work has made Japan what it is today.	勤労によって日本は今日の日本になった。
Working hard made Jack what he is.	勤勉のお陰で今日のジャックがある。
Hard work has brought him where he is.	勤勉さが今の彼をつくりあげた。
Turn on your back.	仰向けになりなさい。
Education means something more than going to school.	教育とはただ学校に行くだけではなくそれ以上のことを意味する。
Move over a little if you please.	恐れ入りますが席をちょっとお詰めください。
We moved to New York last fall.	去年の秋、私たちはニューヨークに引っ越した。
I need medical help.	急患で診ていただきたいのですが。
We've really got to step on it.	急いでいるんですけど。
It will do you good to have a holiday.	休日をとるのが、あなたの身体によいでしょう。
The holidays are costing me a lot.	休暇を過ごすのに私にはたくさんの金がかかります。
It will do you good to have a holiday.	休暇をとることは体に良いでしょう。
We have five days to go before the holidays.	休暇までにあと５日ある。
The holidays came to an end at last.	休暇もとうとう終わった。
I'll be only too pleased to help you.	休暇は全くあっという間に終わってしまった。
Tell me what you did on your holidays.	休暇に何をしたか教えてください。
It will do you good to have a holiday.	休みを取れば、あなたは楽になるだろう。
Kumi did not talk about her club.	久美は彼女のクラブについて話しませんでした。
Please turn over.	逆さまに向きを変えてください。
One question was what I was going to be.	疑問の一つは、私がどんな人になるかでした。
It is too early to get up.	起きるには早過ぎる。
You are human.	貴方達は、人間です。
You are human.	貴方は、人間です。
We are interested in your service.	貴社のサービスに興味があります。
Here is our answer to your fax message dated April 1st.	貴社からの４月１日付のファックスに対しての、私どもの返事は以下の通りです。
Reporter: Can you give me an example?	記者：例を１つあげてくださいますか。
She has a good memory, too.	彼女は記憶力もいい。
Let's take a break for a change.	気分転換に休憩しよう。
How do you feel now?	気分はどうですか。
I understand how you feel.	気持ちを御察しします。
I know how you feel.	気持ちは分かるよ。
I really feel for you.	気持ちはよく分かるよ。
Take it easy!	気軽にいこう。
Take it easy.	気楽にやりなさい。
Let's take it easy.	気楽にしなさい。
It was there, when I noticed it.	気がつくと、そこにありました。
I met him on my way home.	帰宅の途中で彼に会った。
Don't let your feelings show.	喜怒哀楽を見せるな。
I'll be only too pleased to help you.	喜んでお手伝いいたしましょう。
I am only too pleased to come with you.	喜んであなたと参ります。
Turn your face this way.	顔をこちらへ向けなさい。
It's hard to tell Englishmen from Americans just by the way they look.	顔だけでイギリス人とアメリカ人を区別することは難しい。
Your face is red.	顔が赤いよ。
An error was made.	間違いがありました。
It will not be long before we meet again.	間もなく、私たちは再会するだろう。
Is there a tour guide available?	観光ガイドは雇えますか。
Give me a break.	勘弁してくれ。
Please add up the bill.	勘定書を合計して下さい。
Give me the bill, please.	勘定を頼むよ。
The bill must be paid today.	勘定は今日支払わなければならない。
Charge this bill to me.	勘定はつけにして下さい。
The bills are all done by computers.	勘定はすべてコンピューターで行われている。
Air the futon.	蒲団を干して下さい。
Stocks fell hard.	株価が急落した。
How much was the additional charge?	割り増し料金はいくらでしたか。
Easy come, easy go.	楽に得たものは、すぐに失ってしまう。
I don't think any more students want to come.	学生達の中で来たいと思う者はもうこれ以上はいないと思う。
Not all the students were present at the class.	学生達が全員その授業に出席していたわけではない。
All of the students were present.	学生全員が出席した。
I got to know him when I was a student.	学生時代に彼と知り合いました。
Read as many books as you can while you are a student.	学生時代に出来るだけ多くの本を読むようにしなさい。
I studied in England for six months when I was a student.	学生時代、イギリスに半年留学しました。
Every student has access to the library.	学生は誰でも図書館を利用できる。
Students have access to the library.	学生は図書館は利用できる。
Students should make use of the books in the library.	学生は図書館の本を利用すべきだ。
Students should make the most of their free time.	学生は自由な時間を出来るだけ有効に利用すべきだ。
Study the student more.	学生はもっと勉強しなさい。
Every student has free access to the library.	学生はだれでも自由に図書館を利用できる。
All the students come from the US.	学生はすべてアメリカ出身だ。
Students will take one of these English courses.	学生はこれらの英語コースの中から１つを受講する。
Students have access to these computers.	学生はこのコンピューターを利用できる。
Some of the students come to school by car.	学生の中には車で通学する者もいる。
Not all the students are against the plan.	学生の全員が計画に反対しているわけではない。
I was used to studying when I was a student.	学生の時は勉強することになれていた。
Some of the students were from Asia and the others were from Europe.	学生の幾人かはアジア出身で、他はヨーロッパ出身だった。
Two-thirds of the students came to the meeting.	学生の３分の２がその集会に出ました。
I asked the student what image he had of black people.	学生に黒人に対するイメージを聞いた。
Have students read such books as will make them think more.	学生にもっと考えさせるような本を読ませなさい。
Do you take in students?	学生でも下宿させてもらえますか。
A student wants to see you.	学生がお会いしたいと言っています。
Three students. Here's my student ID.	学生３枚ください。これが学生証です。
There is no easy process of learning.	学習にやさしい過程などない。
I met her on my way to school.	学校へ行く途中で彼女にあった。
I met Tom on my way to school.	学校へ行く途中でトムに会った。
School has closed for the Christmas holidays.	学校はクリスマスでやすみになった。
When does your school break up?	学校はいつ休暇になりますか。
When does school break up?	学校はいつ休みになるのですか。
If you are to do well in school, you must study hard.	学校で立派にやっていくつもりなら、頑張って勉強しなくては。
You're never too old to learn.	学ぶのに年を取りすぎているということはない。
One is never too old to learn.	学ぶのに年は関係ない。
No one is too old to learn.	学ぶに遅すぎることなし。
He is, without question, the best man for the job.	確かに彼はその仕事に最適の人物だ。
No one was to be seen in the street.	街路には誰の姿も見られなかった。
I want to see the streets.	街を見に行こう。
I don't feel like going out.	外出をする気がしない。
I feel like going out.	外へ出たい。
Could you let him out?	外に出してやってくれませんか。
Look at the picture.	絵を見なさい。
How many pictures did you buy?	絵を何枚買いましたか。
I will see you, each in your turn.	皆に順番に会いましょう。
I will see you, each in your turn.	皆さんに１人ずつお会いしましょう。
I work for a shipping company.	海運会社に勤めています。
I like to talk about the good old days.	懐かしい昔のことを話すのが好きだ。
The good old days have gone, never to return.	懐かしきよき昔は過ぎ去ってしまい、２度と帰ってこないでしょう。
I order you to turn right.	回れ右を命じる。
About face!	回れ右！
Don't talk around it.	回りくどく言うな。
The talks continued for two days.	会談は２日間続いた。
The community is made up of individuals.	社会は個人から成り立っている。
The company plans to close its U.S. sales unit in New York.	会社はニューヨークにあるアメリカ販売子会社を閉鎖する計画だ。
We are having a meeting.	会合を開いている。
The meeting was last month.	会合は先月あった。
The meeting will take place next Sunday.	会合は次の日曜日に開かれる。
The meeting will take place next Sunday.	会合は次ぎの日曜日に行われる。
The meeting will be put off.	会合は延期になるだろう。
The meeting broke up at eight.	会合は８時に解散した。
Where will we meet?	会合の場所はどこですか。
Twelve are present at the meeting.	会合には１２人が出席している。
I will tell her what to say at the meeting.	会合で何を言ったらよいか彼女に教えてあげよう。
Could you add the cost to my room bill?	会計は部屋代につけてください。
Could you please call him into the meeting?	会議中の彼を呼び出せますか。
The meeting closed at four p.m.	会議は午後四時に終わった。
The conference closed at five.	会議は５時に終わった。
The meeting broke up at four.	会議は４時に散会した。
Did he show up at the meeting?	会議に彼は現れましたか。
Those present at the meeting supported the bill.	会議に出席した人々は、その法案を支持した。
Those present at the meeting supported the bill.	会議に出席した人はその法案を支持した。
Only a few people showed up on time for the meeting.	会議に時間どおりに現れたのは２、３人しかいなかった。
How many people were present at the meeting?	会議には何人出席しましたか。
Were all the members present at the meeting?	会員はみんなその会に出席していましたか。
All the members were present at the meeting.	会員はみんなその会に出席していました。
The meeting will take place next Monday.	会は来週の月曜日に催されます。
The meeting broke up at eight.	会は八時に散会した。
The meeting broke up at eight.	会は八時に解散した。
The meeting was all but over.	会はほとんど終わっていた。
The meeting broke up at five.	会は５時に解散となった。
The meeting started at ten.	会は１０時に始まった。
It was around eight last night when the meeting broke up.	会が散会したのは昨夜８時ごろだった。
To meet is to part.	会うは別れのはじめ。
I can't put up with it.	我慢できない。
We students are now at our best.	我々学生は、今が一番いいときだ。
We are very interested in the history.	我々は歴史にとても興味がある。
We heard it from Mr Such and such.	我々は某氏からそれを聞いたのだ。
We parted, never to see each other again.	我々は別れて二度とお互いに会うことはなかった。
We tried to project our analysis into the future.	我々は分析を将来に当てはめようとした。
We're banking on you to provide all the money we need.	我々は必要な金を全部君が出してくれるものと当て込んでいる。
We hadn't so much as heard of her name.	我々は彼女の名をきいたことさえなかった。
We never work on Sunday.	我々は日曜日には働きません。
Every one of us is more or less interested in art.	我々は誰でも芸術には多かれ少なかれ興味を抱いている。
We are against war.	我々は戦争に反対だ。
We must continue to study as long as we live.	我々は生きている限り学び続けなければならない。
We talked in sign language.	我々は身振り言語で話した。
We must always do our best.	我々は常に最善を尽くさねばならない。
We must provide for the future.	我々は将来に備えねばならない。
We must provide for the future.	我々は将来に備えなければならない。
We've run short of money.	我々は資金不足だ。
We were forced to work hard.	我々は仕方なく働かなければならなかった。
We must not go to war again.	我々は再び戦争をしてはいけない。
We took turns with the driving.	我々は交代で運転した。
We took turns driving the car.	我々は交替で車を運転した。
We are all in agreement.	我々はみな同意している。
We came to an agreement in the end.	我々はついに合意に達した。
We took a turn around the city in our car.	我々はその市内をちょっとドライブした。
We were watching the child at play.	我々はその子供が遊んでいるのを見ていた。
We talked over the plan with him.	我々はその計画について彼と話し合った。
We voted against the bill.	我々はその議案に反対投票をした。
We were talking to each other all the time.	我々はその間ずっとお互いにしゃべっていた。
We talked to each other for a while.	我々はしばらくの間話し合った。
We should face up to this issue.	我々はこの問題に立ち向かうべきだ。
We are in agreement on this subject.	我々はこの問題については一致している。
Our new head office is in Tokyo.	我々の新しい本社は東京にあります。
It's you who has broken our agreement.	我々の協定を破ったのは君のほうだ。
Our holiday plans are still up in the air.	我々の休暇の計画はまだ未定だ。
More than one student studies French in our class.	我々のクラスでフランス語を勉強している学生はひとりではない。
All we need now is action, not discussion.	我々に今必要なのは行動することであって話し合うことではない。
Let us do the work.	我々にその仕事をやらせて下さい。
Our trading companies do business all over the world.	我が国の商社は世界をまたにかけて商売をする。
If only we had a garden!	我が家に庭があればよいのに。
We welcome those who want to join our club.	我がクラブに入会したい人々を歓迎します。
Science has brought about many changes to our lives.	科学は私達の生活に多くの変化をもたらした。
Science has brought about many changes in our lives.	科学は私たちの生活にたくさんの変化を引き起こした。
A family is the smallest unit of society.	家族は社会の最小構成単位である。
The family is the most important unit in society.	家族は社会の最も重要な構成単位である。
May I take a few days off to visit my family?	家族の所へ行きたいものですから、２〜３日休みをとってもいいでしょうか。
I've always wanted to go to Australia with my family.	家族とオーストラリアに行きたいと思っています。
There are a lot of persons who try to buy a house.	家を買おうとする人がたくさんいる。
I'm getting a new house built.	家を新築中です。
It took them two years to build the house.	家を建てるのに彼らは２年かかった。
Let us go home.	家へ帰りましょう。
Let me show you around our house.	家の中をお見せしましょう。
There is a garden at the back of my house.	家の後ろに庭があります。
Please go around to the side of the house.	家の横に回ってください。
On my way home, I met him.	家に帰る途中に、私は彼に会いました。
Let me know when you'll return home.	家に帰る時間を知らせてくれ。
We will purchase a new car next week.	我が家では来週、新車を購入するつもりだ。
Take every possible means.	可能な限りの手段を講じろ。
Mr Kato was too old to work any longer.	加藤さんは年をとりすぎてもう働けなかった。
The prices are subject to change without notice.	価格は予告なしに変更されることがあります。
The prices are subject to change without notice.	価格は予告なしに変わることがあります。
Prices are subject to change without notice.	価格は予告なく変更されることがあります。
Prices range from the low $30 to the high $50.	価格の下は３０ドルから上は５０ドルに及ぶ。
How many nights would you like the room for?	何泊のご予定でしょうか。
For how many nights?	何泊されますか。
Read it again and again.	何度もそれを読み返しなさい。
Thousands of people wanted to know the answer.	何千人もの人がその答えを知りたがりました。
Thousands of people wanted to know the answer.	何千もの人々がその答えを知りたがっています。
How many staff members filed to change departments?	何人社員が転部を申し込んできましたか。
How many people were present at the meeting?	何人の人が会議に出席していましたか。
How many children do you have?	何人の子どもがいますか。
What time and where could we meet?	何時にどこで待ち合わせする？
Where's your head at?	何考えてんだ？
What are you talking about!?	何言ってるんだよ！
What you're talking about is more important than how you say it.	何を話すかは、いかに話すかより重要である。
What's your major?	何を専攻していますか。
What should I bring?	何を持って行けばいいですか。
What to say is more important than how to say it.	何を言うかの方がどういうかより重要だ。
What do you mean?	何を言いたいのですか。
I can't understand what you're trying to get at.	何をおっしゃりたいのか、私にはわかりません。
Above all, you must help each other.	何よりもまず、君たちはお互いに助け合わなければいけない。
Above all, I want to see him again.	何よりも、彼にもう一度会いたい。
Not having heard from him, I wrote to him again.	何も便りがなかったので、私はもう１度彼に手紙を書いた。
What are you talking about?	何の話をしているのですか。
What were we talking about?	何の話をしていたっけ？
What has brought you here?	何の用でここまできたのですか。
What has brought you here?	何の用でここに来たのですか。
Few people are free of care.	何の心配もない人は少ない。
What are you talking about?	何のことを話しているのか。
What are you talking about?	何のことを言っているの？
I don't know how to reply to that question.	何と答えていいかわかりません。
I sort of understand.	何となくはわかりました。
Do something!	何とかしろ！
Can't you do something to help me?	何とかしてよー。
Please do something about it.	何とかしてください。
Come again?	何とおっしゃったのですか。
How fast!	何て速いんだろう。
Come again?	何ですって？もう一度言って下さい。
I didn't hear what you said.	何ていったんですか。
He says "want" when he wants something, and "no" when he does not.	何か欲しいときは、「欲しい」と言い、欲しくないときは「いらない」という。
There should be something for us to talk about.	何か僕らが話し合うべきことがあるはずだ。
I want something to read.	何か読むものが欲しい。
We want something new.	何か新しいものがほしい。
Do you have something to write with?	何か書くものをお持ちですか。
I want something with which to write.	何か書くものが欲しいな。
I need something to write with.	何か書くものが必要だ。
Give me something to write on.	何か書くものを貸してくれ。
I need something to write with.	何か書くためのものが必要だ。
I want something to write on.	何か書きつけるものが欲しい。
Will you give us a statement?	何か述べてくれませんか。
I should have done something.	何か手を打っておくべきだった。
Do you have any questions?	何か質問がありますか。
Give me something to do.	何か仕事を下さい。
May I say something?	何か言ってもいいですか。
What's the cause?	何が原因ですか。
I'd like something light.	何か軽いものがいいですか。
Do you hear any sound?	何か音が聞こえるかね？
Ask me something easier.	何かもっとやさしいことを聞いてくれ。
Something's got to give.	何かで妥協しなくちゃ。
Something must be done!	何かしなければ。
I have to do something.	何かしなければならない。
Let's play something.	何かして遊ぼうよ。
I felt something crawling on my back.	何かが背中をはっているのを感じた。
Something is being looked for.	何かが求められている。
If you find an interesting book, please buy it for me.	何かおもしろい本が見つかったら私に買っておいて下さい。
Did you notice any change?	何か、変化に気づきましたか。
What would you do if war were to break out?	仮に戦争が起こるとしたらどうしますか。
We shipped the following to you last week.	下記は先週出荷しました。
I'd like a quote on the following.	下記に対して価格を提示してください。
See below.	下を見ろ。
Can you see something red down below?	下の方に何か赤いものが見えますか。
Music moves the feelings.	音楽は気持ちを動かします。
I hear music.	音楽が聞こえる。
Don't put me in the same class with them.	俺を奴等と一緒にするな。
I've got something on you.	俺はお前の尻尾をつかんでいる。
Are you talking to me?	俺に話してるのか。
You don't... you don't talk to me like that.	俺に・・・俺にそんな口をきくな。
I feel something.	俺が何かを感じる。
It's you I'll always love.	俺が愛するのは永遠にお前だけ。
Apply within.	応募の方はお入りください。
How do you feel?	塩梅はいかがですか。
Please feel free to ask me questions.	遠慮なく私に質問して下さい。
You can't see too well with these LCD displays.	液晶画面は、見にくいなぁ。
I hear it takes time to make friends with the English people.	英国人と親しくなるには時間がかかるそうだ。
Let's study English.	英語を勉強しましょう。
To study English is important for young people.	英語を学ぶ事は若者にとって重要だ。
To study English is important for today's young people.	英語を学ぶ事は今日の若者にとって大切だ。
What is the easiest way to learn English?	英語を学ぶ最もやさしい方法は何ですか。
Learning English is hard work.	英語を学ぶのは骨が折れる。
English is studied in China, too.	英語は中国でも勉強されています。
You have to study English step by step.	英語は着実に勉強しなければならない。
English is the world's language.	英語は世界の言語である。
English is not easy for us.	英語は私達にはやさしくない。
English is not easy for me.	英語は私にはやさしくない。
English is a very important language in today's world.	英語は今日の世界ではとても重要な言語だ。
English is just one of over 2,700 languages in the world today.	英語は今日、世界にある２７００以上の言語の一つにすぎません。
English has become an international language.	英語は国際語になった。
English is an international language.	英語は国際言語である。
English is not easy, but it is interesting.	英語は簡単ではない、でもそれは面白い。
English is not easy, but it is interesting.	英語は簡単でない、しかし面白い。
English is easy to learn.	英語は学びやすい。
We have English third period.	英語は３時間目だ。
English, as you know, is very much a living language.	英語は、ご存知の通り、今も確実に生きている言語である。
No one can match him in English.	英語で彼にかなう者はいない。
Answer in English.	英語で答えなさい。
Must I answer in English?	英語で答えなければなりませんか。
Written in English, this book is easy for me to read.	英語で書かれているので、この本は私にも読みやすい。
It goes without saying that English is an international language.	英語が世界語であることは言うまでもない。
I will love you always.	永遠にあなたを愛します。
Would you like to go to a movie?	映画見に行かない？
Watching movies is very interesting.	映画を見ることは、とてもおもしろい。
What do you say to going to the movies?	映画を見に行こうではないですか。
How about going to the movies?	映画を見に行くのはどうですか。
I like going to the movies.	映画を見に行くのが好きです。
How about going to the movies?	映画を見に行きませんか。
Don't you feel like going to the movies?	映画を見に行きたくないですか。
I'd like to go to the movies.	映画を見に行きたいな。
Would you like to take in a movie?	映画を見に行かない？
Would you like to take in a movie?	映画を観に行かない？
Was the movie good?	映画は良かったですか。
Do you like movies?	映画は好きですか。
When does the movie start?	映画は何時からですか。
Has the movie started yet?	映画はもう始まりましたか。
I can't see the movie.	映画の画面がよく見えません。
How about going to the movies?	映画に行ってはどうですか。
Why not go to the movies?	映画に行ったらどうですか。
How about going to a movie?	映画に行くのはどうですか。
You're going to a movie?	映画に行くの？
I'm going to go to the movies.	映画に行くつもりです。
How about going to the movies?	映画に行きませんか。
The movie starts.	映画が始まります。
I talked with our sales people.	営業の者と話をしてみました。
Oh, I'm just going to take it easy.	うん、私はただのんびり過ごすつもりよ。
There is no air in space.	宇宙空間には空気がない。
The time has come when we can travel through space.	宇宙を旅行できる日がやって来た。
The building on the right side is a school.	右側にある建物は学校だ。
Turn to the right, and you'll find my office.	右折しなさい、そうすれば私の事務所が見つかります。
Turn to the right.	右を向いてください。
Take the road on the right.	右の道を行って下さい。
Take the right road.	右の道を行け。
If you turn right, you will see a big building.	右に曲がれば大きな建物が見えますよ。
Turn to the right, and you'll find the hotel.	右に曲がりなさい。そうすればそのホテルが見つかりますよ。
Turn to the right.	右に曲がりなさい。
Can you help me when I move?	引っ越すとき手伝ってもらえますか。
Could you help me when I move?	引っ越しのとき手伝っていただけますか。
She didn't like this city when she moved here, but she has gotten used to it now.	引っ越して来た当時、彼女はこの町が気に入らなかったが、今では慣れてしまった。
Let's turn back.	引き返そう。
I'll give you an answer in a day or two.	一両日中にお返事します。
I'll let you know in a day or so.	一両日中にお知らせします。
One is red and the other is white.	一方は赤で、また一方は白である。
You must learn step by step.	一歩一歩学ばなければなりません。
He's my most interesting friend.	一番面白い友達は彼です。
I'll put you up for the night.	一晩泊めてあげよう。
Will you put us up for one night?	一晩私たちを泊めていただけませんか。
The people at large are against war.	一般大衆は戦争に反対している。
The people at large were against the war.	一般の人々はその戦争に反対だった。
People in general are against the new law.	一般に人々は新しい法律に反対である。
New Year's Day is the key to the year.	一年の計は元旦にあり。
Can you pay off your loans in a year?	一年でローンが払いきれるかね。
She hears English all through the day.	彼女は一日中英語を耳にしています。
Any goods can be supplied at a day's notice.	一日前に予告してもらえばどんな品物でも供給できます。
Do you offer any all-day tours?	一日のツアーはありますか。
I'd like to have a good talk with her.	一度彼女とゆっくり話をしてみたいものです。
I think I try to do too much at a time.	一度にたくさんのことをやろうとするのがいけないようです。
Rome was not built in a day.	一朝一夕にはできない。
Let's take a break.	一息いれようよ。
You have only to study hard.	一生懸命勉強すればよい。
It will pay you to study hard.	一生懸命勉強することは君のためになる。
Work hard, or you'll have to take the same course again next year.	一生懸命勉強しなさい。さもないと、来年また同じ授業を取らなくてはならなくなりますよ。
He worked hard.	一生懸命働いた。
I ran as fast as I could.	一生懸命走った。
What are you doing so hard?	一生懸命何をしてるんだい。
I'm trying hard, but can't think of her name.	一生懸命がんばっても彼女の名前が思い出せない。
I think it is my business to study hard.	一生懸命に勉強するのが私の仕事だと思う。
Who can read the future?	一寸先は闇。
Choose the one.	一人を選んでくれ。
A man came up to me and asked for a match.	一人の男がつかつかと近づいてきて、マッチを貸して下さいと言った。
Can I take your picture with us?	一緒に写真に入っていただけますか。
Let me go with you.	一緒に行かせて下さい。
Put it on one bill, please.	一緒に勘定して下さい。
Would you like to go see a movie with me?	一緒に映画を見に行きませんか。
You can read ten books in a week? Don't you mean in a month?	一週間に１０冊も本を読むの？一ヶ月の間違いではないの？
Let me say.	一言言いたい。
Mr Iuchi has no one to fall back on.	井内君にたよる人がいない。
Can I use my medical insurance?	医療保険は使えますか。
I'd like to get medical insurance.	医療保険に入りたいのです。
Do you have medical insurance?	医療保険には入っていますか。
Medical science is always on the march.	医学は常に進歩している。
You know something?	意外な話があるんだ。
The committee are all against it.	委員達は皆それに反対している。
The committee meets today at four.	委員会はきょう４時に開かれる。
The committee is made up of fifteen members.	委員会は１５人のメンバーから成る。
The committee will meet next Friday.	委員会は、次の金曜日に、開催されます。
The members of the committee are all men.	委員会の委員は全員男性だ。
The committee are all present.	委員は全員出席している。
The committee are all for the plan.	委員は全員その計画に賛成である。
I still haven't heard from him.	依然として彼から便りがない。
On your marks, get set, go!	位置について、用意、ドン。
A person named Itoh wants to meet you.	伊藤さんという方がお会いしたいそうです。
Have you met her before?	以前彼女に会ったことがありますか。
Haven't we met before?	以前お会いしませんでしたかしら。
I've always wanted to meet you.	以前からお目にかかりたいと思っていました。
Have we met before?	以前お会いしたことがありますか。
It feels like I've seen her before.	以前、彼女に会ったような気がする。
I'll never do this again.	以後こんなことはいたしません。
I would like to place an order for the following.	以下の通り注文いたします。
The following is what he told me.	以下が彼の話したことです。
We never meet without a parting.	逢うは別れの始め。
It is easy to love, but hard to be loved.	愛することはやさしいが、愛されることは難しい。
We got an early start.	われわれは朝早く出発した。
We had to start for America at short notice.	われわれは即刻アメリカにむかって出発しなければならなかった。
We plan to have a welcoming party for Mr. Clark who came to Japan the other day.	われわれは先日来日したクラーク氏のために歓迎会を開くつもりです。
We are but men, not gods.	われわれは神ではなく人間にすぎない。
We have yet to learn all the facts.	われわれはまだ事実を十分に知らない。
We should read as many books as possible.	われわれはなるべくたくさん本を読むべきである。
Our plan will call for a lot of money.	われわれの計画はたくさんの金を必要とするだろう。
Please take me over to the other side.	わたしを向こう側へわたしてください。
I was a first year student last year.	わたしは去年一年生でした。
I didn't mean to do that.	わたしはそうするつもりは無かった。
I am a student at Oxford University.	わたしはオックスフォード大学の学生です。
I am always helped by you.	わたしはいつでもあなたに助けられている。
I can understand what you are saying.	わたしはあなたの言うことが理解できる。
I saw a movie for the first time in two years.	わたしは２年ぶりに映画を見た。
I met Mary and John when in London.	わたしは、ロンドンにいるときメアリーとジョンにあった。
You are welcome to any book in my library.	わたしの書斎のどの本でも好きにお使いください。
My watch keeps very good time.	わたしの時計は時間が正確である。
I have no time to watch TV.	テレビを見る時間が無いんだよ。
I have a lot of work to do.	わたしにはする仕事がたくさんある。
We have seen three wars.	わたしたちは戦争をさんかい経験した。
We noticed the man enter her room.	わたしたちはその男が彼女の部屋に入るのを見た。
When I came home, he was watching TV.	わたしが家に帰ってきたとき、彼はテレビを見ていました。
When I see this picture, I always think of the old days.	この写真を見るといつも昔のことを思い出すの。
You can use the delivery service for a small additional charge.	わずかな追加料金で配達サービスが利用できます。
Ok, let's give it a try.	わかった、試しにやってみよう。
There are a lot of parks in London.	ロンドンには公園がたくさんある。
How many payments will it take to pay off this loan?	ローンは何回払いですか。
Rome wasn't built in a day.	ローマは一日にしてならず。
Rome was not built in a day.	ローマは一日して成らず。
Rome was not built in a day.	ローマは１日で建設されたものではない。
Rome was not built in a day.	ローマは１日でできたのではなかった。
Rome was not built in a day.	ローマは、一日にして建設されたものではない。
The history of Rome is very interesting.	ローマの歴史はとても面白い。
May I have a road map, please?	ロードマップをください。
How much more does it cost to return the rental car to another location?	レンタカーの乗り捨て料金はいくらだろう？
I had a very hard time writing the paper.	レポートを書くのに四苦八苦した。
When must I turn in the report?	レポートはいつ提出しなければなりませんか。
Ruriko is a high school student.	るり子は高校の学生だ。
Lucy is a student from America.	ルシーはアメリカからきた学生だ。
Lynn runs fast.	リンは走るのが速い。
Linda came into the building.	リンダは建物の中に入って来ました。
Lincoln is one of the greatest figures in American history.	リンカーンはアメリカ史の中の最も偉大な人物のひとりである。
Lincoln is one of the greatest figures in American history.	リンカーンはアメリカで最も偉大な人物の一人だ。
The list is as follows.	リストは次のとおり。
Few students can read Latin.	ラテン語を読める学生はほとんどいない。
Turn off the radio, please.	ラジオを消してください。
Will you please turn down the radio?	ラジオの音を小さくしてくれませんか。
Turn on the radio.	ラジオをつけなさい。
Will it bother you if I turn on the radio?	ラジオをつけてもご迷惑ではないでしょうか。
Turn on the radio.	ラジオをつけてくれ。
Please turn on the radio.	ラジオをつけてください。
I found that I could not study well with the radio on.	ラジオをつけたままでは、良く勉強できないことがわかった。
The radio will not work.	ラジオは壊れている。
Please turn down the radio.	ラジオの音を低くして下さい。
Turn up the radio. I can't hear it.	ラジオの音を大きくしてくれ。聞こえないよ。
Turn the radio up a little.	ラジオの音を少し大きくしてよ。
Turn down the radio.	ラジオの音を小さくしなさい。
Could you turn down the radio?	ラジオの音を小さくしていただけませんか。
Could you turn down the radio?	ラジオの音を下げてくれませんか。
Turn the radio up a little.	ラジオの音をもう少し大きくしてよ。
The radio doesn't work.	ラジオの音がでない。
Turn the radio down.	ラジオのボリュームを下げてください。
There is a short program of local news on the radio.	ラジオでその土地の短いニュース番組がある。
The radio is out of order.	ラジオが故障している。
Please turn off the light.	ライトのスイッチを切ってください。
Since we can't find a better one, let's make the best of what we have.	よりいい物が見つからないので、今ある物で我慢しよう。
All right, I will do it again.	よしもう一度やろう。
Do you travel a lot?	よく旅行をしますか。
I didn't hear you.	よく聞こえませんでした。
I can't hear very well.	よく聞こえないのです。
You should talk. You only got a 65.	よくそんなこといえるね。君だってたったの６５点じゃない。
I've never been to Europe.	ヨーロッパへは一度も行ったことがありません。
There are a lot of different people in Europe.	ヨーロッパにはたくさんのいろいろな民族がいる。
It is important for us to choose good friends.	よい友を選ぶことは大切だ。
Good question!	よい質問だ。
This will be one of the best memories of my life.	よい思い出になりました。
Good students study hard.	よい学生は一生懸命勉強する。
Who runs faster, Yumi or Keiko?	ユミとケイコではどちらが速く走りますか。
We had a very good time last night.	ゆうべはとても楽しかった。
Our car broke down last night.	ゆうべうちの車が故障した。
Mr Young has no less than six cars.	ヤング氏は６台も車を持っている。
There are a lot of ways of doing it.	やり方がいく通りもある。
We worked hard to make ends meet.	やりくりするために一生懸命働いた。
I have a lot of work to do.	やらなくてはいけない仕事がたくさんありますから。
I've told you over and over again not to do that.	やめてと何度も言ったでしょう。
At last, my turn came.	やっと順番がきた。
I found it easy when I gave it a try.	やってみたら簡単でした。
Written in easy English, the book is easy to read.	やさしい英語で書かれているので、その本は読みやすい。
I haven't seen you for a long time, Bill.	やあビル、随分久しぶりだね。
He is no longer a child.	もはや子供ではない。
I have something to ask of you.	ものは相談だけど。
Put it back where you found it.	もとの場所へ戻しておきなさい。
Put it back where you found it.	もとの所へ戻っておきなさい。
Please put it back in its place.	もとの場所に戻して下さい。
Ask me something easier.	もっと易しい事を聞いて下さい。
You are to get up earlier.	もっと早起きしなさい。
We should have set off earlier.	もっと早く出発するべきだった。
Come closer and have a good look at this picture.	もっと近づいて、この絵をよく見なさい。
Just take it easy.	もっと気楽にね。
You should have worked harder.	もっと一生懸命勉強すべきだったのに。
You had better have studied harder.	もっと一生懸命勉強した方がよかったのに。
I should have come earlier.	もっと早く来るべきだった。
I want a lot more.	もっとたくさん欲しい。
If I had more money, I could move to a bigger house.	もっとお金があれば大きな家に移れるのにな。
We would move to a bigger house if we had more money.	もっとお金があれば、もっと大きな家に引っ越すでしょう。
Can you think of something better?	もっといいこと思いつきませんか。
I am against the war, of course.	もちろん、戦争には反対だ。
Come if possible.	もし来られたら来なさい。
If you should need any help, just let me know.	もし万一手伝いが必要なら、ぜひお知らせください。
If she visits France again, she will have been there three times.	もし彼女がもう１度フランスを訪れるなら、彼女はそこに３度行ったことになる。
If you want to go to college, study English harder.	もし大学へ行きたいならば、もっと英語を勉強しなさい。
If it were not for the sun, we could not live.	もし太陽がなければ、われわれは生きられないだろう。
If it were not for the sun, we could not live at all.	もし太陽がなかったら、私たちは全く生きられないだろう。
If it were not for the sun, we could not live.	もし太陽がなかったら、我々は生きられないだろう。
What will become of us if a war breaks out?	もし戦争が起こったら、我々はどうなるでしょう。
But for my family, I would not work so hard.	もし私に家族がいなければ、、こんなに一生懸命に働かないでしょう。
But for my family, I would not have worked so hard.	もし私に家族がいなかったら、あんなに一生懸命働かなかったことでしょう。
It will go hard with him if he is found out.	もし見つかったら彼はひどい目にあうだろう。
If it were not for air and water, we could not live.	もし空気と水がなければ、私たちは生きていけないだろう。
If it is free, please send me a copy.	もしも無料でしたら１部コピーしてください。
Please let us know if we can be of help in other ways.	もしも別の方法でお手伝いできることがありましたら、ご連絡ください。
I will help you if possible.	もしできたら手助けしてあげよう。
If you have any questions, please let me know.	もしご質問があればお知らせください。
Were I you, I would apply for the job.	もしあなたなら、その仕事に申し込むだろう。
What would you do if you were ten years younger?	もし１０歳若ければ、あなたはなにをしますか。
The music of Mozart is always pleasing to me.	モーツァルトの音楽はいつも私にとって、喜びを与えてくれるものだ。
Mozart's life was very short.	モーツアルトの一生は大変短かった。
There's no turning back.	もう戻れない。
Have you read the book yet?	もう本を読みましたか。
Have you called her yet?	もう彼女に電話をしましたか。
Have you called her yet?	もう彼女に電話しましたか。
Did you call him yet?	もう彼に電話しましたか。
Have you met him yet?	もう彼に会いましたか。
I feel my age.	もう年だよ。
You had better not go there again.	もう二度とそこへ行かない方がいい。
Have you worked out the answer yet?	もう答えは出ましたか。
Now that you're a college student, you should study harder.	もう大学生なんだから、君はもっと一生懸命勉強すべきだ。
Now that you are a college student, you should know better.	もう大学生なのだから、もっと分別があってもよかろう。
We think that there should be no more wars.	もう戦争はごめんだ。
Had you come a little earlier, you could have met her.	もう少し早く来ていたら、君は彼女に会えたのに。
May I ask you some more questions?	もう少し質問してもいいですか。
Would you like to turn it down a little?	もう少し音を下げてくれますか。
Turn the radio down a little.	もう少しラジオの音を小さくしてくれません。
You must put some life into your work.	もう少し、仕事に身を入れなくちゃダメだ。
Are you through yet?	もう終わったの？
It's time to work now. Let's get down to business.	もう就業時間です。仕事にとりかかりましょう。
It's time to work now. Let's get down to business.	もう仕事の時間だ、仕事に本気で取り組もう。
It was really good.	もう最高においしかったですよ。
Have you read today's paper yet?	もう今日の新聞を読みましたか。
Have you read today's paper yet?	もう今日の新聞は読んでしまいましたか。
Let's turn and go back now.	もう引き返しましょう。
I'll see him again.	もう一度彼に会うつもりだ。
Please send me another copy.	もう一度送ってくれませんか。
May I put it on again?	もう一度着てみていいですか。
Would that I were young again.	もう一度若くなれたらいいんだが。
I would like to talk with you again.	もう一度君と話がしたい。
Let's try again.	もう一度やってみましょう。
It is no use trying again.	もう一度やってみても無駄だ。
Please do that again.	もう一度やってください。
Could I ask you to do that again?	もう一度やっていただけますか。
We tried it again, but couldn't do it.	もう一度それを遣ってみたかったが出来なかった。
Please show it to me again.	もう一度それを見せてください。
We tried it again, but couldn't do it.	もう一度それをやってみたが、できなかった。
I tried it over again.	もう一度それをやってみた。
Do it again!	もう一度おやり。
I want to see them again.	もう一度あの人たちに会いたいの。
Come again?	もう一回。
That's too much.	もうたくさん、付き合ってられないよ。
Let's not talk about it any more.	もうその話はやめましょう。
We are going to have a baby.	もうすぐ私達に赤ちゃんが生まれる。
We are going to have a baby.	もうすぐ私に赤ちゃんが産まれるんです。
I can't put it off any longer.	もうこれ以上延ばすわけにはいかない。
Please don't let me hear any more of that story.	もうこれ以上その話を聞かせないでください。
Please don't let me hear any more of that story.	もうこれ以上その話を私に聞かせないでください。
Let me go over the accounts again.	もういちど、その計算をやり直させてください。
Have you started reading the book yet?	もうあの本を読み始めましたか。
You have only to read a few more pages.	もう２、３ページ読みさえすればいい。
I will have been to the States three times if I go there again.	もう１度行けば、アメリカに３回いったことになる。
Try again.	もう１度やってみなさい。
We tried it again, but couldn't do it.	もう１度それをやってみたが、できなかった。
Is there any space for one more person?	もう１人分の空きはありますか。
Now it's time to say good night.	もう、おやすみを言う時間だね。
Meg colored the picture.	メグは絵に色を塗った。
Meg talks too much.	メグはおしゃべりだ。
I met Meg, who told me the news.	メグに会ったらそのニュースを教えてくれた。
I couldn't make out what he meant by 'megafeps'.	メガフェプスってなんのことだか私には理解できなかった。
Can you tell me where Main Street is?	メインストリートはどちらでしょうか。
Each child has an individual way of thinking.	めいめいの子供は独自の考え方を持っている。
Mary is going to have a baby next month.	メアリーは来月赤ん坊が生まれる。
Mary understands Chinese.	メアリーは中国語がわかります。
Has Mary started yet?	メアリーはもう出発しましたか。
Mary has not started yet.	メアリーはまだ出発していません。
I met a friend of Mary's.	メアリーの友達にあった。
What was the result of Mary's test?	メアリーのテストの結果はどうでしたか。
That bank over there would do the service.	むこうの銀行ならそのサービスを行っているでしょう。
I can't do the hard day's work I used to.	むかしのような激しい日雇い労働はできやしない。
All are interested in Japan.	みんなが日本に興味をもっている。
We have to call off the meeting.	ミーティングを中止しなければならない。
I'd like to call a meeting.	ミーティングを開きたいのだが。
Mayuko entered the room.	マユコは部屋に入った。
Mayuko could not answer my question.	マユコは私の質問に答えられなかった。
Mayuko came running to meet us.	マユコは私たちをむかえに走ってきた。
Mayuko always wants the best.	マユコはいつも最上のものを欲しがる。
It will not be long before he turns up.	まもなく彼は現われるでしょう。
It wasn't long before he came again.	まもなく彼はまた来た。
It will not be long before the world runs short of food.	まもなく世界は食糧不足になるだろう。
It was not long before we heard the news.	まもなく私たちはその知らせを聞いた。
Madonna is known to every high school student in Japan.	マドンナは日本では高校生みんなにしられている。
Have you got a match?	マッチを持っていますか。
Do you have a match?	マッチありますか。
Please come again.	また来てくださいね。
I don't know yet.	まだ分かりません。
The full story was yet to be told.	まだ全部の話がされたわけではなかった。
The night is still young.	まだ宵の口だ。
I understand it's going to get hot again.	また暑さがぶり返すそうだ。
There is yet time.	まだ時間がある。
There you go again.	また始まった。
It's still too early to get up.	まだ起きるには早すぎる。
Will you let me see you again?	また会ってもらえるかな？
See you again.	また会いましょう。
Are you going to do it over again?	またやり直しですか。
It looks like they are at it again.	またまた彼らはけんかをしているようです。
Let's do it another time.	もう一回それをしましょう。
I've never been to Paris.	まだパリに行ったことがない。
Let's make it some other time.	またの機会にしましょう。
The time is yet to come.	まだその時はきていない。
Do come again.	またぜひおいでください。
See you again.	またお目にかかりましょう。
I've come to talk with you again.	またあなたと話をしにきてしまった。
Again? Not again!	また？もう勘弁してよ。
I'd like you to put me back on the list.	また、リストに名前を戻して欲しいのですが。
First, I should hear both sides.	まず両方の言い分を聞きましょう。
First of all, we have to put your design to the test.	まずぼくたちは君の計画を試してみなければならない。
First, I'll try to understand why he thinks so.	まず、なぜ彼がそのように考えるか理解してみよう。
Masaru wants to join the English Club.	マサルは英語部に入りたがっています。
It's really time something was done.	まさに何かをしなければならないときだ。
Michael had a hard time making ends meet.	マイケルは収支を合わせるのに苦労した。
Mike liked animals very much.	マイクは動物がとても好きだった。
Mike is in the second year of high school and Ann is too.	マイクは高校二年生でアンも同学年だ。
Mike has a few friends in Florida.	マイクにはフロリダに数人の友達がいる。
Did you hear that, Mike?	マイク、今の話聞いたかい。
Let's go!	まあ行ってみよう。
Margaret is called Meg for short.	マーガレットは短くメグと呼ばれている。
Oh no, really?	まあ、本当？
I sort of like him.	まあ、嫌いでもありません。
Only a few people understood me.	ほんの少しの人しかわたしを理解してくれなかった。
He is but a child.	ほんの子供に過ぎない。
Only a few members turned up at the meeting.	ほんの２、３人しか会議に姿を見せなかった。
He really turns me off.	ほんと彼にはうんざりだわ！
It's really coming down out there!	ほんとに降ってきた！
Really? What's your special today?	ほんと。今日のお勧めは？
Mr White is in charge of our class.	ホワイト先生が我々の組を受け持っています。
Talking of Mr White, where is he living now?	ホワイトさんと言えば、彼は今どこに住んでいますか。
See, you shouldn't work so hard.	ほらね、そんなにはたらき過ぎないほうがいいよ。
She likes animals, you know?	ほら、彼女動物が好きでしょ？
Look! She looks easy.	ほら！あの娘はいけそうだ。
Bob can drive a car, too.	ボブも車を運転できます。
Bob has too many books to read.	ボブは読みきれないほどたくさんの本を持っている。
Bob saw him again.	ボブは再び彼にあった。
Bob was born in the same year as you.	ボブは君と同じ年に生まれた。
Bob can answer all the questions.	ボブはこの問題すべてに答えられる。
I hear that Bob and Lucy have broken up.	ボブとルーシーは交際をやめたということだ。
Few people know each other well.	ほとんどの人々がお互いをよく知らない。
Few people know that Mr. Itsumi is from Kansai.	ほとんどの人は逸見氏が関西出身だとは知らない。
Few people know about the plan.	ほとんどの人はその計画について知らない。
I can't feel at home in a hotel.	ホテルではくつろげない。
What track for Boston?	ボストン行きは何番ホームですか。
I have no time to put my books in order before I go.	ぼくは出かける前に自分の本を整理する時間がない。
I will never go out of my way.	ぼくは自分のやり方はけっして変えません。
I am no younger than you are.	ぼくは君と同じく若くない。
I met Roy, who asked me to give you this one.	ぼくはロイに会ったら、これをきみに渡すように頼まれた。
I will try it again.	ぼくはそれをもう一度やってみよう。
I will not let the story go out.	ぼくはその話は人にもらさない。
I will put this business through in a week.	ぼくはこの仕事を１週間以内にかたづけたい。
How about going to see a movie with me?	ぼくと映画に行きませんか。
What I mean is this.	ぼくが言わんとするのはこのことだ。
I had to work hard to keep up with the other students.	ほかの学生に遅れないように一生懸命勉強しなければならなかった。
Paul made a lot of money last year.	ポールは昨年たくさんのお金をもうけた。
Paul studies very hard these days.	ポールは最近大変一生懸命勉強します。
We couldn't figure out what Paul wanted to do.	ポールが何をやりたかったのか理解できなかった。
Henry will come of age this March.	ヘンリーは今年の３月に成人する。
Ben is not as young as he looks.	ベンは見かけほど若くない。
Helen did me a good turn.	ヘレンは私に親切にしてくれた。
Helen is always at the top of her class.	ヘレンはいつもクラスでは首席だ。
What is the common language in Peru?	ペルーの共通語は何ですか。
Betty drives fast.	ベティは車を運転するとスピードを出す。
Betty never said a word.	ベティは一言も言わなかった。
Welcome to Best Products.	ベストプロダクツへようこそ。
Please turn over the page.	ページをめくりなさい。
Please turn the page.	ページをめくって下さい。
Look at the picture at the top of the page.	ページの上部の写真を見てごらんなさい。
The status of the project is as follows.	プロジェクトの経過は下記の通りです。
Have you heard from Freddie?	フレディーから連絡がありましたか。
Fred and George took turns with the driving.	フレッドとジョージは、交代で運転した。
I don't want to feel blue.	ブルーな気分になりたくない。
You look very good in blue.	ブルーがよく似合いますね。
Such languages as French, Italian and Spanish come from Latin.	フランス語やイタリア語やスペイン語のような言葉はラテン語からできています。
Written in French, this book is not easy to read.	フランス語で書かれてあるので、この本は読むのがたいへんだ。
France was at war with Russia.	フランスはロシアと戦争をしていた。
Please put me through to Mr Black.	ブラックさんに電話をつないで下さい。
Brian looks blue.	ブライアンは憂鬱そうに見える。
Mr Ford owns this land.	フォード氏がこの土地を所有している。
My film has run out.	フィルムがなくなった。
Bill will return next week.	ビルは来週帰って来ます。
Bill was in Japan.	ビルは日本にいました。
Bill has a part-time job so that he can buy a car.	ビルは車を買うためにアルバイトをしている。
Bill is two years older than I.	ビルは私よりも２歳年上である。
Bill is my best friend.	ビルは私の一番の親友です。
Bill brought me the book.	ビルは私にその本を持ってきてくれた。
Bill can run faster than Bob.	ビルはボブより速く走れます。
Bill came all the way from Florida.	ビルはフロリダからはるばるやってきました。
How fast Bill runs!	ビルはなんて速く走るのでしょう。
Bill didn't turn up at the party.	ビルはそのパーティーへ姿を現さなかった。
Bill has stock in that company.	ビルはあの会社の株を持っている。
Let's call Bill up.	ビルに電話をかけてみよう。
I haven't seen Bill for a long time.	ビルには長い間あっていない。
Bill has many friends.	ビルには多くの友達がいる。
Bill was singled out for a special award.	ビルが特別賞に選ばれた。
Bill called me last night.	ビルがゆうべ私に電話してきた。
John might know something about Mr Black.	ひょっとするとジョンはブラックさんについて何か知っているかもしれない。
She might know the answer.	ひょっとして彼女は答えを知っているのかもしれない。
Do you mean you met her!?	ひょっとして彼女と会ったの？
She might know the answer.	ひょっとして彼女は答えを知っているかもしれない。
Cover your head when you are in the sun.	ひなたにいる時は何かかぶっていなさいよ。
Hitler led Germany into war.	ヒトラーはドイツを戦争に引き入れた。
I had a hard time.	ひどい目に遭ったよ。
You'll have a hard time.	ひどい目にあいますよ。
I watched a movie on video.	ビデオで映画を見ました。
It's brand new.	ピカピカの新製品です。
Peter looks very young.	ピーターはとても若く見える。
Paris fell in 1940.	パリは１９４０年に陥落した。
Let's go early, shall we?	はやく出かけましょう。
I will have read Hamlet three times if I read it again.	ハムレットをもう１回読めば、私は３回読んだことになります。
I broke the personal computer.	パソコンを故障させてしまった。
At first, I couldn't figure out what he was saying.	はじめ彼が何を言っているのかわからなかった。
How do you do, Mrs. Allen? I'm pleased to meet you.	はじめまして、アレンさんお目にかかれてうれしいです。
Here are your keys.	はい、あなたの鍵です。
Can I have a single to Birmingham?	バーミンガムまでの片道切符をください。
Party games bring a party to life.	パーティー用のゲームはパーティーに活気を与える。
The party was put off for a week.	パーティーは一週間延期された。
The date of the party is still up in the air.	パーティーの日取りはまだはっきり決まっていない。
I'll see to it that you meet her at the party.	パーティーで彼女に会えるように取り計らおう。
Did you meet many interesting people at the party?	パーティーではたくさんおもしろい人に会いましたか。
Could you tell me how to get to Park Street?	パーク通りにどうやって行くのか教えていただけますか。
Take it easy.	のんびり行こう。
Could you let me see your notes?	ノートを見せてくれないか。
I feel it now.	ねぇもう感じちゃったよ。
Come on, Bill.	ねえ、ビル。
You will have heard the news, I think?	ニュースをお聞きになったでしょう。
"How can a man be born when he is old?" Nicodemus asked.	ニコデモは言った。「人は老年になっていて、どのようにして生れる事が出来るのですか」
No sound was to be heard.	なんの物音も聞こえなかった。
What a hot day it is!	なんて暑い日なんだろう。
How hot it is!	なんて暑いんだろう。
What a big talk.	なんたる大ボラふきだ。
What do you want to talk to me about?	なんだい、話したいことって。
Nancy studied hard.	ナンシーは熱心に勉強した。
Above all, you must work now.	なによりもまず、今君は働かなければならない。
I'm still single.	なにしろ、独り者で。
Why did she come home early?	なぜ彼女は早く帰ってきたのですか。
What turned her against you?	なぜ彼女はあなたに反抗したのですか。
I understand now why he didn't go to a university.	なぜ彼が大学に行かなかったのか今わかった。
Why did you come early?	なぜ早く来たの。
Why was I turned down for the job?	なぜ就職を断られたのか。
Why am I working hard?	なぜ私は一生懸命働いているのですか。
Why didn't you show up at the party last night?	なぜ昨晩パーティーに来なかったのですか。
Why are you short with me?	なぜ君は僕に冷たいんだい？
Why didn't you show up at the party last night?	なぜ君は昨晩そのパーティーにこなかったのか。
What put it in your head to come here now?	なぜ君は今ここへ来る気になったのですか。
Why didn't you let me know you were in New York?	なぜ君はニューヨークにいることを知らせてくれた。
What has brought you here?	なぜ君はここに来たのか。
Why did you put off the printing of my book?	なぜ貴方は私の本の印刷をのばしたのですか。
Because I am a student of old language.	なぜなら私は古い言語を学んでいる学生だから。
Why didn't you look at the picture?	なぜその絵を見なかったのですか。
Why do I feel this way?	なぜこんな気分になるのだろう。
What has brought you here so early?	なぜこんなに早く来たの？
Why is this book loved by young people?	なぜこの本が若い人々に愛されているのですか。
Why did you choose such a subject?	なぜこのような科目を選んだの？
Why do you study so hard?	なぜあなたはそんなに一生懸命勉強するのですか。
Why did you get up so early?	なぜあなたは、こんなに早く起きたのですか。
That sounds really interesting.	なかなかおもしろそうです。
However you do it, the result will be the same.	どんな方法でやっても、結果は同じだろう。
The longest night will have an end.	どんな長い夜にも終わりがあるものだ。
Any student can answer that question.	どんな生徒でもその質問に答えられる。
What sort of information do you get on the Internet?	どんな種類の情報をインターネットで得られるんですか。
Please feel free to ask me any question.	どんな質問でも私に気軽に尋ねてください。
Feel free to ask any questions.	どんな質問でも遠慮なくしなさい。
Any child can do that.	どんな子供でもそれをすることができます。
Any child knows it.	どんな子供でもそれは知っている。
Any child could do that.	どんな子供でもそれはできよう。
Any child can answer that.	どんな子供だってそのくらい答えられる。
What sort of work do you do?	どんな仕事をしていますか。
Any magazine will do.	どんな雑誌でも結構です。
You're never too old to learn.	どんなに年を取っても学問ができないことはない。
However fast you run, you won't be in time.	どんなに速く走っても間に合わないだろう。
However small it may be, I want a house of my own.	どんなに小さくてもよいから、自分の家がほしい。
However hard I try, I can't do it any better than she can.	どんなに一生懸命やっても、私はそれを彼女よりうまくできない。
Come what may, I will not break my word.	どんなことがあろうと約束は破らない。
Tell me which one to choose.	どれを選べばいいか教えてください。
The answers are all right.	どれもみな正しい。
Choose any one book you like.	どれでも好きな本を１冊選びなさい。
You may take any picture you like.	どれでも好きな絵をとってよろしい。
Any amount of information will do.	どれだけの情報でもうれしい。
Any amount of money will be welcome.	どれだけのお金でもありがたい。
Above all, children need love.	とりわけ子供たちは愛情を必要とする。
I love this book above all.	とりわけこの本が好きです。
Let's do this first of all.	とりあえずこれをやってしまおう。
Let's play cards.	トランプをしましょう。
At all events we have done our best.	ともかく我々はベストを尽くしたのだ。
Tom kept talking all night.	トムは夜通ししゃべりつづけた。
Tom can run fast.	トムは速く走れる。
Tom is a student.	トムは生徒です。
He gave Tom an important position.	トムは重要な地位を与えられました。
Tom bought a brand-new car.	トムは車をピカピカの新車で買った。
Tom is going to do something about it.	トムは事態をなんとかしようとします。
Tom helped me to move.	トムは私の引っ越しを手伝ってくれた。
Tom lives in the room above us.	トムは私たちの上の部屋に住んでいます。
Tom has lived in New York since he was a child.	トムは子供の頃からニューヨークに住んでいる。
Tom isn't watching TV now.	トムは今テレビを見ていません。
Tom is a high school student.	トムは高校生です。
Tom changed color.	トムは顔色を変えた。
Tom helped me to move.	トムは引っ越しを手伝ってくれた。
Tom is thinking about applying for a better-paying job.	トムはもっと給料のいい仕事に応募することを考慮中である。
Tom doesn't run as fast as Bill.	トムはビルほど速く走らない。
How fast Tom works!	トムはなんて仕事が早いのでしょう。
Tom runs very fast.	トムはとても速く走ります。
Where was Tom born?	トムはどこで生まれましたか。
Tom applied for the job.	トムはその仕事に応募した。
Tom saw something red there.	トムはそこで何か赤いものを見ました。
Tom is going to apply for a job with a computer company.	トムはコンピューター会社の職に応募するつもりです。
Tom has always done well in every job he has had.	トムはこれまで手をつけた仕事はことごとく成功した。
Tom is always playing video games.	トムはいつもテレビゲームばかりしている。
Tom is a good sort.	トムはいい人だ。
Tom is going to apply for a job with a computer company.	トムは、コンピューター会社に職を求めるつもりだ。
Tom and Nancy broke up last month.	トムとナンシーは先月別れた。
It's not just Tom that has to study. I have to study, too.	トムだけではなく私も勉強しなければならない。
I'm going to talk to Tom when he returns home.	トムが帰宅したら、話してみましょうか。
Tommy couldn't answer the last question.	トミーは最後の問題に答えられなかった。
Tommy, can you hear me?	トミー、聞こえるかい？
All the stories are interesting.	どの話も面白い。
Any child can do that.	どの子供でもそんなことはできる。
Every house had a garden.	どの家にも庭がありました。
How did you figure out this problem?	どのようにしてこの問題を解きましたか。
What has brought you here?	どのようなご用件でいらっしゃいましたか。
In any case, you have to study hard.	とにかくあなたは一生懸命勉強しなければならない。
In any event, I will do my best.	とにかく最善を尽くします。
Tony can run fast.	トニー君は速く走ることが出来る。
Has Tony been watching TV?	トニー君はテレビをずっと見ていますか。
Tony can run fastest in our class.	トニー君が私たちのクラスの中で一番早く走ることが出来ます。
Tony broke it.	トニー君がそれを壊しました。
It's too hot for us to work.	とても暑くて働けない。
I feel like a brand new person.	とても気分がリフレッシュされる。
I was moved.	とても感動したわ。
I'm very short of money.	とてもお金に困っているんだ。
It's very hot, isn't it?	とても暑いですね。
Where are you headed for?	どちらへお出かけですか。
By the way, I have something to tell you.	ところで、ちょっと君に話がある。
By the way, have you heard from her since then?	ところで、その後彼女から便りがありましたか。
Where are you headed for?	どこに行くところですか。
Where should we meet?	どこで待ち合わせしようか。
Where should we meet?	どこで待ち合わせしましょうか。
Where did you have your picture taken?	どこで写真を撮ってもらいましたか。
Where do you think I met her?	どこで私が彼女に会ったと思いますか。
Where shall we meet?	どこで会いましょうか。
Where did you find the key?	どこでその鍵を見つけたのですか。
Where is it possible for you to see me?	どこでお会いしていただけますか。
Where? I'd like to take one, too.	どこで？わたしもそのコースを取りたいわ。
I think I've met you before.	どこかでお会いしたことがあると思います。
Let me hear from you now and again, will you?	ときどき手紙を下さい。
How shall I put it?	どう表現すればいいでしょうか。
You're welcome.	どう致しまして。
How can you break the news to her?	どうやって彼女に打ち明けろというんだい。
How can we put it into practice?	どうやって実行にうつそう。
How do you figure out this problem?	どうやってこの問題を解くのですか。
I can't figure out what he means.	どうも彼の考えがよくわからない。
Please give us some examples.	どうぞ例をあげてください。
Please give me your answer by return.	どうぞ折り返しあなたのご返事をください。
Please bring your plan up at the meeting.	どうぞ君の案を会議に持ち出してください。
Please feel free to call me up.	どうぞ遠慮なく電話をください。
Please feel free to ask questions.	どうぞ遠慮なく質問してください。
Please come and see me again.	どうぞまた御出でください。
By all means.	どうぞどうぞ。
Please turn it on.	どうぞそれをつけてください。
Please put me through to Mr Smith.	どうぞスミスさんにつないでください。
Please put this into English.	どうぞこれを英語に直してください。
Will you step this way, please?	どうぞ、こちらの方へおこしください。
I can't figure out why she didn't come.	どうして彼女がこなかったのかわからない。
Why are you so hard on him?	どうして彼にそんなにつらくあたるのですか。
Why have you bought the same camera as I have?	どうして私のと同じカメラを買ったのですか。
What makes you think that I'm against that?	どうして私が反対だと思うのですか。
How come you didn't call me last night?	どうして昨夜、私に電話しなかったのですか。
What made you come here so early?	どうして君はこんなに早くここへ来たのですか。
Clara asked me why I worked so hard.	どうしてそんなに熱心に働くの、とクララは私に言った。
How did you come to hear of it?	どうしてそれを耳にするようになったのか。
Why didn't you read the magazine?	どうしてあなたは雑誌を読まなくなったのですか。
Why is it so hot?	どうして、こんなに暑いのですか。
Turn on the light, please.	どうか明かりをつけて下さい。
Please let me make it up to you.	どうか埋め合わせをさせてください。
Let me know the way.	どうか道を教えておくれ。
Turn off the light, please.	どうか電灯を消して下さい。
Please let me in.	どうか中に入れて下さい。
Please let me take your picture.	どうか写真を撮らせてください。
Please step back.	どうか下がってください。
Please don't have any hard feelings.	どうか悪く思わないでください。
Would you please turn down the TV?	どうかテレビの音を小さくしてくれませんか。
Would you please have a look at this document?	どうかこの書類に目を通してくださいませんか。
Please let me take your picture.	どうかあなたの写真を撮らせてください。
However we go, we must get there by seven.	どういっても七時までにいかないと。
What do you mean?	どういう意味ですか？
German is not an easy language.	ドイツ語はやさしい言語ではありません。
I don't understand German at all.	ドイツ語がさっぱり分からない。
Some TV programs are interesting, and others are not.	テレビ番組の中にはおもしろいのもあれば、そうでないのもある。
Can I turn off the TV?	テレビ消してもいい？
Please turn on the TV.	テレビを付けて下さい。
May I turn on the TV?	テレビを付けてもいいですか。
Please turn off the TV.	テレビを消しなさい。
Turn off the TV.	テレビを消して。
Let's not watch TV.	テレビを見るのやめましょう。
Mary likes watching TV.	メアリーはテレビを見るのが好きだ。
Don't watch TV.	テレビを見てはいけません。
I'm just watching TV.	テレビを見ている所だ。
Will you turn on the TV?	テレビをつけてくれる？
Let's watch TV.	テレビみようよ。
TV is not watched here.	テレビはここでは見られていない。
Turn up the TV.	テレビの音大きくして。
Turn down the TV.	テレビの音小さくして。
Would you please turn down the TV a little?	テレビの音を少し下げてくれませんか。
Please turn on the TV.	テレビのスイッチを入れて下さい。
I watched an old movie on TV.	テレビで古い映画を見た。
What about watching the night game on TV?	テレビでナイターを見るのはどうですか。
Can I turn on the TV?	テレビつけてもいい？
The TV won't turn on.	テレビが付きません。
My TV has broken down.	テレビが故障した。
TV has taken the place of radio.	テレビがラジオに取って代わった。
The TV was turned on.	テレビがつけられた。
But he likes the long school holidays.	でも彼は長い学校の休みが好きなんだよ。
But I can't understand them very well.	でも私はあまりよくそれらを理解できない。
Debbie! Can you hear me?	デビー！私の声が聞こえるかい？
Shall we start the meeting now?	では会議を始めましょうか。
Let's see if I've got that right.	では、確認させていただきます。
Well, let me tell you.	では、ここでご説明しましょう。
I couldn't answer any questions on the test.	テストで一問も答えられなかった。
We heard about your company from Mr Morris of Digital Com Company.	デジタルコム社のモリス氏より貴社について伺いました。
Six-thirty, it's possible.	できれば、６時半でお願いします。
I'll help you if possible.	できるならお手伝いします。
I'd like to see you if possible.	できるなら、あなたにお目にかかりたい。
Run as fast as you can.	できるだけ速く走りなさい。
You should start as early as possible.	できるだけ早く出発したほうがよい。
Get up as early as you can.	できるだけ早く起きなさいよ。
You are to start as early as possible.	できるだけ早くに出発すべきだ。
Study as hard as you can.	できるだけ一生懸命に勉強しなさい。
Work as hard as you can.	できるだけ一生懸命、働きなさい。
Read as many books as possible.	できるだけたくさんの本を読みなさい。
I'll try as hard as I can.	できるだけ頑張ってやってみます。
Please don't take it out, if possible?	できることなら抜歯しないでください？
Come on Tuesday, if possible.	できたら火曜日に来なさい。
Put the tables end to end.	テーブルを縦一列に並べなさい。
Put the tables end to end.	テーブルを一列に並べなさい。
There is a radio on the table.	テーブルの上にラジオがあります。
Who is the man at the other side of the table?	テーブルの向かいにいる人は誰ですか。
She put the magazine on the table.	テーブルにその雑誌を置いた。
Dave never returned to school again.	デイブは二度と学校に戻らなかった。
Bring me the Kleenex.	ティッシュを持ってきて。
Disneyland was very interesting. You should've come with us.	ディズニーランドはとても面白かったよ。君も来ればよかったのに。
Disneyland was built in 1955.	ディズニーランドは１９５５年に建設されました。
I had a hard time of it.	つらい目にあった。
It shows that English is no longer the language only of the people of England.	つまり、英語はもはや、イギリスの人々だけの言語ではないということです。
I want to put this on house charge.	つけでお願いします。
At last, they met face to face.	ついに彼らは面と向かい合った。
At last, we got through with the hard work.	ついに我々はその困難な仕事を仕上げた。
Where can I get some information on tours?	ツアーについては、どこで聞けばいいのですか。
I have something to tell you.	ちょっと話があります。
May I ask you something?	ちょっと聞いてもいい？
A little language goes a long way.	ちょっと言葉を知っていればずいぶん役にたつよ。
This is hard for me to say.	ちょっと言いにくい話なんだけど。
Let me see it.	ちょっと見せて下さい。
I'm just going to run down to the bank.	ちょっと銀行によってくる。
Let's take a short break.	ちょっと休憩しよう。
Give me a break, will you?	ちょっと勘弁して下さい。
Could you move over a little?	ちょっとつめてもらえませんか。
Let me have a look at the picture.	ちょっとその絵を見せて下さい。
I'll make a little money, and Mr White will never know.	ちょっとした稼ぎになるし、ホワイト氏も気づきはしないだろう。
Give me a break, please.	ちょっとかんべんしてよ。
Can I bother you for something?	ちょっとお願いがあるんですが。
Would you do something for me?	ちょっとおたのみがあるんですが。
Let me have a look at your video camera.	ちょっとあなたのビデオカメラを見せて下さい。
It falls on Sunday.	ちょうど日曜日にぶつかりますね。
I met him just now.	ちょうど今、彼と出会ったのです。
I've just been to the bank.	ちょうど銀行へ行ってきたところです。
We were just talking about you.	ちょうどあなたのことをお話ししていたところです。
Let's get out of here.	ちょいとここらで河岸をかえましょうや。
Tell me what I should be watching for.	チェックポイントを教えてください。
I'd like to check out. Do you have my bill?	チェックアウトしたいので、会計をおねがいします。
How is cheerleading practice?	チアリーダーの練習はどうなの。
Who were you talking with?	誰と話していたのですか。
All are welcome.	だれでも歓迎します。
No, don't go yet.	だめ、行かないで。
Use your head for a change.	たまには頭を使えよ。
It fell out that he could not come in time.	たまたま彼が間に合わなかったのだ。
It is possible that he may know the fact.	たぶん彼はその事実を知っている。
There are few, if any, such men.	たとえそんな人はいるとしてもごく少ない。
Even if you do not like it, you must take charge of it.	たとえそれが嫌いでも、あなたはその世話を引き受けなければならない。
Not a single word did he say.	たったの一言も彼は言わなかった。
I want a lot.	たくさん欲しい。
A good many people have told me to take a holiday.	たくさんの人たちが私に休暇を取るように言った。
Many children were playing in the park.	たくさんの子供達が公園で遊んでいた。
A lot of students do part-time jobs.	たくさんの学生がアルバイトをする。
That's why I think I'll be chosen.	だから選ばれると思います。
So, it isn't hot at all.	だから、全然暑くなんかないんだよ。
Direct marketing is a means of allowing people to shop from home.	ダイレクト・マーケティングは人々が家に居ながらにして買い物が出来る方法である。
Could you bring me a Time magazine?	タイムマガジンを持ってきてください。
Do you have Time magazine?	あなたはタイムマガジンを持っていますか？
It was a very, very hot night.	たいへん暑い夜だった。
Don't you think most Japanese students work hard?	たいていの日本の学生はよく勉強すると思いませんか。
Most people like watching TV.	たいていの人はテレビを見るのが好きです。
Most students study hard.	たいていの学生は熱心に勉強する。
That would bring only a small price.	そんな物を売っても二束三文にしかならない。
Let's not think like that.	そんな風に考えるのはやめよう。
Don't talk back to me like that.	そんな風に口答えするな。
Don't talk like that.	そんな風に言うものじゃない。
Don't ask such hard questions.	そんな難しい質問をするな。
Don't ask me such a hard question.	そんな難しい質問はよしてくれ。
We have no such example.	そんな先例はない。
Don't be too hard on me.	そんな私をしからないでください。
Don't put it that way.	そんな言い方をするなよ。
I don't feel like it.	そんな気分じゃないんだ。
It's mean of you to talk that way.	そんなふうに言うなんて卑怯だ。
Don't run so fast.	そんなに速く走るな。
You need not have come so early.	そんなに早く来る必要はなかったのに。
You did not need to come so early.	そんなに早く来る必要はなかった。
You need not have got up so early.	そんなに早く起きる必要はなかったのに。
You needn't go too early, need you?	そんなに早くに行くには及ばないでしょうね。
I didn't mean it.	そんなつもりではなかったんだ。
That's easy for you to say.	そんなこと言ったって。
We should start getting Christmas gifts for the children.	そろそろ子供達にプレゼントを用意しなければ。
Let's be going now.	そろそろ行こうか。
It's about time we brought this party to an end, isn't it?	そろそろパーティーをお開きにする時間じゃないか。
Turn it off.	それ消して。
They have never been heard of since.	それ以来彼らの消息は不明だ。
He has never been heard of since.	それ以来彼のうわさは聞いていない。
We have never heard from him since.	それ以来彼から一度も便りがない。
I have never heard from him since.	それ以来彼からは何の便りもありません。
He has not been heard of since.	それ以来、彼の消息を聞いていない。
To understand it, you have only to read this book.	それを理解するには、この本を読みさえすればいい。
It's the animal in me that wants it.	それを欲するのは私の中の獣性だ。
Let it be done by six this evening.	それを夕方６時までにやって下さい。
Let's get it over with.	それを片付けてしまおう。
Let me hear it.	それを聞かせてくれ。
I don't know how to put it in Japanese.	それを日本語でどういうのがわかりません。
There are few men who don't know that.	それを知らない人はほとんどいない。
Bring it to me.	それを私のところに持って来なさい。
Bring it back to me.	それを私に戻して下さい。
Let me have a look at it.	それを私に見せてください。
Please send it to me by fax.	それを私にファックスしてください。
Put it where children can't get at it.	それを子供たちの手の届かない所に置きなさい。
Put it back where you got it from.	それを元の場所へ返しなさい。
Put it back where it was.	それを元の所へ戻しなさい。
Let me have a look at it.	それを見せてよ。
Let me see that.	それを見せて。
It took many years to build it.	それを建てるのに何年もかかった。
Can you put it down on the table?	それを机の上に下ろしてくれませんか。
You must take care not to break it.	それを壊さないように注意しなければならない。
Put it down.	それを下に置きなさい。
Let me have a look at it.	それをちょっと見せてください。
Bring it here.	それをこっちへ持ってきなさい。
They built up twenty-five stories on one side and thirty-five stories on the other.	それらは片方が２５階建てでもう片方は３５階建てになりました。
Are they displayed all through the year?	それらは１年を通してずっと飾られている。
These figures don't add up.	それらの数字は、合計があわない。
Those children have no one to care for them.	それらの子供たちは世話をしてくれる人が誰もいない。
It's out of the question.	それは問題外で不可能だ。
That is out of the question.	それは問題外だよ。
That sounds interesting.	それは面白そうだ。
It's free of charge.	それは無料です。
That's against the law.	それは法律違反です。
That's hard to say.	それは表現しにくいですね。
It was such an interesting book that I read it in a day.	それは非常におもしろい本だったので私は１日で読んだ。
It was something she did not want to put into words.	それは彼女が言葉にしたくないことだった。
That applies to him too.	それは彼についても当てはまる。
It isn't hard to do.	それは難しいことじゃない。
I found the book easy.	それは読みやすい本だった。
That's a hard question to answer.	それは答えにくい質問だ。
It's in a small room at the end of garden.	それは庭の隅の小さな部屋にあります。
That's asking too much.	それは虫がよすぎるよ。
It will make for the society.	それは社会に寄与するのだ。
It is a picture that I like very much.	それは私の大きな写真です。
That's not the sort I'm looking for.	それは私の探している種類のものではない。
Does that mean you want to break up?	それは私たちの関係を終わらせたいということですか。
It's not something I'm very good at.	それは私が大変得意としているものではない。
That's the same story as I heard when I was a child.	それは私が子供のころに聞いたのと同じ話です。
That is not what I meant to say.	それは私が言おうとしたことではない。
That is not the point in question.	それは今問題になっている点とは違う。
It is saying too much.	それは言い過ぎだよ。
It is by no means an easy job.	それは決して容易な仕事ではない。
That is something you should not have said.	それは君の失言だ。
That is because you always study hard.	それは君がいつも一生懸命勉強しているからだよ。
That's a copy.	それは偽物です。
That has no bearing on our plan.	それは我々の計画とはなんの関係もない。
Does that mean you want to break up?	それは我々の関係を終わらせたいということですか。
It's a problem we do not have any answer for.	それは我々がまったく回答できない問題だ。
What an easy problem it is!	それは何と易しい問題なのでしょう。
What an animal it is!	それは何という動物だ。
It is written in easy English.	それはやさしい英語で書かれている。
I didn't mean to put that on there.	それはもっていくつもりはなかったんだ。
What an interesting story it is!	それはなんと面白い物語でしょう。
What animal is it?	それはどんな動物だ。
What sort of play is it?	それはどんな芝居ですか。
This sounds very interesting.	それはとても面白そうだ。
It was a very long meeting.	それはとても長い会議だった。
It is out of the question.	それはとてもできない相談だ。
It must be hard for you.	それはつらいだろうね。
That sounds a little off.	それはちょっとずれてるよ。
It moved closer and closer.	それはだんだん近づいてきた。
It has some bearing on this problem.	それはこの問題といくぶん関係がある。
It is the one you used to hear when you were a little child.	それはお前が小さな子供の頃によく聞いた音だ。
That's a good answer.	それはいい答えだ。
It's a possible story.	それはあり得ることだ。
Is that a common name?	それはありふれた名前ですか。
I will put it down to your account.	それはあなたの勘定につけておきましょう。
That's a job of your own choosing, isn't it?	それはあなたが自分で選んだ仕事でしょ。
It goes around the sun in 365 days.	それは３６５日かけて太陽の周りをまわる。
Does that price include tax?	それは、税込みの値段ですか。
Tell me the right answer to it.	それの正しいこたえを教えてくれ。
Its color is red.	それの色は赤い。
Is there a service charge for that?	それには手数料がかかりますか。
I didn't notice it.	それには気付かなかった。
I don't understand much about it.	それについて私は詳しく知りません。
I will say something about it.	それについて言いたいことがある。
And just think, you're on the other side of the world.	それに、考えてもごらんなさいよ。あなたは地球の裏側にいるのにね。
You should've said so earlier.	それならそうと言ってくれればいいのに。
What do you mean by it?	それどういう意味ですか？
It accounts for the fact.	それで説明がつく。
Well, let's make it some other time.	それでは、またの機会ということに。
Does that mean you won't come?	それでは、あなたは来ないということですか。
How do you feel about it?	それって、どう思う？
Each child was given a present.	それぞれの子供がプレゼントをもらった。
That is your major problem.	それが君の大きな問題だ。
It turned out all for the best.	それが一番いい結果になった。
On the third day a wedding took place at Cana in Galilee.	それから３日目に、ガリラヤのカナで婚礼があった。
This is the only possible time for doing that.	それがやれるのは今だけだ。
What do you mean by that?	それ、どういう意味ですか。
Let me try it.	それ、ちょっと僕にやらせてみて。
Let me see it.	それ、ちょっと見せて。
I have heard the story.	その話は知っています。
The story shows us an interesting fact.	その話は私達におもしろい事実を教えてくれた。
The story is very interesting to me.	その話は私には非常に興味がある。
The story was very interesting.	その話はとても興味深かった。
The old man was hard of hearing.	その老人は耳が遠かった。
The old man was not as mean as he looked.	その老人は見かけほど意地悪くなかった。
The old man is hard to please.	その老人は気難しい。
The old man said something.	その老人は何か言いました。
The old man was always looking back on the good old days.	その老人はいつも古き良き時代を回想していた。
The old man is above ninety.	その老人は９０歳を超えている。
I haven't yet had time to see about a hotel for the night.	その夜泊まるホテルの手配をする時間がまだないんだ。
The night was very still.	その夜はとても静かだった。
Let's look at the problem from a different point of view.	その問題を別の観点から見てみましょう。
The problem was under discussion.	その問題は討議中でした。
That question is under discussion.	その問題は審議中です。
The problem was too much for me.	その問題は私には理解できなかった。
I found it easy to answer the question.	その問題は解いてみると簡単でした。
The question is before the committee.	その問題は委員会にかけられている。
I found that the problem was easy.	その問題はやさしいことがわかった。
The problem is important on that account.	その問題はその理由で重要なのだ。
Please tell me the answer to the question.	その問題の解答を教えて下さい。
I found that the problem was easy.	その問題が簡単なことに気づいた。
I found it easy to answer the question.	その問いに答えるのは容易だ。
I got a lot out of that book I read.	その本を読んで多くのことを得た。
I found the book easy.	その本を読んでみるとやさしかった。
Having read the book, I could answer all the questions.	その本を読んでいたので、私はすべての質問に答えることが出来た。
When you're done with the book, put it back where you found it.	その本を読んだら、もとのところへ置きなさい。
Put the book back in the same place where you found it.	その本を君が見つけた場所に戻しておきなさい。
Read the book again and again.	その本を何度も読みなさい。
Put the book back where it was.	その本をもとあった場所に返しておきなさい。
Put the book where you found it.	その本をもとあった所へ置きなさい。
Put the book back where you found it.	その本をなおしなさい。
Bring the book to me, not to Tom.	その本をトムのところではなく、僕のところへ持ってきて下さい。
You'll find both of the books interesting.	その本は両方ともおもしろいとわかるでしょう。
Did you find the book interesting?	その本は面白かったですか。
I found the book very interesting.	その本は読んでみたらとてもおもしろかった。
This book is easy to read.	その本は読みやすい。
I found the book easy.	その本はやさしかった。
That book had a lot of pages.	その本はページが多かった。
I found the book interesting.	その本はおもしろかった。
Was the book interesting?	その本はおもしろかったですか。
The more you read the book, the less you will understand it.	その本は、読めば読むほどわからなくなる。
It is five years since the book was made into a movie.	その本が映画化されてから５年になる。
The law doesn't apply to this case.	その法律はこの件には当てはまらない。
The law does not apply to this case.	その法則はこの場合当てはまらない。
I'm against the bill.	その法案に反対です。
Many people are against the bill.	その法案に反対しているひとがおおい。
I'm for the bill.	その法案に賛成です。
That was the answer I wanted.	その返事は我が意を得たものだった。
The document records that the war broke out in 1700.	その文書にはその戦いが１７００年に起こったと記録されている。
When did you hear the sound?	その物音をいつ聞いたのですか。
The room is too small to play in.	その部屋は小さいので、中では遊べない。
You must not enter the room.	その部屋に入ってはいけません。
The goods were entered to her.	その品物は彼女の注文品として記入された。
It'll be two weeks before you receive the article.	その品は届くまで２週間ほどかかります。
The program is on the air.	その番組は今放送中です。
The program will be on the air before long.	その番組はまもなく放送されるだろう。
Not a star was to be seen that night.	その晩は星ひとつもみられなかった。
That cost me a lot in the long run.	その買い物は結局高くついた。
The purchase is on the company's account.	その買い物は会社の払いになります。
Christmas fell on Saturday that year.	その年は、クリスマスは土曜日だった。
Christmas fell on Saturday that year.	その年のクリスマスは土曜日だった。
Tell me which of the two cameras is the better one.	その二台のカメラのうちどちらがよいほうなのか教えて下さい。
The two children were of an age.	その二人の子供は年が同じだった。
A war broke out between the two countries.	その二国間で戦争が起こった。
The road runs from Tokyo to Osaka.	その道は東京から大阪まで続いている。
Is that answer right?	その答えは正しいのですか。
Isn't the answer easy?	その答えはやさしいのではないですか。
There were no radios in Japan in those days.	その当時日本にラジオはなかった。
There were no radios in those times.	その当時はラジオと言うものが無かった。
In those days, I was still a student.	その当時、私はまだ学生であった。
The island is to the south of Japan.	その島は日本の南のほうにある。
Few people live on the island.	その島のほとんどに人が住んでいない。
It was hard for them to get to the island.	その島に着くことは彼らには難しかった。
There were no signs of life on the island.	その島に人がいる形跡はなかった。
There is no living on the island.	その島に住むことは不可能だ。
No animals are to be found on the island.	その島で動物はぜんぜん見当たらない。
The land came into the market.	その土地が売りに出された。
I've never heard of that city.	その都市のことを聞いたことがない。
All the roads leading into the city are full of cars.	その都市に入る道はすべて車で一杯である。
The store was just off the street.	その店は通りから奥まったところにあった。
I hear the store is in the center of the city.	その店は町の中心にあるそうですね。
There's only one store on the island.	その島には一軒しか店がない。
Put what you get at the store to my account.	その店でかうものは私のつけにしておきなさい。
There are many people and cars on that street.	その通りは車や人の量が多い。
The street is full of cars.	その通りは車でいっぱいだ。
There are stores on each side of the street.	その通りの両側に店が並んでいる。
I was interested in seeing the city.	その町を見て回るのに興味をもった。
The parking lot is free of charge.	その駐車場は無料だ。
I am very pleased to hear the news.	その知らせをお聞きして大変喜ばしく存じます。
The news came out of the blue.	その知らせは突然やってきた。
The price includes tax.	その値段は税金を含みます。
The man answers the description.	その男は人相書に合っている。
The man answered to the description.	その男は人相書きのとおりだった。
The man always cadges money from me.	その男はいつも私に金をたかる。
The man entered the next room.	その男の人は隣の部屋には行った。
All the students of the university have access to the university library.	その大学の学生は皆、大学の図書館を自由に利用できる。
What is that big new building?	その大きな新しい建物は何ですか。
Is that as fast as you can go?	その速さで精一杯ですか。
The ship will call at Yokohama.	その船は横浜に寄港する。
The war was over at the price of many lives.	その戦争は多くの命を犠牲にして終わった。
The war lasted two years.	戦争は２年続いた。
The war ended in 1954.	その戦争は１９５４年に終わった。
It was the war that changed Japan.	その戦争こそが日本を変えた。
The baby is crawling.	その赤ん坊ははいはいしている。
It fell to me to take care of the baby.	その赤ん坊の面倒を私が見なければならない。
The baby is called Tom.	その赤ちゃんはトムっていうの。
That student runs fast, doesn't he?	その生徒は走るのが速いね。
Not all those students are present.	その生徒達が全員出席しているわけではない。
The students were told to turn in reports by the next day.	その生徒たちは翌日までにレポートを提出するよう言われた。
Is the man old or young?	その人は年をとっていますか。若いですか。
What he said was over my head.	その人の言ったことはさっぱりわからない。
I've never met him.	その人には一度も会ったことはない。
The fact was brought to light.	その真実が明るみに出た。
The offer is too good to turn down.	その申し出は、断るにはあまりにも良すぎる。
The new student became friends with Ken.	その新入生はケンと親しくなった。
The new model car will be brought to market in May.	その新型車は五月に発売される。
That color is becoming to your face.	その色は君の顔の色と似合う。
The information is very important to us.	その情報は私達にとっては非常に重要です。
Some of the information is very important.	その情報のなかには大変重要なものもある。
The place is very much built up now.	その場所は今は相当建て込んでいる。
We checked the document again.	その書類をもう一度調べた。
The paper wasn't important.	その書類は重要でなかった。
Let the paper be signed.	その書類に署名しなさい。
The collection is open to the public.	その収集品は一般に公開されている。
The car didn't move.	その車は動かなくなった。
The car is very fast.	その車は大変速い。
The car is easy for me to drive.	その車は私には運転しやすい。
The car broke down.	その車は故障した。
The car made a right turn over there.	その車はあそこで右に曲がった。
The car doesn't run fast.	その車は、速く走らない。
The price of the car is too high.	その車の値段は高すぎる。
The car is in the way. Please move it.	その車がじゃまです。動かしてください。
The social worker was asked to follow up the information about the Stevenson family.	その社会奉仕家はスチブンソン家に関する情報をあくまでも追跡するよう求められた。
Let me have a look at those photos.	その写真を見せて下さい。
Will you show me the picture?	その写真を見せてくれませんか。
The picture was taken from the air.	その写真は空から写されたものである。
The picture brought back a lot of memories.	その写真はいろいろな思い出をよみがえらせた。
That question is easy to answer.	その質問は答えやすい。
The question is by no means easy.	その質問は決してやさしくない。
If I knew the answer to the question, I would tell you.	その質問の答えを知ってたら、君に教えるのだけれど。
It is easy to answer the question.	その質問に答えるのは簡単だ。
Only you can answer the question.	その質問に答えられるのは君だけだ。
We were all running short of money then.	その時私たちはお金に困っていた。
The watch broke down.	その時計は故障した。
I haven't heard from him since then.	その時以来彼から何の便りもない。
Up to that time, we were watching TV.	その時まで、私はテレビを見ていました。
The building to the right of that office building is the Tokyo Building.	その事務所の右隣が東京ビルです。
There is no one but knows the fact.	その事実を知らないものはいない。
They are the only people who know the fact.	その事実を知っているのは彼らだけだ。
You shouldn't make too much of the fact.	その事実を過大視してはいけない。
You shouldn't make too much of the fact.	その事実をあまりに過大視すべきではない。
The event has become known to the public.	その事件は明るみに出た。
The fact is, I think, very important.	その事実はとても大切だと思います。
Put that in writing.	その事を書面にして下さい。
You may not have heard about this.	その事はまだお聞きになっていないかもしれない。
How does the paper feel?	その紙はどんな手触りですか。
The city is well supplied with water.	その市には十分に水が供給されている。
The child does not even know how to add.	その子は足し算の仕方さえ知らない。
The child followed me to the park.	その子供は公園まで私についてきた。
That child talks as if he were an adult.	その子供はまるで大人であるかのような話し方をする。
The child talks as if he were a man.	その子はまるで大人のようなことを言う。
She put it in the box.	その子はそれを箱の中に入れました。
That child has few friends.	その子はあまり友人がいない。
The child was taken care of by him.	その子は、彼の世話を受けた。
Few people know how to do it.	その仕事を知っている人はほとんどいない。
Let's do the work.	その仕事をやろう。
I think it will be easy to do the job.	その仕事をするのは簡単だと思う。
I'm through with my work. Let's go out.	その仕事は終わったよ。出かけよう。
You will find the job easy.	その仕事は楽にできるだろう。
That job was not very interesting, but on the other hand it was well paid.	その仕事はあまり面白くなかったが、その一方で給与はよかった。
That job was not very interesting, but on the other hand it was well paid.	その仕事はあまりおもしろくなかったが、他方で報酬が良かった。
It is up to you to apply for the job.	その仕事に応募するかしないかは、あなたが決めることです。
Why not apply for that job?	その仕事に応募したらどうだい。
That job took a lot out of me.	その仕事でへとへとだ。
Can I have a look at the magazine?	その雑誌を見せてくれますか。
The magazine comes out every week.	その雑誌は毎週出る。
The magazines were sold out.	その雑誌は売り切れだった。
Where can I buy that magazine?	その雑誌はどこで買えますか。
At that time, she was a student at Yale.	その頃彼女はエール大学の学生であった。
That country is turning into a society with high education.	その国は高等教育社会に変わりつつある。
Many young people are out of work in that country.	その国ではたくさんの若い人々が失業している。
The passwords were easy to figure out.	その合い言葉は分かりやすかった。
Not a few people had that thought.	その考えをする人は少なくない。
The park was designed for small children.	その公園は小さな子ども用に造られた。
The park is common property.	その公園は公共の財産だ。
What does this word mean?	その語はどんな意味ですか。
I have never heard of him since.	その後彼のうわさを聞かない。
The old building was broken down.	その古い建物は取り壊された。
Don't play with that key!	その鍵をいじるな！
I found it easy to find the building.	その建物を見つけるのは簡単だった。
The building will be completed in a year.	その建物は１年で出来ます。
The building is seven stories high.	その建物は７階建てだ。
The building was built in 1960.	その建物は１９６０年に建てられた。
You should not make little of the result.	その結果を軽く見てはいけない。
You should not make little of the result.	その結果を軽く見ちゃいけない。
I am pleased with the result.	その結果に喜んでいる。
It may be too early for us to put the project into practice.	その計画を実行に移すのは私たちにはまだ早すぎるかもしれない。
It cost lots of money to put the plan into practice.	その計画を実行に移すのに多大な費用がかかった。
The plan is under discussion.	その計画は討議中です。
As yet, the project is in the air.	その計画は今のところ未決定である。
Will the plan meet the need?	その計画はこの場にふさわしいだろうか。
Some people are for the plan and others are against it.	その計画に賛成の者もいれば反対の者もいる。
The plan calls for a lot of money.	その計画には沢山の資金が必要だ。
The new plan will call for a lot of money.	その計画には多額の金が必要となるだろう。
The plan calls for a lot of money.	その計画には多額のお金が必要である。
The plan calls for a lot of money.	その計画にはたくさんの投資が必要だ。
The bank opens at 9 a.m. and closes at 3 p.m.	その銀行は午前９時に開き、午後３時に閉まる。
Where is the bank?	その銀行はどこにありますか。
We have an account with the bank.	その銀行に取り引きがある。
Will you show me the way to the bank?	その銀行に行く道を教えてくれませんか。
Put the money in the bank.	その金を銀行に預けなさい。
All the schools are closed on that holiday.	その休日にはすべての学校が休みになる。
I had him in that discussion.	その議論で彼を論破した。
The student ordered the book from New York.	その学生はニューヨークにその本を注文した。
All the students study English.	その学生たちは全員英語を勉強しています。
The school supplies the students with books.	その学校は生徒に本を支給する。
There are 2,000 students in the school.	その学校には二千人の学生が在学している。
The shops in the street were for the most part closed.	その街の店は大部分閉められていた。
I found the picture interesting.	その絵画を見たらおもしろかった。
Look at the picture.	その絵を見なさい。
Please let me have a look at those pictures.	その絵を見せてください。
I've seen that picture before.	その絵、以前に見たことがあるよ。
I've seen that picture before.	その絵は以前に見たことがある。
The picture is good in its way.	その絵はそれなりによくできている。
Can you see the picture?	その絵が見えますか。
The company closes its books at the end of March.	その会社は毎年３月に決算をする。
The company has purchased a new computer system.	その会社は新しいコンピューターシステムを購入した。
The meeting took place last week.	その会合は先週行われた。
The meeting is all over.	その会合はすっかり終わった。
The meeting was called off.	その会合は、中止になった。
Only one third of the members turned up at the meeting.	その会合に姿を現したのはメンバーの３分の１だけだった。
There were only six people at the meeting.	その会合にはわずか６人しかいなかった。
The meeting room is in use now.	会議室は現在使用中です。
There were thirty people present at the meeting.	その会議に出席していたのは３０名の人であった。
Were you present at the meeting?	その会議に出席したのですか。
The house is to let.	その家は貸家です。
The house is built in European style.	その家はヨーロッパ風に造ってある。
The house is being built now.	その家は今建築中である。
The house is too small for five people to live in.	その家は５人が住むには狭すぎる。
That music really gets me.	その音楽には本当に感動をおぼえた。
I couldn't hear the sound well.	その音がよく聞こえなかった。
You should have seen the film.	その映画を見るべきだったのに。
I saw the film, which was not so good.	その映画を見ましたが、あまりよくありませんでした。
I found the film interesting.	その映画を見たらおもしろかった。
I saw the film and found it interesting.	その映画を見たけれど面白かったよ。
I want to see the movie again.	その映画をもう一度見たいな。
How many times did you see the movie?	その映画を何回見ましたか。
If the film is on at your place, do go and see it.	その映画をそちらでやっていたら、ぜひ見た方がいいですよ。
The movie was good.	その映画は良かった。
The movie was interesting.	その映画は面白かった。
The movie is X-rated.	その映画は成人向きだ。
Only adults may watch that film.	その映画は成人しかみられない。
The picture is on now.	その映画は上映中だ。
The movie was interesting to all of us.	その映画は私達みんなにとって興味深かった。
I saw the film in San Francisco last year.	その映画は去年サンフランシスコで見たことがある。
I've seen the film many times, but I'd like to see it again.	その映画は何度も見たことがあるが、もう一度見てみたい。
When will the film be released?	その映画は何時封切りになりますか。
How many times did you see the movie?	その映画は何回見ましたか。
That movie will be released by and by.	その映画はまもなく公開される。
How did you like the film?	その映画はどうだった。
The film was not what I had thought it was.	その映画は、私が思っていたようなものではなかった。
How does the film end?	その映画の結末はどうなっていますか。
Are you for or against the plan?	その意見に賛成ですか、それとも反対ですか。
The committee has something to do with this plan.	その委員会はこの計画に関係している。
The committee is made up of ten members.	その委員会は１０名から成っている。
The committee is made up of ten members.	その委員会は１０人のメンバーで構成されている。
Add a few more names to the list.	そのリストにもう２、３の名前を加えなさい。
That was why he entered the university.	そのようにして、彼はその大学に入学した。
In such a case, you can always ask a question in return.	そのような場合、あなたはいつでもその代わりに質問することができます。
There were few, if any, cases.	そのようなケースは、たとえあるにせよ、まれなことだった。
Few people know how to do it.	そのやり方を知っている人はほとんど少ない。
We need to talk about how to do it.	そのやり方についてどうすべきかを話し合う必要がある。
The cost of financing of the project was very high.	そのプロジェクトの資金コストはとても高かった。
The plan has broken down.	そのプランは失敗に終わった。
The building has not been known to us at all.	そのビルは私たちには全然知られていない。
The building is twenty stories high.	そのビルは２０階建てです。
It's at the back of the building.	そのビルの後ろですよ。
The performance was low-keyed.	そのパフォーマンスは冴えないものでしたよ。
I heard the news on the radio.	そのニュースはラジオで聞いたよ。
The news has just come on the radio.	そのニュースはちょうどラジオで流れたところだ。
The sun was coming up then.	そのとき太陽がのぼるところだった。
I met him then for the first time.	そのとき初めて彼と会った。
Mr Jones said something then.	そのときジョーンズさんが何かいいだした。
The test result showed how much he had studied.	そのテストの結果は彼がどれぐらい勉強したかを示した。
The result of the test brought home to me how little I had learned.	そのテストの結果で私はいかに学んでいなかったかを痛感した。
I didn't mean that.	そのつもりで言ったのでは・・・。
Where can we go on that tour?	そのツアーはどこを回りますか。
How much is the tour?	そのツアーはいくらですか。
That team has never played as well as they played today.	そのチームは今日ほどよくプレーしたことはなかった。
The show will be on the air at 7 p.m.	そのショーは午後７時に放送される。
The computer's color is red.	そのコンピューターの色は赤い。
I was only a little child then.	そのころ私はほんの子供でした。
In those days, there were no radios.	そのころはラジオはなかった。
There was no TV or radio in those days.	そのころはテレビやラジオはありませんでした。
In those days, he was a student.	そのころ、彼は学生だった。
It is no good talking about it.	そのことをはなしても無駄です。
I don't want to make an issue of it.	そのことは問題にしたくない。
I can't put up with it any longer.	そのことはもはや容赦できない。
You may have heard of that.	そのことはお聞きになったかもしれない。
It must have something to do with money.	そのことはお金に関係があったに違いない。
Could you please give me some more examples of that?	そのことについてもう少し例をあげてくれませんか。
I've heard all about it.	それについては全て伺いました。
Tell me as much about that as possible.	そのことについてできるだけ話を聞かしてください。
Let me do that.	そのことなら私に任せておけ。
I want to talk to him about it.	そのことで彼と話し合いたい。
Something must be done about it in no time.	そのことですぐに何か手を打たねばなるまい。
What places does that tour visit?	そのコースは、どこをまわるのですか。
I found the game easy.	そのゲームはやさしかった。
The group was made up of four young men.	そのグループは４人の若者から構成されていました。
The club has more than fifty members.	そのクラブには５０人以上の会員がいる。
That club is way too big.	そのクラブでは大きすぎるよ。
The class was made up of seventeen children.	そのクラスは１７名の子供から成り立っていた。
Every student in the class knows the fact.	そのクラスのどの生徒もその事実を知っている。
The camera will cost at least $500.	そのカメラは少なくとも５００ドルする。
You will have heard the news.	そのお知らせはお聞きになったでしょう。
The money was put into a special fund to buy books for the school library.	そのお金は学校図書館の本を購入するための特別な基金に入れられた。
You will learn to love your baby.	そのうち赤ん坊が可愛くなるよ。
One of these two answers is right.	その２つの答えのどちらか一方が正しい。
The two languages have a lot in common.	その２つの言語には共通点が多い。
Is it hot over there?	そちらは暑いですか。
And they knew something which the Europeans did not.	そして彼らはヨーロッパ人が知らなかったことを知っていた。
Turn right there.	そこを右に曲がりなさい。
Go over it again.	そこをもう一度やってください。
Let's go and see him there.	そこへ彼に会いに行こう。
We took turns driving our car on our way there.	そこへ行く途中私たちは交代で運転した。
We took turns driving our car on our way there.	そこへ行く途中で私たちは交代で車を運転した。
Only a few people didn't go there.	そこへ行かなかった人はわずかだった。
I've been there a few times.	そこへは何回か行ったことがある。
We took turns driving our car on our way there.	そこは行く途中私達は交代で車を運転した。
Please let me know when we get there.	そこに着いたら教えてください。
Every time I go there, I meet her.	そこに行くたびに彼女に会う。
I've never been there before.	そこにはこれまで一度もいったことがない。
There were more than 100 students there.	そこには１００人以上の生徒がいた。
There are no means of getting there.	そこにたどりつく方法はない。
Please buy it from that official.	そこにいる係員から買ってください。
Move! You're in my way.	そこにいると邪魔なんだよね。どいてよ。
I met a friend there.	そこで友人に会った。
Never did I think I would see her there.	そこで彼女に会おうとは思いもかけなかった。
Who did you meet there?	そこで誰に会ったのですか。
Don't take it so hard!	そう深刻に考えるな。
Few people think so.	そう思っている人が少ない。
It is not too much to say so.	そう言っても言い過ぎではない。
Come to that, I'd like to do some shopping too.	そう言えば買い物もしたいな。
It all amounts to a lot of hard work.	そうなるとかなりきつい仕事ということになる。
Really? I want to go there very much. I like Renoir very much.	そうなの。ぜひ、行ってみたいわ。私はルノアールが好きなの。
We'll face that problem when we come to it.	そうなったときに私達は問題に直面することになる。
That is why he wasn't present at the meeting.	そういう訳で彼はその会議に出席しなかった。
That was why he entered the university.	そういうわけで、彼はその大学に入学した。
Do keep practicing!	ぜひ練習を続けなさい。
Do come by all means.	ぜひ来てください。
Try by all means.	ぜひやってみなさい。
Do come and see us again.	ぜひまた遊びにきてください。
You must come to the party by all means.	ぜひパーティーにおいでください。
I will do it by all means.	ぜひそれをやりましょう。
Do it by all means.	ぜひそれをしなさい。
You really must see that movie.	ぜひその映画を見るべきです。
I'd love to see the movie.	ぜひその映画を見たい。
By all means.	ぜひお願いします。
I shall never give up.	ぜったい降参しない。
Please answer the phone.	すみませんが電話に出てください。
Will you please let me go now?	すみませんが、もう行かせていただけませんか。
Mr. and Mrs. Smith are a good match.	スミス夫妻は似合いの夫婦だ。
Mr Smith is in charge of the class.	スミス先生はそのクラスの担任だ。
The Smiths moved to Ohio.	スミス一家はオハイオウ州に引っ越した。
Mr Smith says, "I was born in New York."	スミスさんは自分はニューヨークの生まれだと言った。
All roads lead to Rome.	すべての道はローマに通ず。
Not all the students were present.	すべての学生が出席したわけではなかった。
All the students are studying English.	すべての学生が英語を勉強している。
Four-fifths of all the members were against the plan.	すべての会員のうち、５分の４はその計画に反対だった。
80% of all English words come from other languages.	すべての英語の単語のうち、８０％は他の言語を起源としています。
This is the first time I have seen a Spielberg movie.	スピルバーグの映画を見たのはこれが最初だ。
You're driving too fast.	スピードの出しすぎだよ。
Steve, I heard you were the baby of the family.	スティーブ、あなたは末っ子なんだってね。
You never wanted to talk about it.	ずっとその話を避けてきたくせに。
Not all of the staff was present.	スタッフ全員が、出席したわけではありません。
Now that we've got off the mark, we must get through this work.	スタートを切ってしまった以上、私達はこの仕事を最後までやり通さねばならない。
I really want to know.	すごく知りたいなあ。
That's a lot!	スゴイ量だね！
That's too much!	すごいじゃない！
It will not be long before we meet again.	すぐ再会できるだろう。
Don't talk so impudently.	ずうずうしいことを言うな。
Susie can type many times as fast as I can.	スージーは私の何倍もの速さでタイプが打てる。
Susan is majoring in American history.	スーザンはアメリカ史を専攻しています。
Sweden has a language of its own.	スウェーデンには独自の言語がある。
I'd like a single from the 24th for two nights.	シングルの部屋を２４日から２泊お願いしたいのですが。
Single, please.	シングルにしてください。
Jill saw the movie with Ken.	ジルはケンとその映画を見た。
John talks big.	ジョンは話が大きい。
John works hard.	ジョンは熱心な勉強家だ。
John is easy to please.	ジョンは気がいい。
John has not come yet, but when he does, I will call you.	ジョンはまだ来ないが、来たらあなたを呼びます。
John is not as old as Bill; he is much younger.	ジョンはビルと同じではなく、ずっと年下だ。
John will not answer the question.	ジョンはその質問に答えようとしない。
John has the complete collection of Sam's music.	ジョンはサミーのレコード全集を持っている。
John always tried to live up to the example of Lincoln.	ジョンはいつもリンカーンを見習って生きようとしていた。
John is a good student.	ジョンはいい生徒です。
John shall have a holiday one of these days.	ジョンには近いうちに休みをやろう。
John shall have a holiday one of these days.	ジョンには近いうちに休みをあげよう。
The student who is talking with John is from Canada.	ジョンと話している学生はカナダ出身です。
John and Mary broke up last week.	ジョンとメアリーは先週別れた。
Mr Johnson ran fastest of the three.	ジョンソン氏は、３人の中でいちばん速く走った。
John came and moved some of the boxes.	ジョンがやって来て箱のいくつかを動かしました。
I can't understand why John turned down a job as good as that.	ジョンがなぜあんなに良い仕事を断ったのか私には理解できない。
John Lennon was born in 1940.	ジョン・レノンは１９４０年に生まれた。
There is no one who has been loved by the students more than Mr Jones.	ジョーンズ先生ほど生徒たちに愛された人はいない。
Mr George is liked by all the students.	ジョージ先生は生徒全員から好かれている。
George Washington was born in 1732.	ジョージ・ワシントンは１７３２年に生まれた。
Just come to see me any time you feel like it, George.	ジョージ、気が向いたらいつでも訪ねて来て下さい。
Who runs faster, Judy or Tony?	ジュディさんとトニー君とではどちらが速く走れますか。
You are welcome, Jack!	ジャックよくきてくれたね。
Jack made me go there against my will.	ジャックはむりやり私をそこへ行かせた。
Jack doesn't drive fast.	ジャックはスピードを出して運転しない。
Jack was born on August the tenth.	ジャックは８月１０日に生まれた。
Jack's car is a recent model.	ジャックの車は新型です。
Let's build on your plan.	じゃあ君のプランで行こう。
Let me tell you something.	じゃあ、言わせてもらうけど。
Can I have the key now, please?	じゃあ、キーをもらえますか。
Well, at least let me set up the table.	じゃ、せめてテーブルの準備でもしましょう。
Jim is coming to the party, too.	ジムもまたパーティーに来ます。
Jim was born in the same year as he.	ジムは彼と同じ年に生まれた。
Jim is watering the garden.	ジムは庭に水を撒いている。
Jim runs as fast as Ron.	ジムはロンと同じ速さで走る。
Jim hasn't been home yet.	ジムはまだ帰宅していない。
Jim hasn't come yet.	ジムはまだきていない。
Jim is short for James.	ジムというのはジェームスを短くしたものだ。
We had been talking about Jim when he entered the room.	ジムが部屋に入ってきたとき私たちはずっと彼の話をしていた。
I had been reading a magazine for some time when she came.	しばらく雑誌を読んでいたら彼女がきた。
Let me think for a while.	しばらく考えさせて下さい。
I have a lot of work to do.	しなければならない仕事がたくさんある。
Study hard.	しっかり勉強しなさい。
Study hard.	しっかり勉強して下さい。
It will not be long before we meet again.	じきにまたお会いするでしょう。
But he doesn't know it yet.	しかし彼はそのことをまだ知らない。
But today, a lot of young people are following her example.	しかし今日、多くの若者達が彼女にならって活動している。
But not really.	しかし、実際は違いました。
But we can't understand him.	しかし、私たちは彼の言うことが理解できない。
However, I have no money.	しかし、わたしにはお金はありません。
But then he fell in love with Jane Wilde, a student studying languages in London.	しかし、その時、彼はロンドンで語学を学んでいる学生のジェーン・ワイルドを恋するようになった。
Jeff thinks he will never fall in love.	ジェフは恋に落ちたりはしないと思っている。
Jane has been acting in films since she was eleven.	ジェーンは十一歳の時からずっと映画に出演している。
Jane understands your way of thinking.	ジェーンは君の考え方が分かっている。
Jane won't come to meet me any more.	ジェーンはもうぼくに会いに来ないだろう。
I am looking at the pictures of Jane.	ジェーンの写真を見ているところだ。
Jane Smith works very hard at her office.	ジェーンスミスは会社で一生懸命働いています。
I had a call from James out of the blue.	ジェームズから突然電話があった。
Shakespeare knew only a little Latin, but he put the little he knew to very good use.	シェークスピアはラテン語をほんの少ししか知らなかったが、そのわずかなことを大いに利用した。
Shakespeare is too hard to read.	シェークスピアの作品はとてもむずかしくて読めない。
Jane offered to take care of our children when we were out.	ジェインは私たちが留守のとき子供たちの世話をしてくれると申し出た。
I haven't heard from Jane since she moved to Tokyo.	ジェインが東京に引っ越して以来、連絡がないんだ。
The plays of Shakespeare fall into four periods.	シェイクスピアの劇は四期に分かれる。
Welcome to San Francisco.	サンフランシスコへようこそ。
Again, there is another side to the story.	さらにまた、その話にはもうひとつの側面がある。
Sam is two years younger than Tom.	サムはトムより二歳年下です。
Now let's return to the main problem of education.	さて例の教育に関しての本題に戻るとしよう。
Well, let's get down to business.	さて本題にはいろうか。
We now turn to a different problem.	さて別の問題に入ります。
Let's go on to the next subject.	さて次の話題に移ることにしよう。
Now, look at the picture, every one.	さて皆さん、その絵をご覧なさい。
So you are back again.	さてはまた帰ってきたね。
Well, let's start our work.	さて、わたしたちの仕事を始めよう。
Now you must answer some big questions.	さて、あなたはいくつかの重要な質問に答えなくてはなりません。
We'd better get a move on.	さっさと行ったほうがいい。
Let's start now, and you go first.	さあ出発しよう。君先頭を行きなさい。
Let's be off now.	さあ出かけましょう。
Let's go at our work.	さあ仕事をはじめましょう。
Let's get down to work.	さあ仕事に取り掛かろう。
Now, let's turn to work.	さあ仕事にかかろう。
Let's get down to business.	さあ仕事だ。
It's now my turn.	さあ今度は僕の番だ。
Is something going on with your server?	サーバで何が起こってるのですか。
Now let's talk it up.	さあ、宣伝だ。
Let's do some boxing.	さあ、少しボクシングをしよう。
Let's get out of the car now.	さあ、車から降りよう。
Let's get going.	さあ、始めましょう。
Now let's get down to work.	さあ、仕事にとりかかろう。
Let's get the show on the road.	さあ、計画を始めよう。
Let's take a break.	さぁ、休憩をとろう。
Let's call it a day.	さぁ、一日を終わりとしましょう。
Come on, try again.	さあ、もう一度。
Let's break up the party.	さあ、パーティーをおしまいにしよう。
I must think it over before answering you.	ご返事をさし上げる前によく考えましょう。
Tokyo, as you know, is one of the financial centers of the world.	ご存知のように、東京は世界の金融の中心地だ。
Please feel free to link to my page.	ご自由にリンクを設定して下さい。
Did you bring your family with you?	ご家族もごいっしょに連れてこられたのですか。
If you change your address, please let me know.	ご移転の際はお知らせ下さい。
Computers will save you a lot of time.	コンピューターを使えば時間に節約になる。
Computers can give us facts, but they can't give us experience.	コンピューターは私たちに真実を与えることができるが、経験を与えることはできない。
The more I studied computers, the more interesting I came to find it.	コンピューターの勉強をすればするほど面白くなってきた。
Computers will save you a lot of time.	コンピューターで時間が多く節約できます。
The computer broke down.	コンピューターが故障したんです。
I don't feel like going out on such a day.	こんな日には外出したくない。
It takes a lot of money to keep up such a big house.	こんな大きな家を維持するのは金がかかる。
Jobs are hard to come by with so many people out of work.	こんなに多くの人が失業中では仕事は得にくい。
Never have I read such an interesting story.	こんなにおもしろい話は読んだことがない。
You must put up with your new post for the present.	こんどの勤め口でしばらく辛抱しなさい。
Can I put this up for you?	これ荷物を上にあげてもよろしい。
It is no use talking with them any longer.	これ以上彼らと話し合っても無駄だ。
Please send this by special delivery.	これを速達で送って下さい。
Send this by special delivery.	これを速達で出してください。
Please change this for a blue one.	これを青いのと取り替えてください。
I'll keep this for future use.	これを将来使えるように取っておこう。
Let this be an example to you.	これを戒めとしなさい。
Who broke this?	これを壊したのはだれですか。
Put this into English.	これを英語で言いなさい。
Where would you like me to put this?	これをどこに置きましょうか。
Please copy this.	これをコピーして下さい。
Can you copy this for me?	これをコピーしてくれますか。
This is the most interesting book of all.	これはすべてのうちでもっとも面白い本だ。
These stories are very interesting to me.	これらの話は私にとって非常におもしろい。
These problems are important to me.	これらの問題は私にとって重要だ。
You don't have to answer these questions.	これらの問題には答える必要はない。
Tell me where to put these books.	この本をどこに置いたらいいか教えてください。
These books are easier than those books.	こっちの本はあっちの本よりやさしい。
There points can be brought under the same heading.	これらの点は同じ項目にまとめて扱うことができる。
Add up these figures.	この数字を合計しなさい。
These figures don't add up.	これらの数字は合計と合わない。
Will you please check these figures?	これらの数字が合っているか調べて下さい。
These goods are free of tax.	これらの商品は無税です。
I would like you to look over these documents.	こちらの書類に目を通していただきたいのですが。
These questions are easy to answer.	これらの質問は、答えるのが簡単だ。
You must answer these questions.	これらの質問に答えなければならない。
There's too much money in these accounts.	これらの口座に金が多く入り過ぎてる。
Do you like any of these pictures?	これらの絵でどれか気になるものはありますか。
Would you like some of those pictures?	これらの絵でどれか気にいるものがありますか。
These cameras are made in Japan.	これらのカメラは日本製です。
Will the meeting please come to order?	これより会議を始めます。
I've never heard of such a story before.	これまでそんな話は聞いた事も無い。
There is no more important problem than this.	これほど重要な問題はない。
Never have I felt better.	これほど気分のよかった事は一度もありません。
This will set a good example.	これは模範となる。
This is an interesting story.	これは面白い話だ。
This is an interesting book.	これは面白い本だよ。
This was an additional fund for buying books.	これは本を買うための足しになった。
This is a story written in easy English.	これは平易な英語でかかれた書物です。
This is very important.	これは非常に重要である。
This is something she has done since she was a child.	これは彼女が子供の頃からやって来たことだったのだ。
This is the house in which they lived when they were children.	これは彼らが子供の頃住んでいた家です。
This is too easy for him.	これは彼にはあまりやさしすぎる。
This is the house he was born in.	これは彼が生まれた家です。
This is a watch made in Japan.	これは日本製の時計です。
This is a camera made in Japan.	これは日本で作られたカメラだ。
This is a road map.	これは道路地図です。
This is too long.	これは長すぎます。
This is too short.	これは短すぎます。
This is too big.	これは大きすぎました。
This is a house to let, not to be sold.	これは貸家だ、売家ではない。
This is an important event.	これは重要な行事です。
This is a car for young people.	これは若者向きの車です。
You can't bring this in.	これは持ち込めません。
This is too small a house for us to live in.	これは私達が住むにはせますぎる家だ。
This is a picture of my family.	これは私の家族の写真です。
This is above me.	これは私には理解できません。
This is above me.	これは私には分からない。
This is a picture I took last week.	これは私が先週撮った写真です。
This is the house where I used to live when I was young.	これは私が若いころに住んでいた家です。
This is the only camera I've got.	これは私が持っている唯一のカメラだ。
This is the same watch as I have.	これは私が持っているのと同じ時計だ。
This is the book which I read last night.	これは私が昨日読んだ本だ。
This is the picture I took in my house.	これは私が家で撮った写真です。
This is a book of children's stories.	これは子供向けの物語の本だ。
This is a good book for children to read.	これは子供が読むのには良い本です。
This is by no means easy reading.	これは決してやさしい読み物ではない。
This applies to your case as well.	これは君の場合も当てはまる。
This is the same camera as yours.	これは君のと同じカメラだ。
This is a picture.	これは絵です。
This is broken.	これは壊れていました。
What heading does this come under?	これは何の項目に入るか。
This is a direct road to London.	これはロンドンへ直行する道です。
Is this a radio?	これはラジオですか。
What an interesting book this is!	これはなんと面白い本でしょう。
This is a very important meeting.	これはとても大切な会合だ。
This is a very interesting book.	これはとってもおもしろい本です。
Where should I put this?	これはどこに置けばよろしいのですか。
What does this mean?	これはどういう意味ですか。
This is a good place to start the analysis.	これはその分析を始めるのに良い箇所だ。
This is the key for the box.	これはその箱をあける鍵です。
This is the house that Jack built.	これはジャックが建てた家だ。
This one is similar to that one.	これはあれに似ている。
Is this the key you are looking for?	これはあなたの探している鍵ですか。
This is too much for a day's work.	これは１日の仕事としては多すぎます。
I am in charge of this.	これは、私の担当だ。
Charge this to my company.	これは、会社払いだ。
Feel free to comment on any point made here.	これについて、自由に批評して下さい。
I'd like the same style as this one.	これと同じ髪型にしてください。
Choose between this and that.	これとあれの中から選んで下さい。
Please choose between this one and that one.	これとあれの中から一つ選んでください。
This is a post office and that is a bank.	これが郵便局で、あれが銀行です。
This is the best camera in the store.	これが店で一番いいカメラです。
This is my I.D. card.	これが診察券です。
This is the key I have been looking for.	これが私の探していた鍵です。
This is the house where I was born.	これが私の生まれた家です。
How does this bear on my future?	これが私の将来とどう関係しますか。
This is the house in which I was born and brought up.	これが私が生まれ育った家です。
This is the house I lived in when I was young.	これが私が若い頃にすんでた家です。
This is the house where I lived when I was a child.	これが私が子供の頃住んでいた家だ。
This is the key which I have been looking for.	これが私がずっと捜していたカギです。
This is the room where the body was found.	これが死体の発見された部屋です。
Answer me this. Did you see her there?	これから言うことに答えなさい。あなたはそこで彼女に会ったのですか。
Answer me this.	これから言うことに答えなさい。
I'll study harder in the future.	これからもっと勉強します。
I'll study harder in the future.	これからはもっと勉強します。
This is the very camera I've wanted for a long time.	これがまさに私が長い間欲しいと思っていたカメラだ。
This is the house in which he was born.	これが彼の生家です。
This is the means by which I can find him.	これが、彼を探し出せる方法だ。
This is the camera with which he took the picture.	これが、彼がその写真を撮ったカメラです。
Please charge this to my account.	これ、私につけておいておいて下さい。
This watch is a new type.	この腕時計は新型です。
How much is this watch?	この腕時計はいくらですか。
Let's get off the subject.	この話題はよそう。
This story tells us an interesting fact.	この話は、おもしろいことを私たちに教えてくれます。
This history book is written for high school students.	この歴史書は高校生を対象に書かれている。
The example doesn't fall into any type stated above.	この例は先にあげたどのタイプにも当てはまらない。
This tour takes in each of the five main islands.	この旅行には主な五つの島がどれも含まれている。
This question isn't easy.	この問題は簡単ではない。
This problem is easier than that.	この問題はそれよりやさしい。
I don't know what the question means.	この問題の意味がわかりません。
This book is easy to read.	この本を読むのは容易だ。
It is easy for me to read this book.	この本を読むのは私には簡単です。
Every time I read this book, I find something new.	この本を読むたびに、何か新しい発見をします。
It is possible for you to read this book in a few days.	この本を君が２・３日で読むのは可能です。
Give me a copy of this book.	この本を１部ください。
This book is written in easy English.	この本は易しい英語で書かれている。
This book looks interesting.	この本は面白そうだ。
This book is above me.	この本は僕には理解できない。
I found this book interesting.	この本、読んでみたら面白かったよ。
This book is interesting to read.	この本は読むのに面白い。
This book is easy to read.	この本は読むのに簡単だ。
It is easy to read this book.	この本は読みやすい。
This book only goes down to World War II.	この本は第二次大戦までしか扱っていない。
This book should help you a lot.	この本は大いに君の役に立つはずだ。
This book isn't interesting at all.	この本は全然おもしろくない。
This book is hot off from the press.	この本は出版されたばかりだ。
This book has a lot of pictures.	この本は写真が多い。
This book is above me.	この本は私の力では及ばない。
This book is above my understanding.	この本は私の理解力を超えている。
This book is above me.	この本は私には難しすぎる。
This book is easy for me to read.	この本は私には読みやすい。
This book is hard for me to read.	この本は私が読むには難しい。
Even children can read this book.	この本は子供でも読めます。
This book is meant for children.	この本は子ども向けです。
This is an old book with a new face.	この本は見かけこそ新しそうだが内容は以前と変っていません。
This book is easy for you to read.	この本は君には易しく読めます。
This book is a must for every student studying English.	この本は我々英学生にとっては正に座右の書である。
What heading does this book come under?	この本は何の項目に入りますか。
This is the most interesting.	この本が一番面白い。
Please put this book on the very top.	この本は一番上に置いてください。
This book is really interesting.	この本はとても面白い。
This book is so easy that a child can read it.	この本はとてもやさしいので子供でも読める。
This book is very interesting.	この本はたいへんおもしろい。
This book is way more interesting than that one.	この本はあの本よりずっと面白い。
This book is not as easy as that one.	この本はあの本ほどやさしくない。
This book isn't as interesting as that book.	この本はあの本ほどおもしろくない。
This book is as interesting as that book.	この本はあの本と同じくらいおもしろい。
This book has gone through eight editions.	この本は８版を重ねました。
This book is of great value to students of science.	この本は、科学を勉強する人にとっては大変価値がある。
The author of this book is still young.	この本の著者はまだ若い。
Which is easier to read, this book or that one?	この本とあの本とどっちがやさしい？
Which is easier, this book or that book?	この本とあの本では、どちらがやさしいですか。
You'll find this book very interesting.	この本がとても面白い事がわかるでしょう。
This law does not apply in Japan.	この法律は日本では通用しない。
This news is official.	この報道は公式のものだ。
Could you put this report into Italian for me?	この報告書をイタリア語に訳してくれませんか。
Make a copy of this report.	この報告書の写しを取りなさい。
This report is free from errors.	この報告書には誤りがない。
The report made much of that fact.	この報告はその事実を重視した。
The analysis gives the following results.	この分析では次の結果が出ている。
This room is too hot for us to work in.	この部屋は暑すぎて私たちは仕事ができない。
It is hot in this room.	この部屋は暑い。
This room is too small for us.	この部屋は私たちにとって狭すぎる。
This room doesn't get a lot of sun.	この部屋は採光が悪い。
This room is for individual use.	この部屋は個人専用です。
It is very hot in this room, isn't it?	この部屋はとても暑いですね。
This room does not get much sun.	この部屋はあまり日が当たらない。
The table takes up a lot of space in this room.	この部屋ではそのテーブルがずいぶん場所をとっている。
It was in this room that we had the meeting last Friday.	この部屋が、我々が先週の金曜に会議を開いた部屋だ。
Who's in charge of this section?	この部の責任者は誰か。
Could you put these in a box?	この品物を箱にいれてもらえますか。
Please pay the tax on the items over there.	この品の税金分はむこうでお支払い下さい。
Is there any tax on this?	この品には税がかかりますか。
The figures in this table are shown in thousands.	この表の数値は千単位で示されている。
Do you want to watch this program?	この番組見る？
This box will do for something.	この箱は何かの役にたつ。
Let's play this Sunday.	この日曜日はどうですか。
Put this Japanese into English.	この日本語を英訳しなさい。
Choose between these two.	この二つの中から一つ選びなさい。
This road is closed to cars.	この道路は車は駐車禁止になっています。
This road goes to the city.	この道路はその市へ通じている。
This road is closed to cars.	この道路は、車は通行止めになっている。
This road will lead you to the park.	この道を行けば、公園に出られます。
This road will take you to the post-office.	この道を行くと郵便局があります。
Where does this road lead to?	この道を行くとどこへ出ますか。
This road leads you there.	この道を行くとそこへ出ます。
This road leads to Hong Kong.	この道は香港に通じている。
This road goes to the park.	この道は公園に至る。
Where does this street lead to?	この道はどこに出ますか。
Am I on the right road?	この道でいいの？
What do you call this animal in Japanese?	この動物は日本語で何と言いますか。
This animal is bigger than that one.	この動物はあれよりも大きい。
We ended this discussion.	この討論を終わりにした。
Who owns this land?	この土地は誰が所有しているのですか。
This land is my property.	この土地は私の所有物だ。
To see this point, look at the table below.	この点を見るために、下の表を見なさい。
This shop is a rental video shop.	この店はレンタルビデオ店です。
This store always closes at eight.	この店はいつも８時に閉店する。
Do you have any tax-free articles?	この店では免税品を扱っていますか。
This garden is open to the public.	この庭は一般に開放されています。
You mustn't park the car in this street.	この通りに車を駐車させてはいけない。
This city is hard to live in.	この町は暮らしにくい。
Please put down your name in this book.	この帳面にあなたの名前を書いてください。
The area is built up now.	この地域は今や立て込んできた。
The area is built up now.	この地域は、今や建て込んできた。
Stars can be seen at night in this area.	この地域では夜に星が見えます。
Houses can't be built in this area.	この地域では家を建てることができない。
This news is important to us.	この知らせは私たちには重要だ。
These men are used to hard work.	この男たちははげしい仕事に慣れている。
What does that word mean?	この単語は何を意味しますか。
What does this word mean?	この単語はどういう意味ですか。
This word is not in common use.	この単語は、一般によく使われていない。
Do you know the meaning of this word?	この単語の意味を知っていますか。
What is the meaning of this word?	この単語の意味は何ですか。
What does this word mean?	この単語の意味はどういう意味ですか。
I don't understand this word.	この単語の意味がわからないのですが。
Can you tell me what this word means?	この単語が何を意味するかわかりますか。
I don't understand this word.	この単語がわからないのですが。
There are ten thousand students in this university.	この大学には１万人の学生がいる。
How long has it been since we last met?	この前会ってからどのくらいになるかな。
Don't let me down as you did the other day.	この前みたいに私をがっかりさせないでね。
Is this baby a he or a she?	この赤ちゃんは男ですか女ですか。
This baby is 3 weeks old.	この赤ちゃんは生後3週間です。
Welcome to this world!	この世界へようこそ！
If only there were no wars in the world.	この世界に戦争なんてなければよいのに。
Will you please check these figures?	この数字があっているか調べてください。
This library has a large collection of Chinese books.	この図書館には中国語の本がかなりそろっている。
There are a lot of English books in this library.	この図書館には英語の本がたくさんある。
Are there any English magazines in this library?	この図書館には英語の雑誌がありますか。
If you will not be available at the new time, please let us know.	この新日程でご都合が悪いようでしたら、ご連絡下さい。
We can offer these new products at 20% below list price.	この新製品は価格表から２０％引きで提供する用意がございます。
This color becomes you.	この色はあなたに似合う。
Do you like this color?	この色、気に入りましたか。
I'd like to mail this package to Canada.	この小包をカナダへ送りたいのですが。
I'd like two copies of each of these documents.	この書類をそれぞれ２部ずつコピーしてほしいんだが。
Please make five copies of this document.	この書類を５枚コピーして下さい。
I would like you to look over these documents.	この書類にざっと目を通してもらいたい。
Put your name on this document.	この書類にサインして下さい。
She turned down our offer of help.	この所は私たちの援助の申し出を断った。
They are going to bring out "Romeo and Juliet" this coming fall.	この秋には「ロミオとジュリエット」が上演されます。
This subject is the most important.	この授業はとても重要だ。
I'd like to fax this to Japan.	この手紙を日本までファックスしてください。
You can put this car to use as you like.	この車を好きなときに使っていいですよ。
This car is going to break down.	この車は故障しそうだ。
This car is easy to drive.	この車は運転しやすいな。
This car has a better performance than that one.	この車はあの車より性能がよい。
I love this picture.	この写真大好き。
I never see this picture without thinking of my young days.	この写真を見ると必ず私は若い頃を思い出す。
I never see this picture without thinking of him.	この写真を見るといつも彼を思い出す。
I never see this picture without thinking of him.	この写真を見るといつも彼のことを思い出す。
Please take a look at this picture.	この写真を見て下さい。
Have a good look at this picture and find me in it.	この写真をよく見て私を見つけてごらん。
Have a good look at this picture.	この写真をよく見て。
Please let me have a look at those pictures.	この写真をちょっと見せてください。
This picture was taken by him.	この写真は彼によって撮影された。
This question is by no means easy.	この質問は決してやさしくない。
It is easy to answer this question.	この質問に答えるのは簡単だ。
Can you answer this question?	この質問に答えられますか。
I will come earlier next time.	この次はもっと早く来よう。
Please bring me the book next time you come.	この次に来るときその本を持ってきてくれ。
This watch is of great value.	この時計は非常に価値がある。
This watch is made in Japan.	この時計は日本製です。
What is the price of this watch?	この時計は値段は幾らですか。
I don't like this watch.	この時計は気に入りません。
This watch is broken.	この時計は壊れている。
This watch is meant for you.	この時計はあなたにあげるつもりです。
We need a large amount of money for this project.	この事業には多額の資金が要る。
This game was put off.	この試合は延期された。
It's the highest building in this city.	この市で最も高い建物です。
This job will mean moving to another city.	この仕事を引き受けると他の町へ引っ越すことになるだろう。
This job is too much for me.	この仕事は私の手に余る。
This work is by no means easy.	この仕事は決してやさしくない。
Is the job too much for you?	この仕事は君の手に負えないですか。
Let me put this business in your hands.	この仕事は君の手にまかせようじゃないか。
This job calls for practice.	この仕事は慣れの必要だ。
This job will call for a lot of money.	この仕事には大金が必要でしょう。
There is no future in this job.	この仕事には将来性がない。
Do you want to read this magazine?	この雑誌を読みたいですか。
May I have this magazine?	この雑誌をいただいてもいいですか。
This magazine is issued every month.	この雑誌は毎月出る。
This magazine sells well.	この雑誌はよく売れるんです。
Please air the zabuton.	この座布団を干して下さい。
Jobs are hard come by these days.	この頃は仕事にありつくのが難しい。
That's an interesting ad.	この広告はセンスがいいね。
That word has fallen out of use.	この語は今では用いられない。
What does this word mean?	この語は何と言う意味か。
What does this word mean?	この語はどんな意味ですか。
This old building has seen better days.	この古い建物は昔、きれいだった。
Is this word in common use?	この言葉はふつうに使われていますか。
What does this word mean?	この言葉はどういう意味ですか。
Please take charge of this key.	この鍵を預かってくれ。
This building also is a bank.	この建物もまた銀行です。
This building is very large.	この建物は非常に大きい。
Is it all right to take pictures in this building?	この建物の中で写真を撮ってもいいですか。
Is this building open to the public?	この建築物は一般に公開されていますか。
I'll talk it over with Marty and see what he thinks.	この件はマーティとよく相談して彼の意見を聞くことにする。
How do you feel about the issue?	この件について、どう感じますか。
How do you feel about the issue?	この件について、どう思いますか。
Can I hear your comments about this?	この件について、コメントが欲しいんですが。
Let's try this plan.	この計画をやってみよう。
Are you for or against the plan?	この計画に賛成ですか、反対ですか。
This type of mobile phone sells well.	この型の携帯電話はよく売れています。
A TV set of this size will take little space.	この型のテレビならあまり場所をとらないでしょう。
Money really talks in this business.	この業界では金がものをいうんだ。
I can't understand this sign's meaning.	この記号の意味が理解できない。
I met him the other day.	この間彼に会った。
We watched a TV program the other day about your people.	この間あなたたちの国の人についてのテレビを見ました。
I got your fax the other day.	この間、君からＦＡＸが届いた。
What does this kanji mean?	この漢字はどういう意味ですか。
This amount includes tax.	この額は税込みです。
This school has many students.	この学校はたくさんの生徒がいます。
What has brought you to this city?	この街へは何のようで来たのですか。
When I see this picture, I always think of the old days.	この絵を見る度に、昔を思い出します。
Look at this picture.	この絵を見て下さい。
Look at the picture.	この絵をごらんなさい。
The meeting had 12 attendees.	この会議は１２人で構成されている。
This association shall be called the E.S.S.	この会の名称はＥ．Ｓ．Ｓ．とする。
Are you a member of this society?	この会の会員ですか。
I'd like to send this package to Japan.	この荷物を船便で日本に送りたいのですが。
This is the house where he was brought up.	この家は彼が育った家です。
This house is as large again as that one.	この家はあの家よりも２倍大きい。
It is I who am head of this family.	この家のあるじは私だ。
Have you a room to let in this house?	この家に貸間はありますか。
Delivery is not included in the price.	この価格には、運賃は含まれていません。
This movie is for adults, not for children.	この映画は大人向けであり、子供向けではない。
This movie is just great.	この映画は素晴らしい。
Did you like the movie?	この映画は気に入った？
This movie is very interesting to me.	この映画はとても興味があります。
I found this film very interesting.	この映画はとてもおもしろいということが分かった。
I don't think this movie is interesting.	この映画がおもしろいとは思わない。
This movie is very interesting to me.	この映画は、わたしにはとても興味があります。
What does this mark mean?	この印はどういうものですか。
Let's keep this level.	このレベルを守りましょう。
This radio is out of order.	このラジオは故障している。
How much is this radio?	このラジオはいくらですか。
How much is this radio?	このラジオはいくらか。
Is this radio yours?	このラジオはあなたのですか。
What is the price of this radio?	このラジオの値段はいくらですか。
This was how he entered the university.	このようにして、彼はその大学に入学した。
This old car breaks down all the time.	このポンコツ車はえんこばかりしている。
This hotel was built last year.	このホテルは去年建てられた。
What are the charges in this hotel?	このホテルの料金はいくらですか。
What are the charges in this hotel?	このホテルの宿泊料金はいくらですか。
What are the charges in this hotel?	このホテルの宿泊料はいくらですか。
Please copy this page.	このページをコピーして下さい。
Please make three copies of this page.	このページのコピーを３枚とってください。
I think this project is moving on the right track.	このプロジェクトはうまくいっていると思います。
Let's put in a lot of time on that project.	このプロジェクトにはたっぷり時間をかけましょう。
I'd like to have this film processed.	このフィルムを現像・焼付けしてください。
I don't want this news to be made public yet.	このニュースはまだ公にしてほしくない。
I don't much feel like working these days.	このところあまり仕事に気乗りがしない。
I don't feel like going out these days.	このところあまり外出する気がしない。
Written, as it is, in easy English, the book is easy to read.	このとおり平易な英語で書かれているのでその本は読みやすい。
This table takes up too much space.	このテーブル、場所を取りすぎるんだ。
I think this table takes up too much space.	このテーブルは場所を取りすぎると思う。
This table takes up too much space.	このテーブルは、場所を取りすぎる。
How much is the tour per person?	このツアーは一人いくらですか。
This size is too large for me.	このサイズは私には大きすぎます。
I know a lot about this computer.	このコンピューターのことはよく知っている。
What does this word mean?	このことばはどういう意味ですか。
This game can be played by young children.	このゲームは幼い子供にもできる。
You will find this game very interesting.	このゲームは面白いと分かるよ。
This case also applies to other cases.	このケースはほかのケースにも当てはまる。
There are fifty members in this club.	このクラブの会員は５０名です。
The club has thirty members.	このクラブには３０人の会員がいます。
There are forty students in our class.	このクラスには生徒が４０にんいる。
What's this key for?	このキーは何の為の物ですか。
Is this camera for sale?	このカメラは売り物です。
This camera is small, but very good.	このカメラは小さいが、大変優れている。
How do you use this camera?	このカメラはどうやって使うの。
This camera was made in Germany.	このカメラはドイツでつくられた。
How much is this camera?	このカメラはいくらですか。
Will you show me how to use this camera?	このカメラの使い方を教えてください。
Would you take a picture of us with this camera?	このカメラで私たちの写真を撮っていただけますか。
If you have not yet paid this bill, please let us hear from you.	このお支払いがまだでしたら、ご連絡ください。
Could you change this bill, please?	このお札を両替してくださいませんか。
Will this amount of money meet your need?	このお金であなたの要求に見合いますか。
Would you take part in this event?	このイベントに参加しませんか。
This house is to let.	このいえは貸し家である。
There are few places to park around here.	このあたりは駐車できるスペースがほとんどない。
There are few houses around here.	このあたりは人家がほとんどない。
The area has been built up since I came here.	このあたりは私がここにきて以来建て込んできた。
Please let me off here.	このあたりで降ろしてください。
The two of them were never to meet again.	この２人は二度と会えない運命だった。
Choose between these two.	この２つから選びなさい。
Turn the light over here, will you?	こっちに明かりをむけてくれないか。
Here is your key.	こちらがあなたの鍵だ。
The fewer, the better.	ごちそうは小人数ほどよい。
There are a lot of places to see around here.	ここら辺には見るべきところがたくさんあります。
Come here! I mean you.	ここへ来なさい。君のことだ。
Put down your name and address here.	ここへ住所と名前をお書きください。
Let's set up a sign here.	ここへ看板を立てよう。
It always leads me here.	ここへとぼくを導いてくれる。
Koko continued to learn fast.	ココは速やかに学び続けた。
This is the house where I was born.	ここは私の生まれた家です。
This is where I was born and brought up.	ここは私が生まれ育ったところです。
This is the house where I was born.	ここは私が生まれた家です。
What's the name of this street, please?	ここは何という通りですか。
It's very hot here.	ここはとても暑い。
Testing Koko's IQ is not easy.	ココの知能指数を調べるのは容易ではない。
Please put your name and address, please.	ここに住所とお名前をお願いします。
Put down your name and address here.	ここに御住所とお名前をお書きください。
May I put it down here?	ここに下ろせばいいのか。
It has been over three years since I moved here.	ここに引っ越してから３年以上になる。
Is it possible to be here a little longer?	ここにもう少しいることができますか。
There are no less than five hundred students here.	ここには少なくても５００人の学生がいる。
Could you tell me what to put here?	ここには何を書けばよいか教えていただけますか。
Could you tell me what to put here?	ここには何を記入したらよいか教えてくださいますか。
Who put this paper here?	ここにこの新聞を置いたのは誰でしたか。
Here is a picture to show you.	ここにあなたに見せる写真がある。
Here is a new magazine for you to read.	ここにあなたがお読みになる新しい雑誌があります。
I have five here and as many again.	ここに５個ともう５個持っています。
Are we allowed to take pictures here?	ここで写真を撮ってもよろしいですか。
Can I take pictures here?	ここで写真を撮ってもいいでしょうか。
Let's take a picture here.	ここで写真をとりましょう。
Let's get off here.	ここで降りましょう。
Let's take a break now.	ここで休憩にしましょう。
Put it there, not here.	ここではなくあそこに置きなさい。
Let's watch TV here.	ここでテレビを見ましょう。
Watch TV here.	ここでテレビを見なさい。
I didn't think I'd meet you here.	ここでお目にかかれるとは思ってもいませんでした。
This is the house where he was born.	ここが彼の生まれた家です。
Could you tell me how to get to Park Street from here?	ここからパーク通りにどうやって行くのか教えていただけますか。
This is the main street of this city.	ここがこの都市の中心部です。
Gordon is interested in the Japanese way of life.	ゴードンは日本の生活様式に興味を持っている。
This change will make your plan more interesting.	こう変えたら君のプランはもっと面白くなるでしょう。
This work would do credit to a professional.	こういった仕事は、プロの誇りとなるだろう。
Experience talks in these cases.	こういう場合には経験が物を言う。
This was why he entered the university.	こういうわけで、彼はその大学に入学した。
Ken must run fast.	ケンは速く走らなければいけない。
Ken runs fastest of the three.	ケンは三人のなかでもっとも速く走ります。
Ken studied English last night.	ケンは昨晩英語を勉強しました。
Ken has never been to New York.	ケンはニューヨークへ行ったことがない。
Ken runs faster than you.	ケンはあなたよりも速く走ります。
Ken's story was as follows.	ケンの物語は次のとおりでした。
Ken's turn came.	ケンの順番が来た。
Pam doesn't use the word "drive", however.	けれども、パムは「運転する」という言葉は使いません。
Never play here.	けっしてここで遊んではいけない。
How did you feel about the game?	ゲームについてのご感想は？
Where can I find a good gay club?	ゲイのクラブを推薦してください。
Kate talked over the picture with Brian.	ケイトはブライアンとその絵について語った。
Kate is majoring in German.	ケイトはドイツ語を専攻している。
Kate has a good figure.	ケイトの容姿は素晴らしい。
From Kate's point of view, he works too much.	ケイトから見ると、彼は働き過ぎである。
Christmas is a special holiday.	クリスマスは特別な休日だ。
Christmas comes a few days before New Year.	クリスマスは新年の数日前にめぐってくる。
Did you buy her something for Christmas?	クリスマスに彼女に何か買ってあげたの？
Is there practice every day?	クラブ活動は毎日ありますか。
Every member of the club was present.	クラブの全員が出席していた。
Each and every member of the club was present.	クラブ会員は１人残らずみな出席していた。
There are 50 members in the club.	クラブのメンバーは５０人です。
Will you join our club?	クラブに入りませんか。
Those who want to join the club should sign here.	クラブに入りたい人は、ここに名前を書いて下さい。
Our class has forty-five students.	クラスには４５人生徒がいる。
Kumiko runs as fast as Tom.	クミコはトムと同じくらい速く走ります。
Cuzco is one of the most interesting places in the world.	クスコは世界でもっとも興味深い場所のひとつである。
Sunday is a holiday in Christian countries.	キリスト教国では日曜日は休業日である。
Christ was born in 4BC.	キリストは紀元前４年に生まれた。
Were there any interesting topics in today's history class?	きょうの歴史の授業で何か面白い話題はありましたか。
Did Cathy go, too?	キャシーも行きましたか。
Is this getting you going too?	きみもゾクゾクきてるかい？
You didn't join that club, did you?	きみはそのクラブに入らなかったんだね。
You will be in charge of the babies in this room.	きみはこの部屋の赤ちゃんたちを担当してもらいます。
What time is it now by your watch?	きみの時計で今何時ですか。
It follows from what you say that he was not there.	きみの言っていることからすれば、彼はそこにいなかったことになる。
You must have been working too hard.	きっと働きすぎですよ。
Don't be so hard on me.	キツイなあ。
Let's go back the way we came.	来た道を戻りましょう。
Bring me the key.	キーを持ってきて。
Get me the key.	キーを取って。
We joined the country club.	カントリークラブに入った。
It's the place that has all of Gulfport talking.	ガルフポート中で話題のお店です。
I should've brought my camera.	カメラを持ってくればよかった。
There's no point in taking a camera.	カメラを持っていっても無駄だ。
Do you have a camera?	カメラを持っていますか。
Watch the camera for me while I make a phone call.	カメラを見ていてね。電話をかけてくるから。
Watch my camera for me.	カメラを見ていてね。
Are you bringing your camera?	カメラは持っていくのですか。
How many cameras do you have?	カメラはいくつお持ちですか。
We had to make a very early start.	かなり早い時間に出発しなければならなかった。
Canada is on the north side of America.	カナダはアメリカの北側にある。
I told you never to move in a group.	かたまって行動するなと言ったんだ。
Would you help me look for my keys?	かぎを捜すのを手伝っていただけませんか。
Is this your interesting book?	これがあなたの面白い本ですか。
Charge it, please.	カードでお願いします。
May I talk to you?	お話ししてもよいですか。
Can we talk?	お話ししたいことがあります。
I have something to tell you.	お話があるのですが。
Can we have a talk?	お話があるのですが。
Bring your friends with you.	お友達を連れていらっしゃい。
I'm pleased to meet you.	お目にかかれて嬉しい。
I'm very pleased to meet you.	お目にかかってたいへんうれしい。
You may go if you choose.	お望みならいってもいいですよ。
Old people get up very early.	お年寄りはとてもはやく起きる。
I'm not in a position to answer.	お答えできる立場にありません。
Don't use all the hot water.	お湯を全部使わないで。
The hot water isn't running.	お湯が出ません。
What's the name of that store again, please?	お店の名前をもう一度お願いします。
Please let us know.	お知らせください。
Let me take you home.	お宅にお送りしましょう。
Please feel free to have a second helping.	お代わりをどうぞご遠慮なく。
Did you get the package I sent you?	お送りした小包、受け取りましたか。
I think that you'll like it, too.	お前も好きになると思うよ。
I brought you up under my personal care.	お前はわしが手塩にかけた人間だ。
You are not a child any more.	お前はもう子供ではない。
You are two-faced.	お前のすることには裏表がある。
I'm no match for you.	お前にはかなわないよ。
Can't you hear the sound?	お前にはあの音が聞こえないのか。
You talk so fast I can't understand a word you say.	お前、早口だから、何言ってるんだか全然分からないよ。
Could you bring me some water?	お水を持ってきてください。
Let me take care of that for you.	お手伝いしましょうか。
Let me help you.	お手伝いしましょう。
Don't be too hard on me, please.	お手柔らかにお願いします。
A young person wants to see you.	お若いかたがあなたにお会いしたいそうです。
Bring your children with you.	お子さんを連れて行きなさい。
How many children do you have?	お子さんは何人おありですか。
How old are your children?	お子さんたちはおいくつですか。
Do you have any children?	お子さんがおありですか。
Let's try to understand one another.	お互いを理解し合うようにしようではありませんか。
To understand each other is important.	お互いに理解しあうことは大切なことです。
We should not make too much of money.	お金を重視するのは良くない。
I have a lot of money.	お金をたくさん持っている。
You should turn money to good use.	お金はよく考えて使いなさい。
Money, as such, has no meaning.	お金それ自体は何の意味もないものだ。
Since we have no money, it's no use thinking of a holiday.	お金が無いのだから、休日のことを考えても無駄だよ。
Love is as important to me as money is to her.	お金が彼女に大切なのと同じだけ私には愛が大切だ。
I am running short of money.	お金が足りなくなってきている。
I have run short of money.	お金がなくなってしまった。
I am short of money.	お金がなくなった。
How was your holiday?	お休みはどうでしたか。
I know how you feel.	お気持ちはよく理解できます。
Welcome home.	お帰りなさい。
Here is your bill.	お勘定です。
I've heard a lot about you.	お噂は聞いています。
I've heard a lot about you.	お噂はうかがっております。
I have something to live for in music.	おんがくにわたしは生きがいを持っています。
If it is interesting, any book will do.	おもしろければどんな本でもいいですよ。
Let me tell you something.	面白い話を聞かせてあげようか。
Any book will do, so long as it is interesting.	おもしろいならどんな本でもよい。
I don't want to see your faces.	おまえらの顔なんか見たくもない。
Now that you are no longer young, you must think of your future.	おまえはもう若くないのだから将来のことを考えなければならない。
You are no longer a child.	おまえはもう子供じゃないんだ。
It's to see your face well.	おまえの顔をよく見るためだよ。
The office was closed for 10 days for the New Year's holiday.	オフィスが正月休みで１０日間閉まっていました。
Each building has a name.	おのおのの建物には名前がある。
I really understand what you mean.	おっしゃることは良く分かります。
There are many interesting animals in Australia.	オーストラリアには多くのおもしろい動物がいる。
Elmore James got nothin' on this, baby.	エルモア・ジェイムズのコピーじゃないぜ。
Let me see.	えっと。
Let's see. I bought it last week.	ええと、買ったのは先週でした。
Oh, two nights, please.	ええと、２泊です。
Let me see. There were fifteen people.	ええっと、１５人でした。
Oh, it's just that I never meet any interesting men.	ええ、その、面白い男性にぜんぜんめぐり合えなくてねぇ。
There were six children in the Evans family.	エヴァンス一家には子供が６人いました。
Oh, just over the holidays.	うん、休みが終わるまででいいの。
The car is acting up again.	うちの車はまた故障した。
Our children all go to the local school.	うちの子供は全員地元の学校に通っています。
We have only a small garden.	うちには小さな庭しかない。
India is now short of food.	インドは今、食料が不足している。
Different languages are used in different places in the world.	いろいろな言語が世界のいろいろな場所で使われている。
It was her turn at last.	いよいよ彼女の番になった。
In fact, he even loved her.	いや実際、彼は彼女を愛してさえいた。
Not really. What's up?	いやそれほどでもないよ。何か用かい？
Some ships are going out now.	いま出ていく船がいくつかあります。
There's no turning back now.	いま引き返せっていっても無理だ。
I have never been to Nikko.	いままでに日光に行ったことがない。
With time on our hands now, let's do some good.	いまは時間が手中にあるのだから、何かいいことをしよう。
A child today would not do that.	いまどきそんなことは子供だってしないだろう。
What movies are playing now?	いま、何を上映していますか。
When were you born?	いつ生まれましたか。
Please let me know when you will come to Kobe.	いつ神戸に来るのか教えて下さい。
When did you buy the watch?	いつ時計を買ったの。
When can you let me know the result?	いつ頃連絡をもらえますか。
When was it built?	いつ建てられたのですか。
I always keep my word.	いつも約束を守っているだろ。
You should always keep your word.	いつも約束は守るべきだ。
He is always full of power.	いつも彼は活力がみなぎっている。
I always study hard.	いつも頑張って勉強してるよ。
Some children play video games all the time.	いつもテレビゲームをしている子どもが居る。
I always wanted to see you.	いつもあなたに会いたいと思っていました。
So, when are you going to break down and buy a house?	いつになったら家を買うつもりなの？
When and where did the war break out?	いつどこでその戦争は起きたのですか。
You will always find a good friend in me.	いつでも力になります。
I'm always at your service.	いつでも私にお申しつけ下さい。
I'm always on call at home.	いつでも家で待機しています。
There is always something to do.	いつでも何かしら仕事がある。
Please feel free to ask a question at any time.	いつでも遠慮せずに質問して下さい。
We can always find time for reading.	いつだって読書の時間は見つけられる。
Can she have broken off with them?	いったい彼女は彼らとの関係を断ったのだろうか。
What in the world does he mean?	いったい彼はどういうつもりなのだ。
Can Bill still be at home?	いったいビルはまだ家にいるのでしょうか。
What in the world does he mean?	いったいぜんたい彼はどういうつもりなのか。
Can these books really be of any use to young people?	いったいこの本は若者のためになるのだろうか。
When are they going to put the book on the market?	いつその本は売りに出るんだい。
When will the law go into force?	いつその法律は施行されますか。
Tell me when you first saw the island.	いつその島をはじめて見たか教えて下さい。
When did you get to know the fact?	いつその事実を知るようになりましたか。
When did you see the film?	いつその映画を見たのですか。
When did you hear the news?	いつそのニュースを聞いたのですか。
Let's study hard and become great men.	いっしょうけんめい勉強して、立派な人になりましょう。
When will you give me your answer?	いつごろ返事をいただけますか。
I would like to see you again some day.	いつかまたあなたにお会いしたいものです。
When and where did you receive the gift?	いつ、どこでその贈り物を受け取ったのですか。
There are a lot of old cities in Italy. Rome and Venice, for example.	イタリアには多くの古い都市がある。例えばローマとかベネチアだ。
You shall hear more from me by the next mail.	いずれ後便でくわしく申し上げます。
I will call on you again.	いずれ改めてお伺いいたします。
At any rate, we have no means of helping him.	いずれにしても、彼を助ける手段はない。
I've called and called, but there's no answer.	いくら呼んでも返事がない。
You can't study too hard.	いくら一生懸命勉強しても勉強しすぎることはない。
However hard he worked, he did not become any better off.	いくら一生懸命働いても、彼の暮らしは少しも良くならなかった。
One is never too old to learn.	いくつになっても学ぶことはある。
I have some questions to ask, but I don't want to bother you now.	いくつか聞きたい事があるが今はあなたを煩わせたくはない。
May I ask some questions?	いくつか質問してもいいですか。
The British government is against the plan.	イギリス政府はその計画に反対です。
Take England for example.	イギリスを例にとって見よう。
Any amount of money will do.	いかほどの金額でも結構です。
How to live is an important question for young people.	いかに生きるべきかは、青年にとって重要な問題である。
That's Bill all over.	いかにもビルのやりそうなことだ。
No student is allowed to enter the room.	いかなる生徒もその部屋に入ることは許可されていない。
Turning around, Jesus saw them following and asked, "What do you want?"	イエスは振り向き、彼らがついてくるのを見て言われた、「何か願いがあるのか」。
Jesus was born of Mary.	イエスはマリアから生まれた。
Jesus answered them.	イエスは、彼らに答えて言われた・・・。
He tried harder to get good marks than I did.	いい点を取ろうと彼は私より努力した。
I think you're on the right track.	いい線いってるよ。
It sounds great!	いい案だ！
I learned a lot from what I heard.	いいこと聞いたわ。それって勉強になったわ。
I bought a good camera.	いいカメラを買った。
No, she has never fallen in love.	いいえ、彼女は一度も恋をしたことがありません。
No, I've never been there.	いいえ、行ったこと無いです。
No, I haven't written it yet.	いいえ、まだ書いていません。
No, not too much.	いいえ、あまり降りません。
I like the sound of what he says, but it IS just talk, you know.	あんな調子のいいこと言っておいて、ホント口ばっかりなんだから！
You have a good camera.	あんたはよいカメラを持っていますね。
Are those your pictures?	あれらはあなたの絵ですか。
They move from place to place.	あれらはあちこちへと移動していきます。
It was so hard, I tell you.	あれは本当につらかったよ。
Is that a picture of me?	あれは僕の写真？
That is the house where I was born.	あれは私が生まれた家だ。
That is a high building, is it not?	あれは高い建物ですね。
That is an old camera.	あれは古いカメラだ。
What a big ship that is!	あれはなんて大きい船なんだろう。
Alex will answer, "Color!"	アレックスは「色」と答えるのである。
That amount of food will last them for a week.	あれだけの食料があれば、彼らは１週間持つだろう。
That is the main street of this city.	あれがこの町の大通りだ。
One day I met him.	ある日、私は彼に会った。
One of the children asked one day: "Where do babies come from?"	ある日、子供達の一人が尋ねました。「赤ちゃんはどうやってできるの？」
It is very hard to tell what country a person comes from.	ある人物がどこの出身であるかを言い当てるのは非常に難しい。
The fact that a man lives on the same street with me does not mean he is my friend.	ある人が私と同じ通りに住んでいるということは、その人が私の友人だということではない。
Today is my second day of my side job.	アルバイトを始めて今日で２日目です。
I made a lot of money on the side.	アルバイトで金を儲けたんだ。
Alice wasn't present at the meeting, was she?	アリスは会議に出席していませんでしたね。
All possible means have been tried.	あらゆる可能な手段をつくしてみた。
We tried all means possible.	あらゆる可能な手段を選びました。
Arabic is a very important language.	アラビア語は非常に重要な言葉です。
Many Americans like fast cars.	アメリカ人は速く走る車の好きな人が多い。
We met in the American history class.	アメリカ史の授業で会ったことがあります。
America is a country on the move.	アメリカは動いてる国である。
America is a large country and its people are mobile.	アメリカは国土が広く、人々はよく移動する。
Many American students work their way through the university.	アメリカの学生の中には苦労して働きながら大学を出る者が多い。
In America, cars drive on the right side of the road.	アメリカでは、車は右側通行です。
We have received many orders from the U.S.	アメリカからたくさん注文がきている。
I understand you're visiting from America.	アメリカからいらっしゃっているそうですね。
It is too hot to work.	あまり暑いので働けない。
You don't look so hot.	あまり元気じゃないようだね。
Not too well.	あまり具合がよくありません。
Those officials don't understand finance at all.	あの役人たちは全然、財政のことはわかっていない。
That problem has really got me.	あの問題には参ったよ。
I am very pleased to meet them.	あの方たちに大変うれしいです。
It looks like they have made up again.	あの二人はよりを戻したらしい。
They are too close.	あの二人はどうも怪しい。
They mark down goods at that shop.	あの店では商品を値下げして値段がつけてある。
They short-changed me at that store.	あの店でおつりをごまかされた。
Keep watch on that man.	あの男を見張っていて下さい。
Watch out for that man.	あの男に用心しなさい。
He was living in England when the war broke out.	あの戦争が起こった時彼は英国にいた。
Look at that red building.	あの赤い建物を見なさい。
That student is Tom.	あの生徒がトムです。
They have been working on the new building.	あの人達は新しいビルの建築に従事してきたのです。
He is not very fast at making friends.	あの人は友達をつくることがあまり速くない。
He is watching my every move.	あの人は私の一挙一動を見守っている。
That person will be read out of our club.	あの人はクラブから除名される。
People notice every move he makes.	あの人の一挙手一投足が注目の的です。
Let's ask him.	あの人に頼んでみよう。
How long is it since you heard from him?	あの人から手紙をもらってどれくらいになりますか。
How hard he works!	あの人、ほんとによくはたらくこと！
Follow that car.	あの車を追ってくれ。
Please take a look at that picture.	あの写真を見てください。
Who will hear the case?	あの事件は誰が審理するのですか。
He is very mean to me.	あの子は私に意地悪するよ。
Are you done with that magazine?	あの雑誌はもうすみましたか。
We were younger then.	あの頃の我々はもっと若かった。
Look at that building.	あの建物を見て。
That building is our school.	あの建物は私たちの学校です。
What's that building?	あの建物は何ですか。
Those students work hard, don't they?	あの学生たちはよく勉強するね？
Look at that picture.	あの絵を見てごらん。
Have a look at that picture.	あの絵をちょっと見てごらん。
That company just put up a web page.	あの会社もついにホームページを立ち上げたらしい。
That company puts out a magazine, doesn't it?	あの会社は雑誌を発行するんですよね。
You should have seen the movie.	あの映画は見るべきだったね。
You should have seen the film.	あの映画を君は見るべきだったね。
They say that the movie is an interesting one.	あの映画は面白いのだそうだ。
That movie was really moving.	あの映画はとても感動的だった。
That movie was shown on TV.	あの映画はテレビでした。
How did you like that movie?	あの映画はいかがでしたか。
Is that radio program still on the air?	あのラジオ番組はまだ続いていますか。
It is only a few months since that Frenchman came to Japan.	あのフランス人は日本にきてわずか数ヶ月です。
Look above that building.	あのビルの上を見てごらん。
How high is that building?	あのビルはどのくらい高いのですか。
It's next to that building.	あのビルのとなりです。
No man lives in the building.	あのビルには誰も住んでいないよ。
Let me have a look at that book of Tom's.	あのトムの本をちょっと見せてください。
The show was very interesting. You should have seen it.	あのショウは面白かった。君にも見せてあげたかったよ。
What did you do with that camera?	あのカメラはどうしましたか。
The Englishman likes doing better than talking.	あのイギリス人は語ることよりも実行することが好きだ。
You must talk to her in person.	あなた本人が彼女に話さなければならない。
I hear you Americans like to move from place to place.	あなた方アメリカ人はあちこち引っ越すのが好きだそうですね。
I'm on your side.	あなたを支持します。
I never see you without thinking of Ken.	あなたを見ると必ずケンのことを思い出す。
I was born to love you.	あなたを愛する為に私は生まれた。
I can never make you out.	あなたをさっぱり理解できない。
I meant to have called on you.	あなたをお尋ねするつもりだったのですが。
Do you have to go to market, too?	あなたも買い物に行かなければならないの。
Both you and I are students.	あなたも私も学生です。
Wouldn't you like to come with us, too?	あなたも私たちと一緒にいらっしゃいませんか。
You have a watch.	あなたは腕時計を持っています。
Which period of history are you studying?	あなたは歴史のどの時代を研究していますか。
You must not go out at night.	あなたは夜外出してはならない。
Are you reading an interesting book?	あなたは面白い本を読みますか。
Didn't you hear your name called?	あなたは名前を呼ばれたのが聞こえなかったのですか。
You have only to practice every day.	あなたは毎日練習しさえすればよい。
You tried very hard every day.	あなたは毎日とても一生懸命に努力した。
Do you really want it?	あなたは本当にそれがほしいですか。
You have a lot of books.	あなたは本をいっぱい持ってますね。
You must have known what she meant.	あなたは彼女の気持ちがわかっていたに違いない。
All you have to do is to meet her.	あなたは彼女に会いさえすれば良い。
You only have to follow him.	あなたは彼に付いて行きさえすればいいです。
You must take into account the fact that he is too young.	あなたは彼が若すぎるという事実を考慮に入れなければならない。
Are you always at home in the evening?	あなたは晩にはいつもご在宅ですか。
You look young for your age.	あなたは年の割に若く見える。
You only have to work hard.	あなたは熱心に勉強しさえすればよいのです。
You must not come to meet me again.	あなたは二度と私に会いに来てはならない。
You must watch your step all the way.	あなたは途中ずっと足元を見なければいけません。
You need a change of air.	あなたは転地療養が必要だ。
You don't have to get up early.	あなたは朝早く起きる必要がない。
Who do you want to talk to?	あなたは誰と話したいの？
Who are you? Give us an answer to take back to those who sent us.	あなたは誰ですか。私たちを遣わした人々に返事がしたいのです。
You run very fast.	あなたは大変速く走る。
You used to do so when you were a university student.	あなたは大学生の頃はそうしてたもの。
What did you major in at college?	大学では何を専攻されましたか。
You do not have to run fast.	速く走らなくてもいいんだよ。
Can you run fast?	あなたは速く走ることが出来ますか。
You get up early, don't you?	あなたは早起きでしょうね。
You have to get up early.	あなたは早く起きなければなりません。
You are just the same as you always were.	あなたは昔と全然変わっていない。
You are not a student.	あなたは生徒ではありません。
Are you a new student?	新入生の方ですか？
You are the most important person of us all.	あなたは私達の中で最も重要な人だ。
You can understand me.	あなたは私を理解できますね。
You have more energy than I.	あなたは私より活力がある。
You are not as short as I.	あなたは私ほど背が低くない。
You are not shorter than I.	あなたは私ほどに背は低くない。
You have only to watch what I do.	あなたは私のすることを見てさえいればいい。
Did you see my camera?	あなたは私のカメラを見ましたか。
What do you mean to say to me?	あなたは私に何を言おうとしているのですか。
All you have to do is follow me.	あなたは私についてきさえすればよい。
Can you supply me with all I need?	あなたは私が必要としているものすべてを私に供給できますか。
You should have seen that movie last night.	あなたは昨晩あの映画を見るべきだったのに。
Did you drive her home last night?	あなたは昨晩、彼女を家まで車で送りましたか。
Were you home last night?	あなたは昨日の夜、家にいた？
You have only to answer the first question.	あなたは最初の問いに答えさえすればよい。
You'll have to study harder from now on.	あなたは今後もっと懸命に勉強しなければならないだろう。
You are not watching TV now.	あなたは今テレビを見ていません。
It is better for you to act by legal means.	あなたは合法的手段で行動する方がよい。
Are you a high school student?	あなたは高校生ですか。
You're dating a Keio university student, aren't you?	あなたは慶応の学生といつもデートしているのね。
You have a good memory.	あなたは記憶がよい。
You made an error.	あなたは間違えました。
Are you a student?	あなたは学生ですか。
You are a very good artist.	あなたは絵が上手ですね。
Are you content with your position in the company?	あなたは会社での地位に満足していますか。
Where did you put our key to the house?	あなたは家の鍵をどこに置きましたか。
What sign were you born under?	あなたは何座生まれですか。
What subject do you major in?	あなたは何の科目を専攻しているのですか。
What are you interested in?	あなたは何に関心が有るのですか。
How fast you run!	あなたは何と速く走るのでしょう。
Do you have any animals?	あなたは何か動物を飼っていますか。
Are you interested in music?	あなたは音楽に興味がありますか。
You need to work very hard.	あなたは一所懸命働かないといけない。
You must study English hard.	あなたは一生懸命英語を勉強しなければならない。
Would you like a single room?	あなたは一人部屋が好きですか。
All you have to do is to make a comment.	あなたは意見を述べさえすればよい。
Did you hear the news on the radio?	あなたはラジオでそのニュースを聞きましたか。
You've never been to Europe, have you?	あなたはヨーロッパに行ったことが一度もないのですね。
Did you get good marks?	あなたはよい点数をとりましたか。
You have to study Japanese harder.	あなたはもっと熱心に日本語を勉強しなければなりません。
All you have to do is study harder.	あなたはもっと一生懸命勉強しさえすればいいのです。
You should study English harder.	あなたはもっと一生懸命に英語を勉強すべきです。
You are no longer a baby.	あなたはもう赤ちゃんじゃないんですよ。
Now that you are well again, you can travel.	あなたはもう健康が回復したのだから旅行に行けます。
Have you heard the news yet?	あなたはもうそのニュースを聞きましたか。
You're still young.	あなたはまだ若い。
There is no need for you to go yet.	あなたはまだ行く必要がありません。
You've never been to Paris?	あなたはパリに行ったことがないのでしょう。
Why do you talk about him as if he were an old man?	あなたはなぜ彼のことをまるで老人であるかのように話すのか。
Which club do you want to join?	あなたはどのクラブに入りたいですか。
Which way did you choose?	あなたはどちらの道を選びましたか。
Who did you meet?	あなたはだれに会ったのですか。
Do you have a lot of time?	あなたはたくさん時間がありますか。
You don't have to get up so early.	あなたはそんなに早く起きる必要はない。
You don't have to work so hard.	あなたはそんなに一生懸命に働く必要はない。
You won't have to take charge of that.	あなたはそれを担当する必要はないだろう。
You may choose any of them.	あなたはそれらのうちのどれを選んでもよい。
Are you in agreement with the new law?	あなたはその新しい法律に賛成ですか。
You need to answer the question.	あなたはその質問に答える必要がある。
Where did you come by the watch?	あなたはその時計をどこで手に入れたのですか。
Do you know when the event took place?	あなたはその催し物がいつ行われたか知っていますか。
You should have seen the picture.	あなたはその絵を見るべきだったのに。
Are you planning to take part in the meeting?	あなたはその会合に出席する予定ですか。
Did you hear the news?	あなたはそのニュースを聞きましたか。
Do you know who brought that team into being?	あなたはそのチームを誰が生み出したか知っていますか。
Are you for or against this?	あなたはこれに賛成ですか、反対ですか。
You mustn't park the car in this street.	あなたはこの通りに駐車させてはいけない。
Are you going to pay a visit to China this fall?	あなたはこの秋中国を訪れるつもりですか。
You don't have to answer this question.	あなたはこの質問に答える必要はない。
How do you account for this fact?	あなたはこの事実をどう説明しますか。
Do you have something to do with this group?	あなたはこのグループと何か関係があるんですか。
Do you know how to use this camera?	あなたはこのカメラの使い方を知っていますか。
What did you do with your camera?	あなたはカメラをどうしましたか。
Do you have a camera?	あなたはカメラを持っていますか。
You know many interesting places, don't you?	あなたはおもしろい場所をたくさん知っていますね。
Were you younger than Ellen?	あなたはエレンより若かったですか。
You are welcomed in our class.	あなたはうちのクラスで歓迎されています。
When were you born?	あなたはいつ生まれましたか。
You always called me from her house.	あなたはいつも彼女の家から電話してきたわ。
You will be welcome at any time.	あなたはいつでも歓迎されています。
You should apply for that post.	あなたはあの勤め口に申し込むべきだ。
Do you have something to do with that company?	あなたはあの会社に何か関係があるのか。
You have never been to Okinawa, have you?	あなたは１度も沖縄に行ったことがありませんね。
You should turn in your paper by next Saturday.	あなたは、来週の土曜日までに論文を提出すべきです。
Are you a student of a private high school?	あなたは、私立高校の生徒ですか。
Did you use my camera?	あなたは、私のカメラを使いましたか。
Go on with your story. That is so interesting!	あなたの話を続けなさい。それはとても面白い。
I can't follow you.	あなたの話には付いていて行けません。
May I ask you some questions about your name?	あなたの名前についていくつか質問してもいいですか。
To your future!	あなたの未来に乾杯！
I never thought of coming to your place.	あなたの部屋に来るなんて思ってもいなかった。
It's your turn. Please come this way.	あなたの番です。どうぞこちらへ来てください。
Your answer is not to the point.	あなたの答えは要領を得ていない。
Compare your answer with Tom's.	あなたの答えとトムの答えと比較しなさい。
Your student called me.	あなたの生徒は私に電話をした。
I have to put down your new address.	あなたの新しい住所を書き留めなくては。
Let me know your new address.	あなたの新しい住所を私に知らせてください。
Let me know your new address.	あなたの新しい住所を教えてください。
Let me know your address.	あなたの住所を知らせてください。
May I take a picture of you?	あなたの写真を撮らせてもらってもいいですか。
May I take your picture?	あなたの写真を撮ってもいいですか。
Can I keep one of your pictures?	あなたの写真を１枚持っていてもいいですか。
Your question is very hard to answer.	あなたの質問は答えるのが非常に難しい。
Your question is hard to answer.	あなたの質問は答えにくい。
What time is it by your watch?	あなたの時計は何時ですか。
What time is it now by your watch?	あなたの時計では今何時か。
Your watch has been found.	あなたの時計はみつかった。
Does your watch keep good time?	あなたの時計、時間は狂いませんか。
Let me help you to do the work.	あなたの仕事の手助けをさせて下さい。
Tell me something about your country.	あなたの国について私に何か教えて下さい。
You may choose any book you like.	あなたの好きな本はどれでも選んでよい。
He is always at your back.	あなたの後ろにはいつも彼がいる。
I don't understand what you are talking about.	あなたの言っていることがわかりません。
What you said does not apply to this case.	あなたの言ったことはこの場合当てはまらない。
I understand what you mean.	あなたの言うことは分かります。
May we know your bank account?	あなたの銀行口座を教えていただけますか。
How many students are there in your school?	あなたの学校には何人の生徒がいますか。
Could you tell me something about your school?	あなたの学校について私に何か教えて頂けませんか。
Your English is too good to be in this class.	あなたの英語はよいのでこのクラスにいる必要はない。
I've heard about you.	あなたの噂は伺っています。
I want you to live more like a human being.	あなたのもっと人間らしく生きてほしい。
You can have any picture that you want.	あなたのほしい絵はどれでも持っていってよい。
I don't mean you.	あなたのことをさして言っているのではない。
I've heard a lot about you.	あなたのことはかねがね聞いておりました。
That sounds very interesting.	あなたのお話では、それはたいへん面白そうですね。
I can't hear you very well.	あなたのおっしゃることがよく聞こえません。
Your order has been submitted.	あなたのオーダーは提出されました。
You can say that again.	あなたのいう通りですよ。
What you say does not bear on our problem.	あなたのいう事は私たちの問題とは関係がない。
Let me give you an example.	あなたに例を示しましょう。
I'm about to tell you the answer.	あなたに返事をしようとしているところです。
I have something to talk over with you.	あなたに相談したいことがある。
I meant to have written to you.	あなたに手紙を書くつもりだったのだが。
May I ask you a question?	あなたに質問してもいい。
Might I ask you a question?	あなたに質問をしてもいいですか。
I am sending you a picture of my family.	あなたに私の家族の写真を送るつもりだ。
I am pleased to see you again.	あなたに再会できてうれしい。
I have something to tell you.	あなたに言うべきことがあります。
It's great to meet you.	あなたに会えてとてもうれしい。
I will show you some pictures.	あなたに何枚かの写真を見せましょう。
Shall I give you something to read?	あなたに何か読むものをあげましょうか。
I ask you a question.	あなたに一つお尋ねします。
You heard from him?	あなたには彼から手紙がきた？
How many children do you have?	あなたには何人子供がいますか。
I shall let you see that.	あなたにそれを見せてあげましょう。
I have something good to tell you.	あなたにお話しするよいことがあります。
I would like to tell you something.	あなたにお話があるのですが。
I have something to give you.	あなたにあげる物があります。
May I ask you a question?	あなたに１つ質問しても、よろしいですか。
Who is it that you want to talk to?	あなたが話をしたがっていたのは誰ですか。
What do you figure on this?	あなたなら、これをどう考えますか。
There's something I need to talk with you about.	あなたと話しあいたいことがあります。
I am no more an artist than you are.	あなたと同様私も芸術家ではないのです。
There is no time like the time when you and I were young.	あなたと私とが若かった時のような時代が今はもうない。
I liked you even more when I met you.	あなたと会って、より一層あなたのことが、好きになりました。
I have something to talk over with you, face to face.	あなたとじかに会ってじっくり話したいことがあるのです。
May I talk with you?	あなたとお話ししていいですか。
May I have a talk with you?	あなたとお話ししたいことがあるのですが。
Are you students?	あなたたちは学生ですか。
Have you met each other?	あなたたち、前に会ったことある？
Who do you want to talk to?	あなたが話をしたいのは誰なの？
Who is the man that you were talking with?	あなたが話していた人はどなたですか。
Let me know the days when you can come.	あなたが来られる日を教えて下さい。
If you care to come, you will be welcome.	あなたが来たいというのなら大歓迎です。
What is it that you really want to say?	あなたが本当に言いたい事は何ですか。
Your help will save us a lot of work.	あなたが手伝ってくれれば、大いに手間が省ける。
If you help me, I'll try it again.	あなたが手伝ってくださるなら、私はもう一度やってみます。
It's your turn to answer the question.	あなたが質問に答える順番です。
When was it that you first met her?	あなたが始めて彼女に会ったのはいつでしたか。
It follows from what you say that he was not there.	あなたが言っていることからすれば、彼はそこにいなかったことになる。
I didn't hear what you said.	あなたが言ったことが聞こえなかったよ。
I can't study with you watching me.	あなたが見つめていては、勉強できないよ。
Tell me what you mean.	あなたが何を言いたいのか、話しなさい。
Let me see the pictures you took in Paris.	あなたがパリで撮った写真を見せて下さい。
Did you talk for a long time?	あなたがたは長い間話しましたか。
What is it that you really want to say?	あなたがおっしゃりたいことは、いったい何ですか。
Please bring my book up when you come.	あなたが２階へ来るとき私の本を持ってきてください。
Your plan to buy another PC is out of the question.	あと一台パソコンを購入する君の案はまったく問題にならない。
We could really use another person around here.	あと一人、いればなあ。
Let's check that shop, too.	あっちの店も見てみよう。
I will buy a watch at the store.	あたしはその店で時計を買うつもりです。
You will see a red house over there.	あそこに赤い家が見えるでしょう。
Can you see the big white building over there?	あそこに大きな白いビルが見えるでしょう。
Just step right over there.	あそこに進んでください。
You can ask the child who's playing over there.	あそこで遊んでいる子供に聞いてごらんなさい。
The students studying over there are my friends.	あそこで勉強している学生は私の友人です。
That's the house where Tom was born.	あそこがトムの生まれた家です。
I am interested in Asian history.	アジアの歴史に興味があります。
He should have worked harder.	あいつはもっと熱心に頑張るべきだったのに。
He is a jack-of-all-trades.	あいつの多芸は無芸のたぐいだ。
Don't take any notice of what he says.	あいつの言うことなんか気にするな。
I've done with him for the future.	あいつとは今後関係がない。
Oh? I want to see him, too.	ああそう、僕も彼に会いたいね。
Archie made a move on her.	アーチーは彼女に言い寄った。
If he goes on like that, he will never amount to much.	ああいう風ではたいした者になれまい。
Break off with such a man as that.	ああいう男とは縁を切れ。
Do you like SF movies?	ＳＦ映画は好きですか。
Can you direct me to NHK?	ＮＨＫへの行き方を教えていただきませんか。
The movie K-9 is showing.	Ｋ―９が上映中です。
Long on A and short on B.	Ａは十分にあるがＢは足りない。
The ABC company is in the red again.	ＡＢＣ会社はまた赤字だ。
Welcome to the management team at ABC Japan.	ＡＢＣジャパンの経営チームにようこそ。
Few people live to be ninety years old.	９０歳まで生きる人は少ない。
I'll meet to you at eight.	８時にお会いしましょう。
Not a few people live to be over eighty.	８０歳以上に長生きする人は少なくありません。
No fewer than fifty thousand people visited there.	５万人もの人々がそこを訪れた。
In case you go out before 5, just let me know.	５時前に出かけの時は、ちょっと知らせて下さい。
The 5th May is Children's Day.	５月５日は子供の日です。
No fewer than five hundred students were present.	５００人もの学生が出席した。
It is easy to add 5 to 10.	５＋１０の足し算はやさしい。
I haven't heard a word from them in over four years.	４年以上も音信不通だったんだよ。
The fourth period was moved up to the third.	４時限が３時限に繰り上げになった。
In April we have a lot of school events.	４月には学校行事がたくさんある。
Would it be possible to set up a meeting with us on April 5 or 6?	４月５日か６日に会っていただけませんか。
On April 1, Nanyo Foods Co. Ltd. will move to its new building in Yokohama.	４月１日、南洋フーズ株式会社は横浜の新社屋に移転します。
Please put me through to 442-5511.	４４２―５５１１へつないで下さい。
I got out of the car at 40th Street.	４０丁目で車を降りた。
Three years is a long time, I feel.	３年というは長い時間だと私は思う。
I will answer within three days.	３日以内に返事します。
Who runs the fastest of the three?	３人のうちで誰がもっとも速く走りますか。
It was three weeks before she wrote an answer to Tom.	３週間して彼女はトムに返事を書いた。
We have French third period.	３時間目にはフランス語があります。
Let's make it three.	３時にしようよ。
March comes between February and April.	３月は２月と４月の間にある。
March 15 will be my last day of school.	３月１５日で学校は終わりです。
It will be three months before our new school building is completed.	３ヶ月すれば、私たちの新しい校舎が完成するでしょう。
No fewer than thirty people were present.	３０人もの人が出席した。
Never again did she enter the house.	２度と彼女はその家の敷居をまたがなかった。
There were two children playing on the street.	２人の子供が通りで遊んでいた。
The two students will be talking to each other.	２人の学生がお互い話し合っているだろう。
Please come again two weeks from today.	２週間後に来てください。
Out of twenty students, only one had read the book.	２０人の生徒のうちたった一人しかその本を読んだことがなかった。
If I were twenty, I could vote.	２０歳になっていれば、投票できるのに。
Twenties and some smaller bills, please.	２０ドル札と、あとそれより少額の札を何枚か入れて下さい。
He will be back in a few days.	２、３日すれば彼は帰ってくるだろう。
May I ask a few questions?	２、３質問をしてもよろしいですか。
Could you please put me up for the night?	１晩とめていただけますか。
I have not heard from her for a year.	１年間彼女から便りがありません。
Do you have any day tours?	１日コースがありますか。
The results will be back in a week.	１週間以内に検査の結果が出ます。
What do you have the first period?	１時限は何の授業ですか。
For three nights starting January 3rd, please.	１月３日から３泊、お願いします。
Did you receive my e-mail of January 10?	１月１０日付の電子メールを受け取りましたか。
Please make three copies of each page.	１ページにつき、３枚ずつコピーして下さい。
May I ask you a question?	１つ質問してもいいですか。
I'd like to ask a question.	１つ質問してみたい。
1980 was the year when I was born.	１９８０年は私が生まれた年です。
In 1943, Japan was at war.	１９４３年に日本は戦争をしていた。
I was not yet born when a war between Japan and the U.S. broke out in December 1941.	１９４１年の１２月に日本とアメリカの間で戦争が勃発した時、私は生まれていなかった。
War broke out in 1941.	１９４１年に戦争が起こった。
People above 18 may drive.	１８歳以上の人は車を運転できる。
Ten years is a short time when we look back at it.	１０年というのは、振り返ってみると短い年月だ。
We have a break from 10:40 to 11:00.	１０時４０分から１１時まで休み時間です。
Few people live to be one hundred years old.	１００歳の長寿をまっとうする人は少ない。
This is what he said: "I shall return by all means."	「必ず戻ってくるからな」というのが、彼の言った言葉です。
"I understand how you feel, Hiroshi," says Mike.	「博、君の気持ちは分かるよ」とマイクが言います。
"How about going to the movies on Saturday?" "I'd like to go."	「土曜日に映画を見に行くのはどうですか」「行きたいですね」
"I'm going to Hawaii next week." "Really?"	「私は来週ハワイへ行くつもりよ」「ほんと？」
"How many keys?" asked Pepperberg.	「鍵はいくつある？」とペパーバーグが聞く。
"What brand is your car?" "It's a Ford."	「君の車はどこの製品ですか」「フォード社のです」
"May I go with you?" "By all means."	「一緒に行ってもいいですか」「どうぞ」
If he says "I love you" all the time he doesn't mean it.	「愛してる」といつも言えば、何の意味もなさなくなる。
"I feel like playing cards." "So do I."	「トランプしたいなあ」「私も」
"What are these?" "They are your pictures."	「これらは何ですか」「あなたの写真です」
"May I use the phone?" "Please feel free."	「お電話をお借りしてもいいですか」「どうぞ、どうぞ」
Try it by all means.	ぜひそれをやってみなさい。
Are you for or against my plan?	私の計画に賛成ですか、反対ですか。
I'm looking for my key.	鍵を探しています。
I study hard at school.	私は学校で一生懸命に勉強する。
He pointed out that the plan would cost a lot of money.	彼はその計画に多大のお金がかかると指摘した。
I also heard a similar story.	私も似た話を聞いたことがある。
Will you go, too?	君も行くか。
Let me know what you're up to.	何をしているのか教えて。
What a memory you have.	君すごい記憶力だね。
What does it mean?	どういうことを意味しているのですか。
I met him while he was in Japan.	私は彼が日本にいるあいだに会いました。
Andy must have practiced very hard.	アンディは、猛練習したにちがいない。
That report was important because it pointed out all the errors the committee had made.	その報告は、委員会の犯した誤りのすべてを指摘したということで重要であった。
One should always do one's best.	人はいつも全力を尽くすべきです。
Of all places to meet you!	よりによってこんなところで君に会うなんて。
When was she born?	彼女はいつ生まれたのですか。
If it's at all possible, I'd like you to take part in the next meeting.	なんとか都合をつけて、次のミーティングに出席していただけませんか。
"When did you buy it?" "Let's see. I bought it last week."	「いつそれを買ったの」「ええと、先週でした」
"Did you watch TV last week?" "No, I didn't."	「あなたは先週テレビを見ましたか」「いいえ」
This does not apply to students.	これは学生にはあてはまらない。
Let's not do the work.	その仕事はやらないでおこう。
Tell me what you did on your holidays.	休暇に何をしているのか教えてください。
She wouldn't let him in.	彼女はどうしても彼を部屋の中に入れようとしなかった。
I have no job, so I can never save money.	アルバイトをしてないから、お金を貯められない。
She works in a bank.	彼女は銀行に勤めている。
He felt at home.	彼はくつろいだ気分になった。
Bill was too young to take the post.	ビルは若すぎてその役職につくことができなかった。
Will you take care of the children while I'm out?	私が外出している間、子供たちの面倒を見てくれませんか。
What does it mean?	それ、どういう意味？
Three children were playing in the park.	３人の子供が公園で遊んでいた。
Sounds great, I'll have a look afterwards.	いいねぇ。後で見に行くよ。
Do you have some paper or something?	紙か何かある？
Gimme something to write on.	書くものをくれ。
Let's have a try.	やってみましょう。
Let's go!	行くよ。
I shall never follow links posted by Muiriel again.	ムーリエルが貼ったリンクはもう二度とクリックするもんか。
Even so, you are a human.	それでも、おまえは人間だ。
Let me have a look.	見せてくれ。
I will never tell!	この口が裂けても言えません！
You're out of order in talking back to her in the first place.	彼女に口答えすること自体そもそも間違いだろ。
Watch your step.	足元に気をつけて。
It's my policy to break it off with men who ask for money.	私は金をせびる男と縁を切ることにしています。
My period hasn't come.	生理が来てません。
Please come again in three days time.	３日後にまた来てください。
That word has fallen out of use.	この語はもう死語です。
Not a few people have two cars.	２台の車をもつ人は少なくない。
You play Starcraft really well.	おまえはスタークラフトやるのがうまいね。
She's asking how that's possible.	彼女は、どうしてそんなことが可能なのかと尋ねている。
There are many words that I don't understand.	分からない言葉がたくさんある。
"I feel like playing cards." "So do I."	「トランプしたいなあ。」「私も。」
She doesn't want to talk about it.	彼女はそのことについて話したくないんだよ。
He's a university student.	彼は大学生です。
He has a lot of money.	彼は金持ちだ。
Which is best, white thread or red thread?	赤い糸と白い糸、どっちがいいですか。
My most interesting friend is Jessie.	一番面白い私の友達はジェシーです。
Your most interesting friend is?	一番面白い友達は？
"Seen my cell phone?" "On the table!"	「俺の携帯見なかったか？」「テーブルの上よ」
I brought you a little something.	きみにちょっとしたものをもってきたよ。
Let's try something.	何かしてみましょう。
The password is "Muiriel".	パスワードは「Muiriel」です。
This is never going to end.	きりがない。
Is that a recent photo?	それは最近の写真？
What're you talking about?	何の話？
Have you been told where the meeting will be?	会議がどこであるか聞いた？
I don't know what you're talking about.	何の話をしてるのか分からないよ。
They were in that room with me all night.	彼らは一晩中その部屋で私と一緒だった。
I like the way you talk.	あなたの話し方が好き。
I don't understand German at all.	ドイツ語は全くわかりません。
I never felt this way before I met you.	こんな気持ちにさせてくれる人は初めてだよ。
I never thought it'd be this hard to create an iPad app.	iPadアプリを作るのがこんなに大変だとは思ってもみなかった。
I shouldn't have gotten up so early.	あんなに早く起きなければよかった。
Could you please take a picture?	写真を撮っていただけませんか？
By the way, have you heard about Suzuki?	時に鈴木の件について聞いたか。
Next Monday and Tuesday are holidays.	来週の月火と連休です。